qtid,semester_en,semester_kor,chapter_order,chapter_name,genre_order,genre_name,genre_subtitle,1,2,3,4,5,total_output_question,1,2,3,4,5,total_input_question
EXEP-01-01,,,,,1,교과 외 유형,,10,60,129,125,8,332,0,0,0,0,0,0
H1S1-01-01,H1S1,고등수학(상),1,다항식의 연산,1,다항식의 덧셈과 뺄셈,,13,28,11,2,0,54,2,3,5,1,0,11
H1S1-01-02,H1S1,고등수학(상),1,다항식의 연산,2,곱셈공식을 이용한 식의 전개,,8,26,27,5,2,68,3,2,14,3,3,25
H1S1-01-03,H1S1,고등수학(상),1,다항식의 연산,3,치환을 이용한 식의 전개,,0,3,8,1,0,12,0,4,5,0,0,9
H1S1-01-04,H1S1,고등수학(상),1,다항식의 연산,4,곱셈공식의 활용 (1),문자가 2개인 경우,0,1,37,9,0,47,1,0,12,3,4,20
H1S1-01-05,H1S1,고등수학(상),1,다항식의 연산,5,x±1/x 꼴의 활용,,0,0,9,2,0,11,0,0,6,1,3,10
H1S1-01-06,H1S1,고등수학(상),1,다항식의 연산,6,곱셈공식의 활용 (2),문자가 3개인 경우,0,1,25,6,0,32,0,0,8,4,3,15
H1S1-01-07,H1S1,고등수학(상),1,다항식의 연산,7,곱셈공식의 활용 (3),도형,0,1,15,10,0,26,0,0,3,2,1,6
H1S1-01-08,H1S1,고등수학(상),1,다항식의 연산,8,다항식의 나눗셈,,1,16,24,3,0,44,1,0,16,0,2,19
H1S1-01-09,H1S1,고등수학(상),1,다항식의 연산,9,조립제법,,0,9,4,2,0,15,0,0,5,1,0,6
H1S1-02-01,H1S1,고등수학(상),2,나머지정리와 인수분해,1,항등식과 계수비교법,,2,7,19,4,0,32,1,2,7,0,1,11
H1S1-02-02,H1S1,고등수학(상),2,나머지정리와 인수분해,2,항등식과 수치대입법,,0,8,17,5,2,32,1,0,8,1,0,10
H1S1-02-03,H1S1,고등수학(상),2,나머지정리와 인수분해,3,주어진 조건을 만족하는 항등식,,0,0,16,11,0,27,0,0,11,1,0,12
H1S1-02-04,H1S1,고등수학(상),2,나머지정리와 인수분해,4,복잡한 항등식의 계수의 합,,0,2,2,6,0,10,0,0,7,1,1,9
H1S1-02-05,H1S1,고등수학(상),2,나머지정리와 인수분해,5,항등식과 다항식의 나눗셈,,0,2,12,9,0,23,0,0,9,0,0,9
H1S1-02-06,H1S1,고등수학(상),2,나머지정리와 인수분해,6,나머지정리 (1),일차식으로 나누는 경우,12,16,21,10,0,59,2,3,12,0,0,17
H1S1-02-07,H1S1,고등수학(상),2,나머지정리와 인수분해,7,나머지정리 (2),이차식으로 나누는 경우,0,0,22,9,0,31,0,0,6,1,1,8
H1S1-02-08,H1S1,고등수학(상),2,나머지정리와 인수분해,8,나머지정리 (3),삼차식으로 나누는 경우,0,0,11,6,0,17,0,0,3,3,2,8
H1S1-02-09,H1S1,고등수학(상),2,나머지정리와 인수분해,9,나머지정리 (4),P(ax+b) 를 x−a로 나누는 경우,0,0,8,4,0,12,0,2,5,1,0,8
H1S1-02-10,H1S1,고등수학(상),2,나머지정리와 인수분해,10,나머지정리 (5),몫을 x−a 로 나누는 경우,0,0,10,5,0,15,1,0,6,2,0,9
H1S1-02-11,H1S1,고등수학(상),2,나머지정리와 인수분해,11,인수정리 (1),일차식으로 나누는 경우,1,15,17,3,0,36,1,0,7,0,1,9
H1S1-02-12,H1S1,고등수학(상),2,나머지정리와 인수분해,12,인수정리 (2),이차식으로 나누는 경우,0,4,10,5,2,21,0,0,5,2,1,8
H1S1-02-13,H1S1,고등수학(상),2,나머지정리와 인수분해,13,나머지정리의 활용,,0,1,5,4,2,12,0,0,5,3,2,10
H1S1-02-14,H1S1,고등수학(상),2,나머지정리와 인수분해,14,조립제법과 항등식,,3,4,6,12,0,25,0,0,9,1,1,11
H1S1-03-01,H1S1,고등수학(상),3,인수분해,1,인수분해의 기본,,17,17,23,3,0,60,2,5,12,0,1,20
H1S1-03-02,H1S1,고등수학(상),3,인수분해,2,치환을 이용한 인수분해,,0,9,23,10,2,44,0,0,8,0,0,8
H1S1-03-03,H1S1,고등수학(상),3,인수분해,3,복이차식의 인수분해,,0,5,13,3,0,21,1,0,8,0,1,10
H1S1-03-04,H1S1,고등수학(상),3,인수분해,4,내림차순을 이용한 인수분해,,0,6,21,6,1,34,1,0,10,3,1,15
H1S1-03-05,H1S1,고등수학(상),3,인수분해,5,순환꼴의 인수분해,,0,2,7,2,0,11,0,0,6,1,1,8
H1S1-03-06,H1S1,고등수학(상),3,인수분해,6,인수정리를 이용한 인수분해,,1,21,12,6,1,41,7,0,3,0,1,11
H1S1-03-07,H1S1,고등수학(상),3,인수분해,7,계수가 대칭인 사차식의 인수분해,,0,0,7,3,0,10,0,0,6,0,0,6
H1S1-03-08,H1S1,고등수학(상),3,인수분해,8,조건이 주어진 식의 인수분해,,0,0,5,8,0,13,0,0,5,1,0,6
H1S1-03-09,H1S1,고등수학(상),3,인수분해,9,인수분해의 활용 (1),삼각형 모양 판단,0,0,19,3,1,23,0,0,2,6,1,9
H1S1-03-10,H1S1,고등수학(상),3,인수분해,10,인수분해의 활용 (2),식의 값,0,2,20,12,0,34,0,0,5,1,1,7
H1S1-03-11,H1S1,고등수학(상),3,인수분해,11,인수분해의 활용 (3),수의 계산,0,2,19,3,0,24,0,0,11,2,2,15
H1S1-04-01,H1S1,고등수학(상),4,복소수,1,복소수의 뜻과 분류,,6,6,3,0,0,15,3,3,1,0,0,7
H1S1-04-02,H1S1,고등수학(상),4,복소수,2,복소수의 연산,,18,25,30,3,0,76,7,2,11,1,2,23
H1S1-04-03,H1S1,고등수학(상),4,복소수,3,복소수가 서로 같을 조건,,5,13,15,3,0,36,0,3,8,0,1,12
H1S1-04-04,H1S1,고등수학(상),4,복소수,4,복소수가 실수 또는 순허수가 되는 조건,,0,2,24,2,0,28,0,1,5,1,1,8
H1S1-04-05,H1S1,고등수학(상),4,복소수,5,켤레복소수를 포함한 식의 값,,2,4,30,12,0,48,1,1,15,3,3,23
H1S1-04-06,H1S1,고등수학(상),4,복소수,6,주어진 조건을 만족하는 복소수,,0,0,20,5,1,26,0,0,11,0,0,11
H1S1-04-07,H1S1,고등수학(상),4,복소수,7,i의 거듭제곱,,0,1,15,3,0,19,0,2,6,2,2,12
H1S1-04-08,H1S1,고등수학(상),4,복소수,8,복소수의 거듭제곱,,0,0,16,17,1,34,3,0,7,1,1,12
H1S1-04-09,H1S1,고등수학(상),4,복소수,9,음수의 제곱근,,4,17,22,5,0,48,1,4,13,2,2,22
H1S1-05-01,H1S1,고등수학(상),5,이차방정식,1,이차방정식의 풀이,,14,1,13,0,0,28,6,1,5,0,1,13
H1S1-05-02,H1S1,고등수학(상),5,이차방정식,2,이차방정식의 근이 주어진 경우,,0,1,13,1,0,15,3,0,9,0,1,13
H1S1-05-03,H1S1,고등수학(상),5,이차방정식,3,이차방정식이 절댓값 또는 가우스 기호를 포함한 경우,,0,2,12,7,0,21,0,0,9,5,1,15
H1S1-05-04,H1S1,고등수학(상),5,이차방정식,4,이차방정식의 활용,,0,0,11,4,0,15,0,0,4,2,0,6
H1S1-05-05,H1S1,고등수학(상),5,이차방정식,5,이차방정식의 근의 판별,,0,17,33,10,0,60,2,4,16,3,2,27
H1S1-05-06,H1S1,고등수학(상),5,이차방정식,6,이차방정식의 판별과 삼각형의 모양,,0,0,8,2,0,10,1,0,4,0,0,5
H1S1-05-07,H1S1,고등수학(상),5,이차방정식,7,이차식이 완전제곱식이 되는 조건,,0,2,7,1,0,10,0,2,4,0,0,6
H1S1-05-08,H1S1,고등수학(상),5,이차방정식,8,근과 계수의 관계,,0,16,35,16,0,67,2,2,18,1,3,26
H1S1-05-09,H1S1,고등수학(상),5,이차방정식,9,두 근의 조건이 주어진 이차방정식의 풀이,,0,1,30,7,0,38,1,1,24,0,2,28
H1S1-05-10,H1S1,고등수학(상),5,이차방정식,10,이차방정식 작성하기,,0,2,26,7,0,35,0,0,11,2,1,14
H1S1-05-11,H1S1,고등수학(상),5,이차방정식,11,잘못 보고 푼 이차방정식,,0,0,9,0,1,10,0,0,4,0,1,5
H1S1-05-12,H1S1,고등수학(상),5,이차방정식,12,이차식의 복소수범위 인수분해,,0,1,9,0,0,10,0,0,7,0,0,7
H1S1-05-13,H1S1,고등수학(상),5,이차방정식,13,이차방정식의 켤레근,,0,6,15,4,0,25,0,0,7,0,0,7
H1S1-05-14,H1S1,고등수학(상),5,이차방정식,14,이차방정식 f(x)=0 과 f(ax+b)=0 의 관계,,0,0,3,8,0,11,0,0,6,1,0,7
H1S1-05-15,H1S1,고등수학(상),5,이차방정식,15,"f(x)-k=0 형태의 두 근 α, β",,2,1,4,2,1,10,0,0,1,1,0,2
H1S1-06-01,H1S1,고등수학(상),6,이차방정식과 이차함수,1,이차함수의 그래프와 직선의 교점,"x축, x축이 아닌 직선",0,0,7,9,0,16,1,7,19,0,1,28
H1S1-06-02,H1S1,고등수학(상),6,이차방정식과 이차함수,2,이차함수의 그래프와 직선의 위치관계,"x축, x축이 아닌 직선",0,1,19,4,0,24,0,0,21,0,1,22
H1S1-06-03,H1S1,고등수학(상),6,이차방정식과 이차함수,3,이차함수의 그래프에 접하는 직선의 방정식,,1,2,8,3,0,14,3,0,6,3,1,13
H1S1-06-04,H1S1,고등수학(상),6,이차방정식과 이차함수,4,이차함수의 그래프와 이차방정식의 실근의 관계,,1,2,5,9,2,19,0,0,4,2,0,6
H1S1-06-05,H1S1,고등수학(상),6,이차방정식과 이차함수,5,이차함수의 최댓값과 최솟값 (1),실수 전체 범위,1,2,6,4,0,13,0,3,14,3,0,20
H1S1-06-06,H1S1,고등수학(상),6,이차방정식과 이차함수,6,이차함수의 최댓값과 최솟값 (2),제한된 범위,0,1,14,7,1,23,1,1,11,2,4,19
H1S1-06-07,H1S1,고등수학(상),6,이차방정식과 이차함수,7,식의 최댓값과 최솟값 (1),,0,0,7,1,2,10,0,0,4,2,1,7
H1S1-06-08,H1S1,고등수학(상),6,이차방정식과 이차함수,8,식의 최댓값과 최솟값 (2),,0,0,8,5,1,14,0,0,7,2,1,10
H1S1-06-09,H1S1,고등수학(상),6,이차방정식과 이차함수,9,식의 최댓값과 최솟값 (3),,0,0,10,1,0,11,0,0,8,0,0,8
H1S1-06-10,H1S1,고등수학(상),6,이차방정식과 이차함수,10,이차함수의 최대·최소의 활용,,0,0,10,8,0,18,2,0,13,4,1,20
H1S1-07-01,H1S1,고등수학(상),7,여러 가지 방정식,1,삼차방정식과 사차방정식,,0,3,32,5,0,40,0,1,8,0,0,9
H1S1-07-02,H1S1,고등수학(상),7,여러 가지 방정식,2,치환을 이용한 사차방정식의 풀이,,0,0,16,1,0,17,0,0,9,0,2,11
H1S1-07-03,H1S1,고등수학(상),7,여러 가지 방정식,3,복이차방정식,,0,0,9,3,0,12,0,0,12,0,0,12
H1S1-07-04,H1S1,고등수학(상),7,여러 가지 방정식,4,계수가 대칭인 사차방정식,,0,1,10,0,0,11,0,0,7,1,0,8
H1S1-07-05,H1S1,고등수학(상),7,여러 가지 방정식,5,근이 주어진 삼·사차방정식,,0,1,12,2,0,15,0,2,8,0,1,11
H1S1-07-06,H1S1,고등수학(상),7,여러 가지 방정식,6,삼차방정식의 근의 판별,,0,0,11,3,1,15,0,0,8,2,1,11
H1S1-07-07,H1S1,고등수학(상),7,여러 가지 방정식,7,삼차방정식의 근과 계수의 관계,,0,0,18,1,1,20,0,0,13,1,0,14
H1S1-07-08,H1S1,고등수학(상),7,여러 가지 방정식,8,삼차방정식의 작성,,0,1,7,2,0,10,0,0,6,0,0,6
H1S1-07-09,H1S1,고등수학(상),7,여러 가지 방정식,9,삼차방정식의 켤레근,,0,0,26,1,0,27,1,2,10,0,0,13
H1S1-07-10,H1S1,고등수학(상),7,여러 가지 방정식,10,방정식 x³=1 과 x³=−1 의 허근의 성질,,0,1,23,14,0,38,4,1,10,2,1,18
H1S1-07-11,H1S1,고등수학(상),7,여러 가지 방정식,11,삼차방정식과 사차방정식의 활용,,0,0,15,1,0,16,0,0,8,0,1,9
H1S1-07-12,H1S1,고등수학(상),7,여러 가지 방정식,12,일차방정식과 이차방정식으로 이루어진 연립방정식,,0,2,18,5,0,25,1,1,8,0,0,10
H1S1-07-13,H1S1,고등수학(상),7,여러 가지 방정식,13,두 이차방정식으로 이루어진 연립방정식,,0,0,25,0,0,25,0,0,10,0,0,10
H1S1-07-14,H1S1,고등수학(상),7,여러 가지 방정식,14,x+y 와 xy 로 이루어진 연립방정식,,0,0,9,3,0,12,0,0,6,1,0,7
H1S1-07-15,H1S1,고등수학(상),7,여러 가지 방정식,15,연립이차방정식의 해의 조건,,0,0,8,2,0,10,0,3,6,0,0,9
H1S1-07-16,H1S1,고등수학(상),7,여러 가지 방정식,16,연립이차방정식의 활용,,0,0,10,3,1,14,0,0,9,0,0,9
H1S1-07-17,H1S1,고등수학(상),7,여러 가지 방정식,17,공통근을 가지는 방정식,,0,1,11,1,0,13,0,1,2,0,0,3
H1S1-07-18,H1S1,고등수학(상),7,여러 가지 방정식,18,정수 및 자연수 조건을 갖는 부정방정식,,0,0,16,3,0,19,2,2,6,0,0,10
H1S1-07-19,H1S1,고등수학(상),7,여러 가지 방정식,19,실수 조건을 갖는 부정방정식,,0,0,8,2,0,10,1,2,3,1,0,7
H1S1-07-20,H1S1,고등수학(상),7,여러 가지 방정식,20,부정방정식의 활용,,0,0,7,2,1,10,0,1,1,0,0,2
H1S1-07-21,H1S1,고등수학(상),7,여러 가지 방정식,21,삼차방정식 f(x)=0 과 f(ax+b)=0 의 관계,,2,2,12,3,0,19,0,0,1,0,0,1
H1S1-08-01,H1S1,고등수학(상),8,여러 가지 부등식,1,부등식의 성질과 풀이,,0,20,11,1,0,32,1,0,6,0,1,8
H1S1-08-02,H1S1,고등수학(상),8,여러 가지 부등식,2,연립일차부등식,,0,0,8,0,1,9,0,0,21,0,0,21
H1S1-08-03,H1S1,고등수학(상),8,여러 가지 부등식,3,A < B < C 형태의 부등식 ,,1,1,7,0,1,10,0,0,11,0,0,11
H1S1-08-04,H1S1,고등수학(상),8,여러 가지 부등식,4,해가 주어진 연립일차부등식,,0,0,6,2,1,9,1,0,10,0,1,12
H1S1-08-05,H1S1,고등수학(상),8,여러 가지 부등식,5,해를 갖거나 갖지 않는 연립일차부등식,,0,0,8,2,0,10,0,0,4,1,0,5
H1S1-08-06,H1S1,고등수학(상),8,여러 가지 부등식,6,정수인 해의 개수가 주어진 연립일차부등식,,0,0,8,3,0,11,0,0,4,0,0,4
H1S1-08-07,H1S1,고등수학(상),8,여러 가지 부등식,7,연립일차부등식의 활용,,0,0,10,0,0,10,0,0,10,0,0,10
H1S1-08-08,H1S1,고등수학(상),8,여러 가지 부등식,8,절댓값 기호가 포함된 일차부등식,,1,15,18,4,0,38,0,4,20,0,1,25
H1S1-08-09,H1S1,고등수학(상),8,여러 가지 부등식,9,특수한 해를 갖는 일차부등식,,0,0,8,1,0,9,0,0,6,0,0,6
H1S1-08-10,H1S1,고등수학(상),8,여러 가지 부등식,10,이차부등식,,0,1,12,1,0,14,0,5,7,0,0,12
H1S1-08-11,H1S1,고등수학(상),8,여러 가지 부등식,11,절댓값 또는 가우스 기호가 포함된 이차부등식,,0,0,11,1,0,12,0,0,8,0,1,9
H1S1-08-12,H1S1,고등수학(상),8,여러 가지 부등식,12,해가 주어진 이차부등식,,0,1,15,4,0,20,2,0,13,0,0,15
H1S1-08-13,H1S1,고등수학(상),8,여러 가지 부등식,13,함수의 그래프와 이차부등식의 해,,3,1,7,1,0,12,6,1,16,0,2,25
H1S1-08-14,H1S1,고등수학(상),8,여러 가지 부등식,14,모든 실수에 대해 성립하는 이차부등식,,0,0,14,3,0,17,0,0,7,3,1,11
H1S1-08-15,H1S1,고등수학(상),8,여러 가지 부등식,15,제한된 범위에서 항상 성립하는 이차부등식,,0,0,7,2,0,9,0,0,7,1,0,8
H1S1-08-16,H1S1,고등수학(상),8,여러 가지 부등식,16,해의 조건이 주어진 이차부등식,,0,0,12,2,0,14,0,0,13,2,5,20
H1S1-08-17,H1S1,고등수학(상),8,여러 가지 부등식,17,부등식 f(x)<0 과 부등식 f(ax+b)<0 의 관계,,0,0,7,3,1,11,0,0,6,2,0,8
H1S1-08-18,H1S1,고등수학(상),8,여러 가지 부등식,18,이차부등식을 이용하여 식의 최댓값·최솟값 구하기,,0,0,10,1,0,11,0,0,1,0,1,2
H1S1-08-19,H1S1,고등수학(상),8,여러 가지 부등식,19,이차부등식의 활용,,0,1,9,0,0,10,1,0,5,0,0,6
H1S1-08-20,H1S1,고등수학(상),8,여러 가지 부등식,20,연립이차부등식,,0,1,15,2,0,18,3,1,9,1,0,14
H1S1-08-21,H1S1,고등수학(상),8,여러 가지 부등식,21,해가 주어진 연립이차부등식,,0,0,8,4,0,12,0,0,9,0,2,11
H1S1-08-22,H1S1,고등수학(상),8,여러 가지 부등식,22,정수인 해의 개수가 주어진 연립부등식,,0,0,9,5,1,15,0,0,5,0,1,6
H1S1-08-23,H1S1,고등수학(상),8,여러 가지 부등식,23,두 이차방정식의 근의 판별,,1,5,8,2,0,16,0,0,3,1,0,4
H1S1-08-24,H1S1,고등수학(상),8,여러 가지 부등식,24,이차방정식의 근의 위치,,0,4,20,2,0,26,0,3,14,4,0,21
H1S1-08-25,H1S1,고등수학(상),8,여러 가지 부등식,25,연립이차부등식의 활용,,0,0,10,0,0,10,0,1,6,3,0,10
H1S1-09-01,H1S1,고등수학(상),9,평면좌표,1,두 점 사이의 거리,,0,4,10,0,0,14,0,0,7,1,1,9
H1S1-09-02,H1S1,고등수학(상),9,평면좌표,2,같은 거리에 있는 점,,0,4,11,2,0,17,1,5,5,2,1,14
H1S1-09-03,H1S1,고등수학(상),9,평면좌표,3,세 변의 길이와 삼각형의 모양 판단,,0,0,11,1,0,12,1,2,5,2,0,10
H1S1-09-04,H1S1,고등수학(상),9,평면좌표,4,거리의 제곱의 합의 최솟값,,0,0,10,1,0,11,0,4,6,2,0,12
H1S1-09-05,H1S1,고등수학(상),9,평면좌표,5,두 점 사이 거리의 활용,,0,0,4,6,0,10,0,0,5,1,0,6
H1S1-09-06,H1S1,고등수학(상),9,평면좌표,6,좌표를 이용한 도형의 성질 판단,,0,0,6,2,0,8,0,0,5,0,0,5
H1S1-09-07,H1S1,고등수학(상),9,평면좌표,7,선분의 내분점과 외분점,,0,7,13,5,0,25,3,3,9,0,0,15
H1S1-09-08,H1S1,고등수학(상),9,평면좌표,8,선분의 내분점과 외분점의 활용,,0,1,8,7,0,16,0,0,16,3,1,20
H1S1-09-09,H1S1,고등수학(상),9,평면좌표,9,삼각형의 무게중심,,2,2,14,1,0,19,4,0,6,0,2,12
H1S1-09-10,H1S1,고등수학(상),9,평면좌표,10,삼각형의 내각의 이등분선,,0,0,6,5,1,12,0,0,8,0,0,8
H1S1-09-11,H1S1,고등수학(상),9,평면좌표,11,사각형에서의 활용,,0,0,11,2,0,13,2,4,4,0,0,10
H1S1-09-12,H1S1,고등수학(상),9,평면좌표,12,중선정리 (파푸스의 정리),,0,1,9,0,0,10,0,0,2,1,0,3
H1S1-10-01,H1S1,고등수학(상),10,직선의 방정식,1,직선의 방정식 (1),기울기와 한 점이 주어진 경우,2,5,8,2,0,17,0,0,10,0,0,10
H1S1-10-02,H1S1,고등수학(상),10,직선의 방정식,2,직선의 방정식 (2),두 점이 주어진 경우,0,3,7,6,0,16,0,2,11,0,0,13
H1S1-10-03,H1S1,고등수학(상),10,직선의 방정식,3,직선의 방정식 (3),x절편과 y절편이 주어진 경우,1,1,6,2,0,10,0,0,8,0,0,8
H1S1-10-04,H1S1,고등수학(상),10,직선의 방정식,4,세 점이 한 직선 위에 있도록 하는 조건,,0,2,9,0,0,11,0,0,9,0,0,9
H1S1-10-05,H1S1,고등수학(상),10,직선의 방정식,5,도형의 넓이를 절반으로 나누는 직선의 방정식,,0,0,11,4,0,15,0,0,8,1,0,9
H1S1-10-06,H1S1,고등수학(상),10,직선의 방정식,6,직선의 개형,,0,3,8,0,0,11,0,0,8,0,1,9
H1S1-10-07,H1S1,고등수학(상),10,직선의 방정식,7,정점을 지나는 직선,,0,1,8,6,1,16,1,2,22,2,1,28
H1S1-10-08,H1S1,고등수학(상),10,직선의 방정식,8,두 직선의 위치 관계,,0,3,15,1,0,19,3,3,13,0,1,20
H1S1-10-09,H1S1,고등수학(상),10,직선의 방정식,9,선분을 수직이등분하는 방정식,,0,0,13,1,0,14,0,0,8,2,1,11
H1S1-10-10,H1S1,고등수학(상),10,직선의 방정식,10,세 직선의 위치 관계,,0,0,3,10,0,13,0,0,10,1,0,11
H1S1-10-11,H1S1,고등수학(상),10,직선의 방정식,11,점과 직선 사이의 거리,,0,5,7,3,1,16,1,2,8,0,0,11
H1S1-10-12,H1S1,고등수학(상),10,직선의 방정식,12,점과 직선 사이 거리의 활용,,0,0,6,10,0,16,0,0,10,4,2,16
H1S1-10-13,H1S1,고등수학(상),10,직선의 방정식,13,평행한 두 직선 사이의 거리,,0,2,10,2,0,14,0,4,7,0,1,12
H1S1-10-14,H1S1,고등수학(상),10,직선의 방정식,14,두 직선이 이루는 각을 이등분하는 방정식,,0,0,8,2,0,10,0,0,6,0,0,6
H1S1-10-15,H1S1,고등수학(상),10,직선의 방정식,15,삼각형의 수심,,0,0,9,1,0,10,0,0,4,1,0,5
H1S1-10-16,H1S1,고등수학(상),10,직선의 방정식,16,자취의 방정식 (1),,0,0,8,2,1,11,0,0,9,0,0,9
H1S1-11-01,H1S1,고등수학(상),11,원의 방정식,1,원의 방정식 (1),중심에 대한 조건이 주어진 경우,6,3,5,2,0,16,1,1,15,0,1,18
H1S1-11-02,H1S1,고등수학(상),11,원의 방정식,2,원의 방정식 (2),두 점을 지름의 양 끝 점으로 하는 경우,0,0,11,2,1,14,1,0,5,0,0,6
H1S1-11-03,H1S1,고등수학(상),11,원의 방정식,3,원의 방정식 (3),지나는 세 점이 주어진 경우,0,1,11,0,0,12,0,0,6,1,1,8
H1S1-11-04,H1S1,고등수학(상),11,원의 방정식,4,방정식이 원을 나타내기 위한 조건,,0,0,7,3,0,10,1,0,8,0,0,9
H1S1-11-05,H1S1,고등수학(상),11,원의 방정식,5,x축 또는 y축에 접하는 원의 방정식,,0,0,10,0,0,10,0,7,10,2,1,20
H1S1-11-06,H1S1,고등수학(상),11,원의 방정식,6,x축과 y축에 동시에 접하는 원의 방정식,,0,0,7,3,0,10,0,3,7,0,1,11
H1S1-11-07,H1S1,고등수학(상),11,원의 방정식,7,원 위의 점과 원 밖의 점 사이의 거리,,0,2,8,2,1,13,0,0,6,0,0,6
H1S1-11-08,H1S1,고등수학(상),11,원의 방정식,8,두 원의 교점을 지나는 원의 방정식,,0,0,10,1,0,11,0,0,10,0,0,10
H1S1-11-09,H1S1,고등수학(상),11,원의 방정식,9,두 원의 교점을 지나는 직선의 방정식,,0,1,8,1,0,10,0,0,7,1,1,9
H1S1-11-10,H1S1,고등수학(상),11,원의 방정식,10,원 위의 점과 직선 사이의 거리,,0,1,8,5,0,14,2,1,7,1,0,11
H1S1-11-11,H1S1,고등수학(상),11,원의 방정식,11,원과 직선의 위치관계 (1),서로 다른 두 점에서 만나는 경우,0,3,9,7,0,19,1,2,9,0,0,12
H1S1-11-12,H1S1,고등수학(상),11,원의 방정식,12,원과 직선의 위치관계 (2),접하는 경우,0,0,6,4,1,11,2,2,7,1,1,13
H1S1-11-13,H1S1,고등수학(상),11,원의 방정식,13,원과 직선의 위치관계 (3),만나지 않는 경우,0,1,5,7,0,13,0,2,8,0,0,10
H1S1-11-14,H1S1,고등수학(상),11,원의 방정식,14,현의 길이,,0,0,10,4,0,14,0,1,12,2,2,17
H1S1-11-15,H1S1,고등수학(상),11,원의 방정식,15,접선의 길이,,1,1,3,5,0,10,1,4,9,2,1,17
H1S1-11-16,H1S1,고등수학(상),11,원의 방정식,16,원의 접선의 방정식 (1),기울기가 주어진 경우,0,1,10,1,0,12,0,1,10,0,1,12
H1S1-11-17,H1S1,고등수학(상),11,원의 방정식,17,원의 접선의 방정식 (2),접점이 주어진 경우,0,1,11,5,0,17,0,0,8,1,0,9
H1S1-11-18,H1S1,고등수학(상),11,원의 방정식,18,원의 접선의 방정식 (3),원 밖의 한 점에서 접선을 그은 경우,0,0,12,9,2,23,0,0,3,4,2,9
H1S1-11-19,H1S1,고등수학(상),11,원의 방정식,19,자취의 방정식,,0,0,13,3,1,17,1,3,8,2,2,16
H1S1-12-01,H1S1,고등수학(상),12,도형의 이동,1,점의 평행이동,,2,7,4,0,1,14,8,1,6,0,1,16
H1S1-12-02,H1S1,고등수학(상),12,도형의 이동,2,도형의 평행이동 (1),직선 또는 포물선,0,3,10,2,0,15,0,1,10,1,0,12
H1S1-12-03,H1S1,고등수학(상),12,도형의 이동,3,도형의 평행이동 (2),원,0,3,6,3,0,12,0,2,15,0,0,17
H1S1-12-04,H1S1,고등수학(상),12,도형의 이동,4,평행이동의 활용,,0,0,11,6,0,17,0,0,8,0,1,9
H1S1-12-05,H1S1,고등수학(상),12,도형의 이동,5,도형의 기본축 대칭이동 (1),점,0,0,3,12,0,15,1,0,6,2,1,10
H1S1-12-06,H1S1,고등수학(상),12,도형의 이동,6,도형의 기본축 대칭이동 (2),직선 또는 포물선,0,1,6,6,0,13,3,4,11,1,0,19
H1S1-12-07,H1S1,고등수학(상),12,도형의 이동,7,도형의 기본축 대칭이동 (3),원,0,1,5,5,0,11,0,2,10,0,0,12
H1S1-12-08,H1S1,고등수학(상),12,도형의 이동,8,대칭이동의 활용,,0,0,3,12,0,15,1,0,5,1,1,8
H1S1-12-09,H1S1,고등수학(상),12,도형의 이동,9,점에 대한 대칭이동,,2,1,7,1,0,11,4,1,4,1,0,10
H1S1-12-10,H1S1,고등수학(상),12,도형의 이동,10,직선 y=ax+b 에 대한 대칭이동,,0,0,8,4,0,12,0,0,9,1,1,11
H1S1-12-11,H1S1,고등수학(상),12,도형의 이동,11,평행이동과 대칭이동의 활용,,0,0,6,6,2,14,1,1,6,1,0,9
H1S1-12-12,H1S1,고등수학(상),12,도형의 이동,12,"f(x, y)=0 그래프의 평행이동과 대칭이동",,0,2,8,3,0,13,0,1,6,3,1,11
H1S1-12-13,H1S1,고등수학(상),12,도형의 이동,13,대칭이동을 이용하여 거리의 최솟값 구하기,,0,2,6,8,1,17,0,0,7,2,1,10
H1S2-01-01,H1S2,고등수학(하),1,집합의 뜻과 표현,1,집합의 뜻,,0,0,0,0,0,0,0,0,0,0,0,0
H1S2-01-02,H1S2,고등수학(하),1,집합의 뜻과 표현,2,집합의 표현,"조건제시법, 원소나열법, 벤다이어그램",0,0,0,0,0,0,0,0,0,0,0,0
H1S2-01-03,H1S2,고등수학(하),1,집합의 뜻과 표현,3,집합과 원소 및 부분집합 사이의 관계,"∈,⊂의 사용",0,2,0,0,0,2,0,0,0,0,0,0
H1S2-01-04,H1S2,고등수학(하),1,집합의 뜻과 표현,4,"유한집합, 무한집합, 공집합",,0,0,0,0,0,0,0,0,0,0,0,0
H1S2-01-05,H1S2,고등수학(하),1,집합의 뜻과 표현,5,유한집합의 원소의 개수,,0,1,1,0,0,2,0,0,0,0,0,0
H1S2-01-06,H1S2,고등수학(하),1,집합의 뜻과 표현,6,조건을 만족시키는 집합 구하기,,0,1,0,2,1,4,0,0,0,0,0,0
H1S2-01-07,H1S2,고등수학(하),1,집합의 뜻과 표현,7,집합 사이의 포함 관계를 이용한 미지수 구하기,,0,0,0,0,0,0,0,0,0,0,0,0
H1S2-01-08,H1S2,고등수학(하),1,집합의 뜻과 표현,8,부분집합 또는 부분집합의 개수 구하기,,0,1,0,0,0,1,0,0,0,0,0,0
H1S2-01-09,H1S2,고등수학(하),1,집합의 뜻과 표현,9,특정한 원소를 갖는(갖지 않는) 부분집합의 개수,,0,0,5,1,0,6,0,0,0,0,0,0
H1S2-01-10,H1S2,고등수학(하),1,집합의 뜻과 표현,10,A⊂X⊂B를 만족시키는 집합 X의 개수,,0,0,2,2,0,4,0,0,0,0,0,0
H1S2-02-01,H1S2,고등수학(하),2,집합의 연산,1,합집합과 교집합,,0,26,3,3,1,33,0,0,0,0,0,0
H1S2-02-02,H1S2,고등수학(하),2,집합의 연산,2,여집합과 차집합,,0,11,8,1,0,20,0,0,0,0,0,0
H1S2-02-03,H1S2,고등수학(하),2,집합의 연산,3,서로소인 집합,,0,0,0,0,0,0,0,0,0,0,0,0
H1S2-02-04,H1S2,고등수학(하),2,집합의 연산,4,벤다이어그램의 색칠한 부분이 나타내는 집합,,0,0,0,0,0,0,0,0,0,0,0,0
H1S2-02-05,H1S2,고등수학(하),2,집합의 연산,5,집합의 연산을 이용한 미지수 구하기,,0,0,0,0,1,1,0,0,0,0,0,0
H1S2-02-06,H1S2,고등수학(하),2,집합의 연산,6,집합의 연산의 성질과 연산법칙,,0,0,0,0,0,0,0,0,0,0,0,0
H1S2-02-07,H1S2,고등수학(하),2,집합의 연산,7,집합의 연산의 성질,포함 관계가 있는 두 집합,0,0,0,0,0,0,0,0,0,0,0,0
H1S2-02-08,H1S2,고등수학(하),2,집합의 연산,8,조건을 만족시키는 부분집합의 개수,,0,0,3,0,0,3,0,0,0,0,0,0
H1S2-02-09,H1S2,고등수학(하),2,집합의 연산,9,드모르간의 법칙,,0,0,1,1,0,2,0,0,0,0,0,0
H1S2-02-10,H1S2,고등수학(하),2,집합의 연산,10,항상 같은 집합 구하기,,0,0,0,0,0,0,0,0,0,0,0,0
H1S2-02-11,H1S2,고등수학(하),2,집합의 연산,11,배수와 약수의 집합의 연산,,0,0,0,0,1,1,0,0,0,0,0,0
H1S2-02-12,H1S2,고등수학(하),2,집합의 연산,12,방정식 또는 부등식의 해의 집합의 연산,,0,0,1,0,0,1,0,0,0,0,0,0
H1S2-02-13,H1S2,고등수학(하),2,집합의 연산,13,새롭게 약속된 집합의 연산,,0,0,0,0,0,0,0,0,0,0,0,0
H1S2-02-14,H1S2,고등수학(하),2,집합의 연산,14,유한집합의 원소의 개수와 활용,,0,0,3,7,0,10,0,0,0,0,0,0
H1S2-02-15,H1S2,고등수학(하),2,집합의 연산,15,유한집합의 원소의 개수의 최댓값과 최솟값,,0,0,2,6,0,8,0,0,0,0,0,0
H1S2-03-01,H1S2,고등수학(하),3,명제,1,명제,,0,0,0,0,0,0,0,0,0,0,0,0
H1S2-03-02,H1S2,고등수학(하),3,명제,2,명제와 조건의 부정,,0,0,0,0,0,0,0,0,0,0,0,0
H1S2-03-03,H1S2,고등수학(하),3,명제,3,명제의 참과 거짓,,0,0,3,1,0,4,0,0,0,0,0,0
H1S2-03-04,H1S2,고등수학(하),3,명제,4,거짓인 명제의 반례,,0,0,0,0,0,0,0,0,0,0,0,0
H1S2-03-05,H1S2,고등수학(하),3,명제,5,진리집합,,0,0,2,0,0,2,0,0,0,0,0,0
H1S2-03-06,H1S2,고등수학(하),3,명제,6,"명제의 참, 거짓과 진리집합",,0,0,1,3,0,4,0,0,0,0,0,0
H1S2-03-07,H1S2,고등수학(하),3,명제,7,명제가 참이 되도록 하는 상수 구하기,,0,2,12,1,0,15,0,0,0,0,0,0
H1S2-03-08,H1S2,고등수학(하),3,명제,8,'모든'이나 '어떤'이 있는 명제,,0,0,0,2,0,2,0,0,0,0,0,0
H1S2-03-09,H1S2,고등수학(하),3,명제,9,"명제와 역, 대우의 참, 거짓",,0,0,1,0,0,1,0,0,0,0,0,0
H1S2-03-10,H1S2,고등수학(하),3,명제,10,명제의 대우를 이용하여 미지수 구하기,,0,0,0,0,0,0,0,0,0,0,0,0
H1S2-03-11,H1S2,고등수학(하),3,명제,11,삼단논법,,0,0,0,0,0,0,0,0,0,0,0,0
H1S2-03-12,H1S2,고등수학(하),3,명제,12,삼단논법과 명제의 추론,,0,0,0,0,0,0,0,0,0,0,0,0
H1S2-03-13,H1S2,고등수학(하),3,명제,13,"충분조건, 필요조건, 필요충분조건",,0,0,0,0,0,0,0,0,0,0,0,0
H1S2-03-14,H1S2,고등수학(하),3,명제,14,"충분조건, 필요조건과 명제의 참, 거짓",,0,0,0,0,0,0,0,0,0,0,0,0
H1S2-03-15,H1S2,고등수학(하),3,명제,15,충분·필요·필요충분조건과 진리집합,,0,0,0,0,0,0,0,0,0,0,0,0
H1S2-03-16,H1S2,고등수학(하),3,명제,16,충분·필요·필요충분조건이 되도록 하는 미지수 구하기,,0,0,23,7,1,31,0,0,0,0,0,0
H1S2-03-17,H1S2,고등수학(하),3,명제,17,대우를 이용한 명제의 증명,,0,0,0,0,0,0,0,0,0,0,0,0
H1S2-03-18,H1S2,고등수학(하),3,명제,18,귀류법,,0,0,0,0,0,0,0,0,0,0,0,0
H1S2-03-19,H1S2,고등수학(하),3,명제,19,실수의 성질을 이용한 절대부등식의 증명,,0,0,0,0,0,0,0,0,0,0,0,0
H1S2-03-20,H1S2,고등수학(하),3,명제,20,절댓값 기호를 포함한 절대부등식,,0,0,0,0,0,0,0,0,0,0,0,0
H1S2-03-21,H1S2,고등수학(하),3,명제,21,산술평균과 기하평균의 관계 (1),곱의 최솟값 구하기,0,0,1,0,0,1,0,0,0,0,0,0
H1S2-03-22,H1S2,고등수학(하),3,명제,22,산술평균과 기하평균의 관계 (2),합의 최솟값 구하기,0,0,7,0,0,7,0,0,0,0,0,0
H1S2-03-23,H1S2,고등수학(하),3,명제,23,산술평균과 기하평균의 관계 (3),합 또는 곱이 일정할 때,0,0,0,0,0,0,0,0,0,0,0,0
H1S2-03-24,H1S2,고등수학(하),3,명제,24,산술평균과 기하평균의 관계 (4),복잡한 식의 최대와 최소,0,0,0,0,0,0,0,0,0,0,0,0
H1S2-03-25,H1S2,고등수학(하),3,명제,25,산술평균과 기하평균의 관계 (5),도형에서의 활용,0,0,1,4,0,5,0,0,0,0,0,0
H1S2-03-26,H1S2,고등수학(하),3,명제,26,코시-슈바르츠의 부등식 (1),ax+by의 최대와 최소,0,0,0,0,0,0,0,0,0,0,0,0
H1S2-03-27,H1S2,고등수학(하),3,명제,27,코시-슈바르츠의 부등식 (2),x²+y²의 최대와 최소,0,0,0,0,0,0,0,0,0,0,0,0
H1S2-03-28,H1S2,고등수학(하),3,명제,28,코시-슈바르츠의 부등식 (3),ax+by+cz의 최대와 최소,0,0,0,0,0,0,0,0,0,0,0,0
H1S2-03-29,H1S2,고등수학(하),3,명제,29,코시-슈바르츠의 부등식 (4),도형에서의 활용,0,0,0,0,0,0,0,0,0,0,0,0
H1S2-04-01,H1S2,고등수학(하),4,함수,1,함수의 뜻,,0,0,1,0,0,1,0,0,0,0,0,0
H1S2-04-02,H1S2,고등수학(하),4,함수,2,함수의 값,,0,0,0,1,0,1,0,0,0,0,0,0
H1S2-04-03,H1S2,고등수학(하),4,함수,3,"함수의 정의역, 공역, 치역",,0,1,0,0,0,1,0,0,0,0,0,0
H1S2-04-04,H1S2,고등수학(하),4,함수,4,조건을 이용하여 함숫값 구하기,,0,0,0,1,0,1,0,0,0,0,0,0
H1S2-04-05,H1S2,고등수학(하),4,함수,5,서로 같은 함수,,0,0,0,0,0,0,0,0,0,0,0,0
H1S2-04-06,H1S2,고등수학(하),4,함수,6,일대일대응 찾기,,0,0,0,0,0,0,0,0,0,0,0,0
H1S2-04-07,H1S2,고등수학(하),4,함수,7,일대일대응이 되도록 하는 미지수 구하기,,0,0,3,1,0,4,0,0,0,0,0,0
H1S2-04-08,H1S2,고등수학(하),4,함수,8,항등함수와 상수함수,,0,0,1,0,1,2,0,0,0,0,0,0
H1S2-04-09,H1S2,고등수학(하),4,함수,9,조건을 만족시키는 함수의 개수,,0,0,1,0,0,1,0,0,0,0,0,0
H1S2-04-10,H1S2,고등수학(하),4,함수,10,합성함수의 성질과 함숫값,,0,2,18,3,0,23,0,0,0,0,0,0
H1S2-04-11,H1S2,고등수학(하),4,함수,11,f∘g=g∘f인 경우,,0,0,0,1,0,1,0,0,0,0,0,0
H1S2-04-12,H1S2,고등수학(하),4,함수,12,f∘g에 대한 조건이 주어진 경우 ,,0,1,3,2,0,6,0,0,0,0,0,0
H1S2-04-13,H1S2,고등수학(하),4,함수,13,f∘g=h를 만족시키는 함수 f 또는 g 구하기,,0,0,0,1,0,1,0,0,0,0,0,0
H1S2-04-14,H1S2,고등수학(하),4,함수,14,fⁿ 꼴의 합성함수,,0,0,0,2,0,2,0,0,0,0,0,0
H1S2-04-15,H1S2,고등수학(하),4,함수,15,함수의 그래프와 합성함수,,0,0,0,1,2,3,0,0,0,0,0,0
H1S2-04-16,H1S2,고등수학(하),4,함수,16,역함수의 정의 ,,0,2,14,1,0,17,0,0,0,0,0,0
H1S2-04-17,H1S2,고등수학(하),4,함수,17,역함수가 존재하기 위한 조건,,0,0,0,2,0,2,0,0,0,0,0,0
H1S2-04-18,H1S2,고등수학(하),4,함수,18,역함수 구하기,,0,0,3,0,0,3,0,0,0,0,0,0
H1S2-04-19,H1S2,고등수학(하),4,함수,19,합성함수와 역함수,,0,0,7,2,1,10,0,0,0,0,0,0
H1S2-04-20,H1S2,고등수학(하),4,함수,20,역함수의 성질,,0,0,0,0,0,0,0,0,0,0,0,0
H1S2-04-21,H1S2,고등수학(하),4,함수,21,함수의 그래프와 역함수의 함숫값,,0,0,0,0,0,0,0,0,0,0,0,0
H1S2-04-22,H1S2,고등수학(하),4,함수,22,함수와 역함수의 교점,,0,0,2,1,0,3,0,0,0,0,0,0
H1S2-04-23,H1S2,고등수학(하),4,함수,23,절댓값 기호를 포함한 함수,,0,0,0,1,0,1,0,0,0,0,0,0
H1S2-04-24,H1S2,고등수학(하),4,함수,24,두 개 이상의 절댓값 기호를 포함한 함수,,0,0,0,0,0,0,0,0,0,0,0,0
H1S2-05-01,H1S2,고등수학(하),5,유리함수,1,유리식의 사칙연산,,0,0,0,0,0,0,0,0,0,0,0,0
H1S2-05-02,H1S2,고등수학(하),5,유리함수,2,유리식과 항등식,,0,0,0,0,0,0,0,0,0,0,0,0
H1S2-05-03,H1S2,고등수학(하),5,유리함수,3,(분자의 차수)≥(분모의 차수)인 유리식,,0,0,0,0,0,0,0,0,0,0,0,0
H1S2-05-04,H1S2,고등수학(하),5,유리함수,4,부분분수로의 변형,,0,0,0,0,0,0,0,0,0,0,0,0
H1S2-05-05,H1S2,고등수학(하),5,유리함수,5,번분수식,,0,0,0,0,0,0,0,0,0,0,0,0
H1S2-05-06,H1S2,고등수학(하),5,유리함수,6,분수를 번분수로 나타내기,,0,0,0,0,0,0,0,0,0,0,0,0
H1S2-05-07,H1S2,고등수학(하),5,유리함수,7,유리식의 값 (1),xⁿ±1/xⁿ의 값,0,0,0,0,0,0,0,0,0,0,0,0
H1S2-05-08,H1S2,고등수학(하),5,유리함수,8,유리식의 값 (2),a+b+c=0 일 때,0,0,0,0,0,0,0,0,0,0,0,0
H1S2-05-09,H1S2,고등수학(하),5,유리함수,9,유리식의 값 (3),방정식이 주어질 때,0,0,0,0,0,0,0,0,0,0,0,0
H1S2-05-10,H1S2,고등수학(하),5,유리함수,10,유리식의 값 (4),비례식이 주어질 때,0,0,0,0,0,0,0,0,0,0,0,0
H1S2-05-11,H1S2,고등수학(하),5,유리함수,11,비례식을 만족시키는 상수 구하기,,0,0,0,0,0,0,0,0,0,0,0,0
H1S2-05-12,H1S2,고등수학(하),5,유리함수,12,유리식의 활용,,0,0,1,0,0,1,0,0,0,0,0,0
H1S2-05-13,H1S2,고등수학(하),5,유리함수,13,유리함수의 정의역과 치역,,0,0,0,0,0,0,0,0,0,0,0,0
H1S2-05-14,H1S2,고등수학(하),5,유리함수,14,유리함수의 그래프와 평행이동,,0,0,3,0,0,3,0,0,0,0,0,0
H1S2-05-15,H1S2,고등수학(하),5,유리함수,15,유리함수의 그래프의 점근선,,0,0,11,4,0,15,0,0,0,0,0,0
H1S2-05-16,H1S2,고등수학(하),5,유리함수,16,유리함수의 그래프의 대칭성,,0,0,5,0,0,5,0,0,0,0,0,0
H1S2-05-17,H1S2,고등수학(하),5,유리함수,17,유리함수의 그래프가 지나는 사분면,,0,0,2,1,0,3,0,0,0,0,0,0
H1S2-05-18,H1S2,고등수학(하),5,유리함수,18,그래프를 이용하여 유리함수의 식 구하기,,0,0,0,0,0,0,0,0,0,0,0,0
H1S2-05-19,H1S2,고등수학(하),5,유리함수,19,유리함수의 최대·최소,,0,0,2,0,1,3,0,0,0,0,0,0
H1S2-05-20,H1S2,고등수학(하),5,유리함수,20,유리함수의 그래프의 성질,,0,0,0,0,0,0,0,0,0,0,0,0
H1S2-05-21,H1S2,고등수학(하),5,유리함수,21,유리함수의 그래프와 직선의 위치 관계,,0,0,0,1,0,1,0,0,0,0,0,0
H1S2-05-22,H1S2,고등수학(하),5,유리함수,22,유리함수 그래프의 활용,,0,0,2,6,2,10,0,0,0,0,0,0
H1S2-05-23,H1S2,고등수학(하),5,유리함수,23,유리함수의 합성,,0,0,0,1,0,1,0,0,0,0,0,0
H1S2-05-24,H1S2,고등수학(하),5,유리함수,24,유리함수의 역함수,,0,0,2,1,0,3,0,0,0,0,0,0
H1S2-05-25,H1S2,고등수학(하),5,유리함수,25,유리함수의 합성함수와 역함수,,0,0,0,0,0,0,0,0,0,0,0,0
H1S2-06-01,H1S2,고등수학(하),6,무리함수,1,무리식의 값이 실수가 되기 위한 조건,,0,0,0,0,0,0,0,0,0,0,0,0
H1S2-06-02,H1S2,고등수학(하),6,무리함수,2,제곱근의 성질,,0,0,0,0,0,0,0,0,0,0,0,0
H1S2-06-03,H1S2,고등수학(하),6,무리함수,3,분모의 유리화,,0,0,1,0,0,1,0,0,0,0,0,0
H1S2-06-04,H1S2,고등수학(하),6,무리함수,4,무리식의 값 구하기 (1),x= a±√b 꼴,0,0,0,0,0,0,0,0,0,0,0,0
H1S2-06-05,H1S2,고등수학(하),6,무리함수,5,무리식의 값 구하기 (2),"x= √a+√b, y=√a-√b 꼴",0,0,0,0,0,0,0,0,0,0,0,0
H1S2-06-06,H1S2,고등수학(하),6,무리함수,6,무리함수의 정의역과 치역,,0,0,0,0,0,0,0,0,0,0,0,0
H1S2-06-07,H1S2,고등수학(하),6,무리함수,7,무리함수의 그래프의 평행이동과 대칭이동,,0,1,14,5,0,20,0,0,0,0,0,0
H1S2-06-08,H1S2,고등수학(하),6,무리함수,8,무리함수의 그래프가 지나는 사분면,,0,0,0,0,0,0,0,0,0,0,0,0
H1S2-06-09,H1S2,고등수학(하),6,무리함수,9,그래프를 이용한 무리함수의 식 또는 부호 구하기,,0,0,1,0,0,1,0,0,0,0,0,0
H1S2-06-10,H1S2,고등수학(하),6,무리함수,10,무리함수의 그래프의 성질,,0,0,3,2,1,6,0,0,0,0,0,0
H1S2-06-11,H1S2,고등수학(하),6,무리함수,11,무리함수의 최대와 최소,,0,0,4,0,0,4,0,0,0,0,0,0
H1S2-06-12,H1S2,고등수학(하),6,무리함수,12,무리함수의 그래프와 직선의 위치 관계,,0,0,0,0,0,0,0,0,0,0,0,0
H1S2-06-13,H1S2,고등수학(하),6,무리함수,13,무리함수의 역함수와 그 성질,,0,1,1,1,0,3,0,0,0,0,0,0
H1S2-06-14,H1S2,고등수학(하),6,무리함수,14,무리함수의 합성함수와 역함수,,0,0,0,1,0,1,0,0,0,0,0,0
H1S2-06-15,H1S2,고등수학(하),6,무리함수,15,유리함수와 무리함수의 그래프,,0,0,1,3,1,5,0,0,0,0,0,0
H1S2-07-01,H1S2,고등수학(하),7,순열과 조합,1,합의 법칙,,0,0,0,1,0,1,0,0,0,0,0,0
H1S2-07-02,H1S2,고등수학(하),7,순열과 조합,2,곱의 법칙,,0,0,1,0,0,1,0,0,0,0,0,0
H1S2-07-03,H1S2,고등수학(하),7,순열과 조합,3,방정식 혹은 부등식을 만족시키는 순서쌍의 개수,,0,0,0,0,0,0,0,0,0,0,0,0
H1S2-07-04,H1S2,고등수학(하),7,순열과 조합,4,약수의 개수,,0,0,0,0,0,0,0,0,0,0,0,0
H1S2-07-05,H1S2,고등수학(하),7,순열과 조합,5,수형도를 이용하는 경우의 수,,0,0,0,0,0,0,0,0,0,0,0,0
H1S2-07-06,H1S2,고등수학(하),7,순열과 조합,6,지불 방법의 수와 지불 금액의 수,,0,0,0,0,0,0,0,0,0,0,0,0
H1S2-07-07,H1S2,고등수학(하),7,순열과 조합,7,도로망에서의 방법의 수,,0,0,0,0,0,0,0,0,0,0,0,0
H1S2-07-08,H1S2,고등수학(하),7,순열과 조합,8,색칠하는 방법의 수,,0,0,0,0,0,0,0,0,0,0,0,0
H1S2-07-09,H1S2,고등수학(하),7,순열과 조합,9,대표를 뽑는 순열의 수,,0,0,0,0,0,0,0,0,0,0,0,0
H1S2-07-10,H1S2,고등수학(하),7,순열과 조합,10,이웃하거나 이웃하지 않는 순열의 수,,0,1,0,0,1,2,0,0,0,0,0,0
H1S2-07-11,H1S2,고등수학(하),7,순열과 조합,11,자리에 대한 조건이 있는 순열의 수,,0,0,0,0,1,1,0,0,0,0,0,0
H1S2-07-12,H1S2,고등수학(하),7,순열과 조합,12,'적어도'의 조건이 있는 순열의 수,,0,0,0,0,0,0,0,0,0,0,0,0
H1S2-07-13,H1S2,고등수학(하),7,순열과 조합,13,조건을 만족하는 자연수의 개수,,0,0,1,0,0,1,0,0,0,0,0,0
H1S2-07-14,H1S2,고등수학(하),7,순열과 조합,14,사전식으로 배열하는 방법의 수,,0,0,0,0,0,0,0,0,0,0,0,0
H1S2-07-15,H1S2,고등수학(하),7,순열과 조합,15,순열기호 P와 조합기호 C의 계산,,0,25,1,0,0,26,0,0,0,0,0,0
H1S2-07-16,H1S2,고등수학(하),7,순열과 조합,16,순열기호 P와 조합기호 C를 이용한 증명,,0,0,0,0,0,0,0,0,0,0,0,0
H1S2-07-17,H1S2,고등수학(하),7,순열과 조합,17,조합의 수,,0,0,3,6,0,9,0,0,0,0,0,0
H1S2-07-18,H1S2,고등수학(하),7,순열과 조합,18,특정한 것을 포함하거나 포함하지 않는 조합의 수,,0,0,0,1,0,1,0,0,0,0,0,0
H1S2-07-19,H1S2,고등수학(하),7,순열과 조합,19,'적어도'의 조건이 있는 조합의 수,,0,0,0,1,0,1,0,0,0,0,0,0
H1S2-07-20,H1S2,고등수학(하),7,순열과 조합,20,뽑아서 나열하는 방법의 수,,0,0,1,0,0,1,0,0,0,0,0,0
H1S2-07-21,H1S2,고등수학(하),7,순열과 조합,21,함수의 개수,,0,0,1,4,0,5,0,0,0,0,0,0
H1S2-07-22,H1S2,고등수학(하),7,순열과 조합,22,직선 또는 대각선의 개수,,0,0,0,0,0,0,0,0,0,0,0,0
H1S2-07-23,H1S2,고등수학(하),7,순열과 조합,23,주어진 점으로 만들수 있는 다각형의 개수,,0,0,0,0,1,1,0,0,0,0,0,0
H1S2-07-24,H1S2,고등수학(하),7,순열과 조합,24,주어진 선분으로 만들수 있는 다각형의 개수,,0,0,0,0,0,0,0,0,0,0,0,0
H1S2-07-25,H1S2,고등수학(하),7,순열과 조합,25,분할하는 방법의 수,,0,1,18,3,0,22,0,0,0,0,0,0
H1S2-07-26,H1S2,고등수학(하),7,순열과 조합,26,분할한 후 분배하는 방법의 수,,0,0,2,2,0,4,0,0,0,0,0,0
H1S2-07-27,H1S2,고등수학(하),7,순열과 조합,27,대진표 작성하기,,0,0,0,0,0,0,0,0,0,0,0,0
HCAL-01-01,HCAL,미적분,1,수열의 극한,1,수열의 수렴과 발산,,0,1,0,0,0,1,0,0,0,0,0,0
HCAL-01-02,HCAL,미적분,1,수열의 극한,2,수열의 극한에 대한 기본 성질,,0,1,5,0,0,6,0,0,0,0,0,0
HCAL-01-03,HCAL,미적분,1,수열의 극한,3,lim(n→∞) a_n = lim(n→∞) a_(n+1) = α의 이용,,0,0,0,0,0,0,0,0,0,0,0,0
HCAL-01-04,HCAL,미적분,1,수열의 극한,4,∞/∞ 꼴의 극한 (1),,0,18,0,4,1,23,0,0,0,0,0,0
HCAL-01-05,HCAL,미적분,1,수열의 극한,5,∞/∞ 꼴의 극한 (2),합 또는 곱,0,0,0,0,0,0,0,0,0,0,0,0
HCAL-01-06,HCAL,미적분,1,수열의 극한,6,∞/∞ 꼴의 극한 (3),로그를 포함한 식,0,0,0,0,0,0,0,0,0,0,0,0
HCAL-01-07,HCAL,미적분,1,수열의 극한,7,∞/∞ 꼴의 극한 (4),미정계수의 결정,0,0,1,0,0,1,0,0,0,0,0,0
HCAL-01-08,HCAL,미적분,1,수열의 극한,8,∞-∞ 꼴의 극한 (1),,0,1,2,2,0,5,0,0,0,0,0,0
HCAL-01-09,HCAL,미적분,1,수열의 극한,9,∞-∞ 꼴의 극한 (2),분수 꼴,0,0,0,0,0,0,0,0,0,0,0,0
HCAL-01-10,HCAL,미적분,1,수열의 극한,10,∞-∞ 꼴의 극한 (3),미정계수의 결정,0,0,0,0,0,0,0,0,0,0,0,0
HCAL-01-11,HCAL,미적분,1,수열의 극한,11,일반항 a_n을 포함한 식의 극한값,,0,0,0,0,0,0,0,0,0,0,0,0
HCAL-01-12,HCAL,미적분,1,수열의 극한,12,수열의 극한의 대소 관계,,0,0,4,0,0,4,0,0,0,0,0,0
HCAL-01-13,HCAL,미적분,1,수열의 극한,13,"수열의 극한에 대한 참, 거짓 판별",,0,0,0,0,0,0,0,0,0,0,0,0
HCAL-01-14,HCAL,미적분,1,수열의 극한,14,등비수열의 극한,,0,6,5,3,0,14,0,0,0,0,0,0
HCAL-01-15,HCAL,미적분,1,수열의 극한,15,등비수열의 수렴 조건,,0,0,0,1,0,1,0,0,0,0,0,0
HCAL-01-16,HCAL,미적분,1,수열의 극한,16,rⁿ을 포함한 수열의 극한,,0,1,0,0,0,1,0,0,0,0,0,0
HCAL-01-17,HCAL,미적분,1,수열의 극한,17,xⁿ을 포함한 극한으로 정의된 함수,,0,0,1,6,2,9,0,0,0,0,0,0
HCAL-01-18,HCAL,미적분,1,수열의 극한,18,수열의 극한의 활용,,0,0,0,11,1,12,0,0,0,0,0,0
HCAL-01-19,HCAL,미적분,1,수열의 극한,19,귀납적으로 정의된 수열의 극한,,0,0,0,0,1,1,0,0,0,0,0,0
HCAL-02-01,HCAL,미적분,2,급수,1,부분분수를 이용하는 급수,,0,1,3,0,1,5,0,0,0,0,0,0
HCAL-02-02,HCAL,미적분,2,급수,2,로그를 포함한 급수,,0,0,0,0,0,0,0,0,0,0,0,0
HCAL-02-03,HCAL,미적분,2,급수,3,항의 부호가 교대로 바뀌는 급수,,0,0,0,0,0,0,0,0,0,0,0,0
HCAL-02-04,HCAL,미적분,2,급수,4,급수와 수열의 극한값 사이의 관계,,0,0,17,3,0,20,0,0,0,0,0,0
HCAL-02-05,HCAL,미적분,2,급수,5,급수의 수렴과 발산,,0,0,0,0,0,0,0,0,0,0,0,0
HCAL-02-06,HCAL,미적분,2,급수,6,급수의 성질,,0,0,0,0,0,0,0,0,0,0,0,0
HCAL-02-07,HCAL,미적분,2,급수,7,"급수의 성질에 대한 참, 거짓 판별",,0,0,0,0,0,0,0,0,0,0,0,0
HCAL-02-08,HCAL,미적분,2,급수,8,급수의 활용,,0,0,0,0,1,1,0,0,0,0,0,0
HCAL-02-09,HCAL,미적분,2,급수,9,등비급수의 합,,0,0,0,4,0,4,0,0,0,0,0,0
HCAL-02-10,HCAL,미적분,2,급수,10,합이 주어진 등비급수,,0,0,1,0,0,1,0,0,0,0,0,0
HCAL-02-11,HCAL,미적분,2,급수,11,등비급수의 수렴 조건,,0,0,3,0,0,3,0,0,0,0,0,0
HCAL-02-12,HCAL,미적분,2,급수,12,S_n과 a_n 사이의 관계를 이용하는 급수,,0,0,0,0,0,0,0,0,0,0,0,0
HCAL-02-13,HCAL,미적분,2,급수,13,등비급수의 도형에의 활용 (1),좌표,0,0,0,0,0,0,0,0,0,0,0,0
HCAL-02-14,HCAL,미적분,2,급수,14,등비급수의 도형에의 활용 (2),선분의 길이,0,0,0,0,0,0,0,0,0,0,0,0
HCAL-02-15,HCAL,미적분,2,급수,15,등비급수의 도형에의 활용 (3),둘레의 길이,0,0,0,1,0,1,0,0,0,0,0,0
HCAL-02-16,HCAL,미적분,2,급수,16,등비급수의 도형에의 활용 (4),넓이,0,0,0,34,2,36,0,0,0,0,0,0
HCAL-02-17,HCAL,미적분,2,급수,17,등비급수의 실생활에의 활용,,0,0,0,0,0,0,0,0,0,0,0,0
HCAL-02-18,HCAL,미적분,2,급수,18,순환소수와 등비급수,,0,0,0,0,0,0,0,0,0,0,0,0
HCAL-03-01,HCAL,미적분,3,지수함수와 로그함수의 미분,1,지수함수의 극한,,0,0,0,0,0,0,0,0,0,0,0,0
HCAL-03-02,HCAL,미적분,3,지수함수와 로그함수의 미분,2,로그함수의 극한,,0,0,0,0,0,0,0,0,0,0,0,0
HCAL-03-03,HCAL,미적분,3,지수함수와 로그함수의 미분,3,무리수 e,,0,1,0,0,0,1,0,0,0,0,0,0
HCAL-03-04,HCAL,미적분,3,지수함수와 로그함수의 미분,4,지수함수와 로그함수의 극한 (1),밑이 e인 경우,0,16,3,1,0,20,0,0,0,0,0,0
HCAL-03-05,HCAL,미적분,3,지수함수와 로그함수의 미분,5,지수함수와 로그함수의 극한 (2),밑이 e가 아닌 경우,0,0,0,0,0,0,0,0,0,0,0,0
HCAL-03-06,HCAL,미적분,3,지수함수와 로그함수의 미분,6,지수함수와 로그함수의 극한에서 미정계수의 결정,,0,0,0,0,0,0,0,0,0,0,0,0
HCAL-03-07,HCAL,미적분,3,지수함수와 로그함수의 미분,7,지수함수와 로그함수의 극한의 활용,,0,0,1,3,0,4,0,0,0,0,0,0
HCAL-03-08,HCAL,미적분,3,지수함수와 로그함수의 미분,8,지수함수와 로그함수의 연속과 미정계수,,0,0,1,0,0,1,0,0,0,0,0,0
HCAL-03-09,HCAL,미적분,3,지수함수와 로그함수의 미분,9,지수함수의 도함수,,0,2,2,0,0,4,0,0,0,0,0,0
HCAL-03-10,HCAL,미적분,3,지수함수와 로그함수의 미분,10,로그함수의 도함수,,0,1,2,0,0,3,0,0,0,0,0,0
HCAL-03-11,HCAL,미적분,3,지수함수와 로그함수의 미분,11,지수함수와 로그함수의 미분가능성,,0,0,2,1,0,3,0,0,0,0,0,0
HCAL-04-01,HCAL,미적분,4,삼각함수의 미분,1,삼각함수,,0,2,0,0,0,2,0,0,0,0,0,0
HCAL-04-02,HCAL,미적분,4,삼각함수의 미분,2,삼각함수 사이의 관계,,0,2,2,0,0,4,0,0,0,0,0,0
HCAL-04-03,HCAL,미적분,4,삼각함수의 미분,3,삼각함수의 덧셈정리,,0,1,5,3,0,9,0,0,0,0,0,0
HCAL-04-04,HCAL,미적분,4,삼각함수의 미분,4,삼각함수의 덧셈정리의 활용,,0,0,2,6,0,8,0,0,0,0,0,0
HCAL-04-05,HCAL,미적분,4,삼각함수의 미분,5,두직선이 이루는 각의 크기,,0,0,0,0,0,0,0,0,0,0,0,0
HCAL-04-06,HCAL,미적분,4,삼각함수의 미분,6,배각의 공식,,0,0,0,0,0,0,0,0,0,0,0,0
HCAL-04-07,HCAL,미적분,4,삼각함수의 미분,7,반각의 공식,,0,0,0,0,0,0,0,0,0,0,0,0
HCAL-04-08,HCAL,미적분,4,삼각함수의 미분,8,삼각함수의 합성,,0,0,0,0,0,0,0,0,0,0,0,0
HCAL-04-09,HCAL,미적분,4,삼각함수의 미분,9,삼각함수의 극한,,0,1,0,1,0,2,0,0,0,0,0,0
HCAL-04-10,HCAL,미적분,4,삼각함수의 미분,10,"함수 sinx/x, tanx/x의 극한",,0,2,0,0,0,2,0,0,0,0,0,0
HCAL-04-11,HCAL,미적분,4,삼각함수의 미분,11,치환을 이용한 삼각함수의 극한,,0,0,0,0,0,0,0,0,0,0,0,0
HCAL-04-12,HCAL,미적분,4,삼각함수의 미분,12,삼각함수의 극한에서 미정계수의 결정,,0,0,0,0,0,0,0,0,0,0,0,0
HCAL-04-13,HCAL,미적분,4,삼각함수의 미분,13,삼각함수의 극한의 활용,,0,0,0,14,6,20,0,0,0,0,0,0
HCAL-04-14,HCAL,미적분,4,삼각함수의 미분,14,삼각함수의 연속과 미정계수,,0,0,0,0,0,0,0,0,0,0,0,0
HCAL-04-15,HCAL,미적분,4,삼각함수의 미분,15,삼각함수의 도함수,,0,3,4,1,0,8,0,0,0,0,0,0
HCAL-04-16,HCAL,미적분,4,삼각함수의 미분,16,삼각함수의 미분가능성,,0,0,0,0,0,0,0,0,0,0,0,0
HCAL-05-01,HCAL,미적분,5,여러 가지 미분법,1,함수의 몫의 미분법,,0,2,2,0,0,4,0,0,0,0,0,0
HCAL-05-02,HCAL,미적분,5,여러 가지 미분법,2,삼각함수의 도함수,,0,0,2,0,0,2,0,0,0,0,0,0
HCAL-05-03,HCAL,미적분,5,여러 가지 미분법,3,합성함수의 미분법 (1),"다항함수, 유리함수",0,0,1,0,0,1,0,0,0,0,0,0
HCAL-05-04,HCAL,미적분,5,여러 가지 미분법,4,합성함수의 미분법 (2),"지수함수, 삼각함수",0,3,2,2,0,7,0,0,0,0,0,0
HCAL-05-05,HCAL,미적분,5,여러 가지 미분법,5,합성함수의 미분법 (3),로그함수,0,1,0,0,1,2,0,0,0,0,0,0
HCAL-05-06,HCAL,미적분,5,여러 가지 미분법,6,합성함수 미분법의 응용,,0,0,0,1,0,1,0,0,0,0,0,0
HCAL-05-07,HCAL,미적분,5,여러 가지 미분법,7,로그함수 도함수의 응용,,0,0,0,0,0,0,0,0,0,0,0,0
HCAL-05-08,HCAL,미적분,5,여러 가지 미분법,8,함수 y=xⁿ (n은 실수)의 도함수 ,,0,1,0,0,0,1,0,0,0,0,0,0
HCAL-05-09,HCAL,미적분,5,여러 가지 미분법,9,매개변수로 나타낸 함수의 미분법,,0,0,7,1,0,8,0,0,0,0,0,0
HCAL-05-10,HCAL,미적분,5,여러 가지 미분법,10,음함수의 미분법,,0,0,8,1,0,9,0,0,0,0,0,0
HCAL-05-11,HCAL,미적분,5,여러 가지 미분법,11,역함수의 미분법 ,,0,0,4,0,0,4,0,0,0,0,0,0
HCAL-05-12,HCAL,미적분,5,여러 가지 미분법,12,역함수의 미분법의 응용,,0,0,5,5,2,12,0,0,0,0,0,0
HCAL-05-13,HCAL,미적분,5,여러 가지 미분법,13,이계도함수,,0,0,2,0,1,3,0,0,0,0,0,0
HCAL-06-01,HCAL,미적분,6,도함수의 활용 (1),1,접선의 방정식 (1),접점의 좌표가 주어진 경우,0,1,4,2,0,7,0,0,0,0,0,0
HCAL-06-02,HCAL,미적분,6,도함수의 활용 (1),2,접선의 방정식 (2),기울기가 주어진 경우,0,0,0,0,0,0,0,0,0,0,0,0
HCAL-06-03,HCAL,미적분,6,도함수의 활용 (1),3,접선의 방정식 (3),곡선 밖의 한점이 주어진 경우,0,0,0,0,1,1,0,0,0,0,0,0
HCAL-06-04,HCAL,미적분,6,도함수의 활용 (1),4,곡선 밖의 한 점에서 그은 접선의 개수,,0,0,0,1,0,1,0,0,0,0,0,0
HCAL-06-05,HCAL,미적분,6,도함수의 활용 (1),5,공통인 접선,,0,0,0,0,0,0,0,0,0,0,0,0
HCAL-06-06,HCAL,미적분,6,도함수의 활용 (1),6,다양한 꼴로 나타난 함수의 접선의 방정식,,0,0,0,1,0,1,0,0,0,0,0,0
HCAL-06-07,HCAL,미적분,6,도함수의 활용 (1),7,함수의 증가와 감소,,0,0,1,0,0,1,0,0,0,0,0,0
HCAL-06-08,HCAL,미적분,6,도함수의 활용 (1),8,구간에서 함수가 증가 또는 감소하기 위한 조건,,0,0,1,0,0,1,0,0,0,0,0,0
HCAL-06-09,HCAL,미적분,6,도함수의 활용 (1),9,함수의 극대와 극소 (1),"유리함수, 무리함수",0,0,1,0,0,1,0,0,0,0,0,0
HCAL-06-10,HCAL,미적분,6,도함수의 활용 (1),10,함수의 극대와 극소 (2),"지수함수, 삼각함수, 로그함수",0,0,1,2,1,4,0,0,0,0,0,0
HCAL-06-11,HCAL,미적분,6,도함수의 활용 (1),11,극값을 가질 조건,,0,0,0,1,1,2,0,0,0,0,0,0
HCAL-07-01,HCAL,미적분,7,도함수의 활용 (2),1,곡선의 오목과 볼록,,0,0,0,0,0,0,0,0,0,0,0,0
HCAL-07-02,HCAL,미적분,7,도함수의 활용 (2),2,변곡점,,0,0,2,0,1,3,0,0,0,0,0,0
HCAL-07-03,HCAL,미적분,7,도함수의 활용 (2),3,변곡점을 이용한 미정계수의 결정,,0,0,0,1,0,1,0,0,0,0,0,0
HCAL-07-04,HCAL,미적분,7,도함수의 활용 (2),4,도함수를 이용한 그래프의 해석,,0,0,0,2,2,4,0,0,0,0,0,0
HCAL-07-05,HCAL,미적분,7,도함수의 활용 (2),5,함수의 그래프 (1),"유리함수, 무리함수",0,0,0,0,0,0,0,0,0,0,0,0
HCAL-07-06,HCAL,미적분,7,도함수의 활용 (2),6,함수의 그래프 (2),"지수함수, 삼각함수, 로그함수",0,0,1,1,3,5,0,0,0,0,0,0
HCAL-07-07,HCAL,미적분,7,도함수의 활용 (2),7,함수의 최대와 최소 (1),"유리함수, 무리함수",0,0,0,1,0,1,0,0,0,0,0,0
HCAL-07-08,HCAL,미적분,7,도함수의 활용 (2),8,함수의 최대와 최소 (2),"지수함수, 삼각함수, 로그함수",0,0,0,1,2,3,0,0,0,0,0,0
HCAL-07-09,HCAL,미적분,7,도함수의 활용 (2),9,함수의 최대와 최소의 활용,,0,0,0,0,2,2,0,0,0,0,0,0
HCAL-07-10,HCAL,미적분,7,도함수의 활용 (2),10,방정식의 실근의 개수,,0,0,0,4,1,5,0,0,0,0,0,0
HCAL-07-11,HCAL,미적분,7,도함수의 활용 (2),11,부등식이 성립할 조건,,0,0,0,1,1,2,0,0,0,0,0,0
HCAL-07-12,HCAL,미적분,7,도함수의 활용 (2),12,직선 운동에서의 속도와 가속도,,0,0,0,1,0,1,0,0,0,0,0,0
HCAL-07-13,HCAL,미적분,7,도함수의 활용 (2),13,평면 운동에서의 속도와 가속도,,0,0,3,1,0,4,0,0,0,0,0,0
HCAL-08-01,HCAL,미적분,8,여러가지 적분법,1,함수 y=xn(n은 실수)의 부정적분,,0,0,0,0,0,0,0,0,0,0,0,0
HCAL-08-02,HCAL,미적분,8,여러가지 적분법,2,지수함수의 부정적분,,0,0,0,0,0,0,0,0,0,0,0,0
HCAL-08-03,HCAL,미적분,8,여러가지 적분법,3,삼각함수의 부정적분,,0,0,0,0,0,0,0,0,0,0,0,0
HCAL-08-04,HCAL,미적분,8,여러가지 적분법,4,치환적분법 (1),"유리함수, 무리함수",0,0,2,0,0,2,0,0,0,0,0,0
HCAL-08-05,HCAL,미적분,8,여러가지 적분법,5,치환적분법 (2),"지수함수, 삼각함수, 로그함수",0,0,2,3,0,5,0,0,0,0,0,0
HCAL-08-06,HCAL,미적분,8,여러가지 적분법,6,∫f(g(x))g'(x)dx 꼴의 부정적분,,0,0,0,0,2,2,0,0,0,0,0,0
HCAL-08-07,HCAL,미적분,8,여러가지 적분법,7,∫f'(x)/f(x)dx 꼴의 부정적분,,0,0,0,2,0,2,0,0,0,0,0,0
HCAL-08-08,HCAL,미적분,8,여러가지 적분법,8,유리함수의 부정적분,,0,0,1,0,0,1,0,0,0,0,0,0
HCAL-08-09,HCAL,미적분,8,여러가지 적분법,9,부분적분법 (1),,0,0,1,3,0,4,0,0,0,0,0,0
HCAL-08-10,HCAL,미적분,8,여러가지 적분법,10,부분적분법 (2),,0,0,2,0,1,3,0,0,0,0,0,0
HCAL-09-01,HCAL,미적분,9,정적분,1,여러 가지 함수의 정적분 (1),"유리함수, 무리함수",0,0,4,1,0,5,0,0,0,0,0,0
HCAL-09-02,HCAL,미적분,9,정적분,2,여러 가지 함수의 정적분 (2),"지수함수, 삼각함수",0,2,4,0,0,6,0,0,0,0,0,0
HCAL-09-03,HCAL,미적분,9,정적분,3,구간에 따라 다르게 정의된 함수의 정적분,,0,0,0,2,2,4,0,0,0,0,0,0
HCAL-09-04,HCAL,미적분,9,정적분,4,그래프가 대칭인 함수의 정적분,,0,0,0,2,0,2,0,0,0,0,0,0
HCAL-09-05,HCAL,미적분,9,정적분,5,주기함수의 정적분,,0,0,0,0,0,0,0,0,0,0,0,0
HCAL-09-06,HCAL,미적분,9,정적분,6,치환적분법을 이용한 정적분,,0,1,3,1,1,6,0,0,0,0,0,0
HCAL-09-07,HCAL,미적분,9,정적분,7,삼각함수로 치환하는 적분법,,0,0,0,0,0,0,0,0,0,0,0,0
HCAL-09-08,HCAL,미적분,9,정적분,8,부분적분법을 이용한 정적분,,0,0,2,1,1,4,0,0,0,0,0,0
HCAL-09-09,HCAL,미적분,9,정적분,9,적분 구간이 상수인 정적분을 포함한 함수,,0,0,0,1,0,1,0,0,0,0,0,0
HCAL-09-10,HCAL,미적분,9,정적분,10,적분 구간에 변수가 있는 정적분을 포함한 함수,,0,0,3,5,4,12,0,0,0,0,0,0
HCAL-09-11,HCAL,미적분,9,정적분,11,"정적분으로 정의된 함수의 극대, 극소",,0,0,0,1,2,3,0,0,0,0,0,0
HCAL-09-12,HCAL,미적분,9,정적분,12,"정적분으로 정의된 함수의 최대, 최소",,0,0,0,2,1,3,0,0,0,0,0,0
HCAL-09-13,HCAL,미적분,9,정적분,13,정적분으로 정의된 함수의 극한,,0,0,0,0,0,0,0,0,0,0,0,0
HCAL-10-01,HCAL,미적분,10,정적분의 활용,1,구분구적법,,0,0,0,1,0,1,0,0,0,0,0,0
HCAL-10-02,HCAL,미적분,10,정적분의 활용,2,정적분과 급수,,0,0,3,4,0,7,0,0,0,0,0,0
HCAL-10-03,HCAL,미적분,10,정적분의 활용,3,정적분과 급수의 활용,,0,0,0,0,0,0,0,0,0,0,0,0
HCAL-10-04,HCAL,미적분,10,정적분의 활용,4,곡선과 x축 사이의 넓이,,0,0,4,2,2,8,0,0,0,0,0,0
HCAL-10-05,HCAL,미적분,10,정적분의 활용,5,곡선과 y축 사이의 넓이,,0,0,0,0,0,0,0,0,0,0,0,0
HCAL-10-06,HCAL,미적분,10,정적분의 활용,6,두 곡선 사이의 넓이,,0,0,1,1,0,2,0,0,0,0,0,0
HCAL-10-07,HCAL,미적분,10,정적분의 활용,7,곡선과 접선으로 둘러싸인 도형의 넓이,,0,0,1,0,0,1,0,0,0,0,0,0
HCAL-10-08,HCAL,미적분,10,정적분의 활용,8,두 도형의 넓이가 같은 경우,,0,0,1,0,0,1,0,0,0,0,0,0
HCAL-10-09,HCAL,미적분,10,정적분의 활용,9,두 곡선 사이의 넓이의 활용 ,,0,0,1,0,0,1,0,0,0,0,0,0
HCAL-10-10,HCAL,미적분,10,정적분의 활용,10,함수와 역함수로 둘러싸인 도형의 넓이,,0,0,0,0,0,0,0,0,0,0,0,0
HCAL-10-11,HCAL,미적분,10,정적분의 활용,11,입체도형의 부피 (1),단면이 밑면과 평행,0,0,0,1,0,1,0,0,0,0,0,0
HCAL-10-12,HCAL,미적분,10,정적분의 활용,12,입체도형의 부피 (2),단면이 밑면과 수직,0,0,1,6,0,7,0,0,0,0,0,0
HCAL-10-13,HCAL,미적분,10,정적분의 활용,13,직선 위에서 움직인 거리,,0,0,1,1,0,2,0,0,0,0,0,0
HCAL-10-14,HCAL,미적분,10,정적분의 활용,14,좌표평면 위에서 움직인 거리,,0,0,0,1,0,1,0,0,0,0,0,0
HCAL-10-15,HCAL,미적분,10,정적분의 활용,15,곡선의 길이,,0,0,2,0,0,2,0,0,0,0,0,0
HSTA-01-01,HSTA,확률과 통계,1,여러 가지 순열,1,원탁에 둘러앉는 경우의 수,,0,0,28,6,0,34,0,0,16,0,0,16
HSTA-01-02,HSTA,확률과 통계,1,여러 가지 순열,2,색칠하는 경우의 수,,0,0,18,0,0,18,0,0,14,1,0,15
HSTA-01-03,HSTA,확률과 통계,1,여러 가지 순열,3,여러 모양의 탁자에 둘러앉는 경우의 수,,0,1,16,4,0,21,0,0,14,1,0,15
HSTA-01-04,HSTA,확률과 통계,1,여러 가지 순열,4,중복순열,,1,2,31,2,0,36,1,9,8,1,3,22
HSTA-01-05,HSTA,확률과 통계,1,여러 가지 순열,5,중복순열의 활용 (1),자연수의 개수,0,2,12,8,0,22,0,0,12,3,1,16
HSTA-01-06,HSTA,확률과 통계,1,여러 가지 순열,6,중복순열의 활용 (2),함수의 개수,0,0,7,5,2,14,1,3,9,2,1,16
HSTA-01-07,HSTA,확률과 통계,1,여러 가지 순열,7,같은 것이 있는 순열 (1),문자의 나열,0,1,19,8,0,28,0,4,8,1,1,14
HSTA-01-08,HSTA,확률과 통계,1,여러 가지 순열,8,같은 것이 있는 순열 (2),자연수의 개수,0,0,11,2,0,13,0,0,14,0,1,15
HSTA-01-09,HSTA,확률과 통계,1,여러 가지 순열,9,순서가 정해져 있는 순열,,0,0,15,1,0,16,0,0,8,2,0,10
HSTA-01-10,HSTA,확률과 통계,1,여러 가지 순열,10,최단 거리의 경우의 수 (1),,0,0,13,5,0,18,0,0,10,1,1,12
HSTA-01-11,HSTA,확률과 통계,1,여러 가지 순열,11,최단 거리의 경우의 수 (2),장애물이 있을 때,0,0,5,12,0,17,0,0,5,4,1,10
HSTA-02-01,HSTA,확률과 통계,2,중복조합과 이항정리,1,중복조합,,0,3,9,5,1,18,3,3,3,1,1,11
HSTA-02-02,HSTA,확률과 통계,2,중복조합과 이항정리,2,중복조합의 활용 (1),적어도 라는 조건이 있는 경우,0,0,9,5,0,14,0,1,7,0,1,9
HSTA-02-03,HSTA,확률과 통계,2,중복조합과 이항정리,3,중복조합의 활용 (2),방정식과 부등식의 해의 개수,0,1,4,26,3,34,0,0,12,2,2,16
HSTA-02-04,HSTA,확률과 통계,2,중복조합과 이항정리,4,중복조합의 활용 (3),함수의 개수,0,0,7,4,0,11,0,0,7,2,2,11
HSTA-02-05,HSTA,확률과 통계,2,중복조합과 이항정리,5,(a+b)ⁿ의 전개식,,0,4,46,4,0,54,0,6,12,2,0,20
HSTA-02-06,HSTA,확률과 통계,2,중복조합과 이항정리,6,(1+x)ⁿ 의 전개식의 활용,,0,0,11,11,0,22,0,0,6,9,3,18
HSTA-02-07,HSTA,확률과 통계,2,중복조합과 이항정리,7,(a+b)ⁿ(c+d)ᵐ의 전개식,,0,0,15,4,0,19,0,1,18,3,1,23
HSTA-02-08,HSTA,확률과 통계,2,중복조합과 이항정리,8,(a+b+c)ⁿ의 전개식,,0,1,10,1,0,12,1,1,1,0,0,3
HSTA-02-09,HSTA,확률과 통계,2,중복조합과 이항정리,9,이항계수의 성질,,0,0,14,3,1,18,0,2,18,2,0,22
HSTA-02-10,HSTA,확률과 통계,2,중복조합과 이항정리,10,이항계수의 합,파스칼의 삼각형,0,0,11,7,0,18,0,1,13,1,2,17
HSTA-03-01,HSTA,확률과 통계,3,확률의 뜻과 활용,1,시행과 사건,,1,4,5,0,0,10,5,1,6,0,0,12
HSTA-03-02,HSTA,확률과 통계,3,확률의 뜻과 활용,2,수학적 확률,,0,1,22,7,0,30,0,2,10,1,0,13
HSTA-03-03,HSTA,확률과 통계,3,확률의 뜻과 활용,3,순열과 확률,,0,0,17,0,4,21,0,0,13,0,1,14
HSTA-03-04,HSTA,확률과 통계,3,확률의 뜻과 활용,4,원순열과확률,,0,2,4,4,0,10,0,1,12,1,1,15
HSTA-03-05,HSTA,확률과 통계,3,확률의 뜻과 활용,5,중복순열과 확률,,0,0,10,1,0,11,0,0,11,1,0,12
HSTA-03-06,HSTA,확률과 통계,3,확률의 뜻과 활용,6,같은 것이 있는 순열과 확률,,0,0,10,0,0,10,0,0,12,0,1,13
HSTA-03-07,HSTA,확률과 통계,3,확률의 뜻과 활용,7,조합과 확률,,0,1,26,13,0,40,0,2,18,3,1,24
HSTA-03-08,HSTA,확률과 통계,3,확률의 뜻과 활용,8,통계적 확률,,0,0,7,7,0,14,2,6,6,0,1,15
HSTA-03-09,HSTA,확률과 통계,3,확률의 뜻과 활용,9,기하적 확률,,0,0,15,0,0,15,1,0,9,1,0,11
HSTA-03-10,HSTA,확률과 통계,3,확률의 뜻과 활용,10,확률의 기본 성질,,0,0,13,0,0,13,0,4,4,0,0,8
HSTA-03-11,HSTA,확률과 통계,3,확률의 뜻과 활용,11,확률의 덧셈정리와 여사건의 확률,,0,1,12,2,3,18,1,0,7,2,2,12
HSTA-03-12,HSTA,확률과 통계,3,확률의 뜻과 활용,12,확률의 덧셈정리 (1),배반사건이 아닌 경우,0,0,21,2,0,23,2,3,9,2,0,16
HSTA-03-13,HSTA,확률과 통계,3,확률의 뜻과 활용,13,확률의 덧셈정리 (2),배반사건인 경우,0,4,24,2,0,30,2,0,12,1,0,15
HSTA-03-14,HSTA,확률과 통계,3,확률의 뜻과 활용,14,여사건의 확률 (1),적어도 라는 조건이 있는 경우,0,1,25,3,0,29,0,0,12,1,0,13
HSTA-03-15,HSTA,확률과 통계,3,확률의 뜻과 활용,15,여사건의 확률 (2),"아닌, 이상, 이하 라는 조건이 있는 경우",0,0,12,3,4,19,3,0,10,1,2,16
HSTA-04-01,HSTA,확률과 통계,4,조건부 확률,1,조건부확률의 계산,,0,1,26,0,0,27,1,1,11,0,0,13
HSTA-04-02,HSTA,확률과 통계,4,조건부 확률,2,조건부확률,,0,1,46,14,0,61,2,7,5,0,1,15
HSTA-04-03,HSTA,확률과 통계,4,조건부 확률,3,확률의 곱셈정리 (1),P(A∩B)=P(A)P(B|A),0,0,17,2,0,19,1,3,11,0,0,15
HSTA-04-04,HSTA,확률과 통계,4,조건부 확률,4,확률의 곱셈정리 (2),P(E)=P(A∩E)+P(Aᶜ∩E),0,0,12,0,0,12,0,0,14,0,2,16
HSTA-04-05,HSTA,확률과 통계,4,조건부 확률,5,확률의 곱셈정리와 조건부확률,,0,0,17,0,0,17,1,0,11,2,3,17
HSTA-04-06,HSTA,확률과 통계,4,조건부 확률,6,사건의 독립과 종속 판정하기,,0,0,15,2,2,19,0,1,8,1,1,11
HSTA-04-07,HSTA,확률과 통계,4,조건부 확률,7,사건의 독립과 종속의 성질,,0,0,4,7,0,11,0,0,3,3,1,7
HSTA-04-08,HSTA,확률과 통계,4,조건부 확률,8,독립사건의 확률,,0,2,40,0,0,42,0,3,7,1,1,12
HSTA-04-09,HSTA,확률과 통계,4,조건부 확률,9,독립사건의 확률의 활용,,0,0,12,3,0,15,0,3,14,1,2,20
HSTA-04-10,HSTA,확률과 통계,4,조건부 확률,10,독립시행의 확률,,0,2,16,0,0,18,0,2,12,1,1,16
HSTA-04-11,HSTA,확률과 통계,4,조건부 확률,11,독립시행의 확률의 활용,,0,1,26,3,0,30,0,0,11,1,2,14
HSTA-05-01,HSTA,확률과 통계,5,확률변수와 확률분포,1,확률질량함수의 성질 (1),p₁+p₂+…+p_n=1,2,1,11,2,0,16,1,2,9,0,0,12
HSTA-05-02,HSTA,확률과 통계,5,확률변수와 확률분포,2,확률질량함수의 성질 (2),P(x_i≤X≤x_j)=p_i+p_(i+1)+…p_j,0,0,13,0,0,13,2,2,6,0,0,10
HSTA-05-03,HSTA,확률과 통계,5,확률변수와 확률분포,3,이산확률변수의 확률,,0,0,10,0,0,10,2,3,6,1,2,14
HSTA-05-04,HSTA,확률과 통계,5,확률변수와 확률분포,4,"이산확률변수의 평균, 분산, 표준편차 (1)",확률분포가 주어진 경우,0,1,13,2,0,16,1,6,5,0,0,12
HSTA-05-05,HSTA,확률과 통계,5,확률변수와 확률분포,5,"이산확률변수의 평균, 분산, 표준편차 (2)",확률분포가 주어지지 않은 경우,0,0,13,14,0,27,0,0,15,1,1,17
HSTA-05-06,HSTA,확률과 통계,5,확률변수와 확률분포,6,"이산확률변수 aX+b의 평균, 분산, 표준편차 (1)","평균, 분산이 주어진 경우",0,2,18,0,0,20,1,5,6,0,1,13
HSTA-05-07,HSTA,확률과 통계,5,확률변수와 확률분포,7,"이산확률변수 aX+b의 평균, 분산, 표준편차 (2)",확률분포가 주어진 경우,0,1,11,2,0,14,0,0,8,3,0,11
HSTA-05-08,HSTA,확률과 통계,5,확률변수와 확률분포,8,"이산확률변수 aX+b의 평균, 분산, 표준편차 (3)",확률분포가 주어지지 않은 경우,0,0,9,1,0,10,0,0,13,0,1,14
HSTA-05-09,HSTA,확률과 통계,5,확률변수와 확률분포,9,이항분포에서의 확률,,0,1,11,4,0,16,0,1,8,1,1,11
HSTA-05-10,HSTA,확률과 통계,5,확률변수와 확률분포,10,"이항분포의 평균, 분산, 표준편차 (1)",이항분포가 주어진 경우,2,3,16,1,0,22,0,4,16,1,0,21
HSTA-05-11,HSTA,확률과 통계,5,확률변수와 확률분포,11,"이항분포의 평균, 분산, 표준편차 (2)",이항분포가 주어지지 않은 경우,0,0,22,1,0,23,0,1,15,2,2,20
HSTA-05-12,HSTA,확률과 통계,5,확률변수와 확률분포,12,기댓값,,0,0,12,1,0,13,0,0,11,1,0,12
HSTA-06-01,HSTA,확률과 통계,6,정규분포,1,확률밀도함수의 성질,,0,2,15,1,0,18,1,5,5,0,0,11
HSTA-06-02,HSTA,확률과 통계,6,정규분포,2,연속확률변수의 확률,,0,2,19,1,1,23,0,0,11,0,2,13
HSTA-06-03,HSTA,확률과 통계,6,정규분포,3,정규분포 곡선의 성질,,0,1,19,2,0,22,1,2,9,0,0,12
HSTA-06-04,HSTA,확률과 통계,6,정규분포,4,정규분포에서 확률,,0,1,7,3,0,11,0,11,10,0,2,23
HSTA-06-05,HSTA,확률과 통계,6,정규분포,5,정규분포의 표준화,,0,0,12,0,0,12,0,1,11,1,0,13
HSTA-06-06,HSTA,확률과 통계,6,정규분포,6,표준화를 이용한 확률 계산,,0,0,19,2,0,21,0,0,11,0,0,11
HSTA-06-07,HSTA,확률과 통계,6,정규분포,7,표준화를 이용한 미지수의 값 계산,,0,1,12,4,0,17,0,0,11,0,0,11
HSTA-06-08,HSTA,확률과 통계,6,정규분포,8,표준화를 이용한 확률 비교,,0,2,8,2,0,12,0,0,9,1,0,10
HSTA-06-09,HSTA,확률과 통계,6,정규분포,9,정규분포의 활용 (1),확률 계산하기,0,0,21,9,0,30,0,0,10,1,3,14
HSTA-06-10,HSTA,확률과 통계,6,정규분포,10,정규분포의 활용 (2),도수 계산하기,0,0,11,1,0,12,0,0,11,0,1,12
HSTA-06-11,HSTA,확률과 통계,6,정규분포,11,정규분포의 활용 (3),"최대, 최소를 만족하는 값 계산하기",0,1,14,0,0,15,0,0,13,1,1,15
HSTA-06-12,HSTA,확률과 통계,6,정규분포,12,이항분포와 정규분포의 관계,,0,0,8,5,0,13,0,0,8,0,2,10
HSTA-06-13,HSTA,확률과 통계,6,정규분포,13,이항분포와 정규분포의 관계의 활용 (1),확률 계산하기,0,1,22,3,0,26,0,0,11,2,2,15
HSTA-06-14,HSTA,확률과 통계,6,정규분포,14,이항분포와 정규분포의 관계의 활용 (2),미지수의 값 계산하기,0,1,8,0,1,10,0,0,10,0,2,12
HSTA-07-01,HSTA,확률과 통계,7,통계적 추정,1,"표본평균의 평균, 분산, 표준편차 (1)",모평균과 모표준편차가 주어진 경우,0,2,17,0,0,19,1,6,6,0,0,13
HSTA-07-02,HSTA,확률과 통계,7,통계적 추정,2,"표본평균의 평균, 분산, 표준편차 (2)",모집단의 확률분포가 주어진 경우,0,0,16,1,0,17,0,3,7,0,0,10
HSTA-07-03,HSTA,확률과 통계,7,통계적 추정,3,"표본평균의 평균, 분산, 표준편차 (3)",모집단이 주어진 경우,0,0,12,0,0,12,0,0,9,0,0,9
HSTA-07-04,HSTA,확률과 통계,7,통계적 추정,4,표본평균의 확률 (1),,0,0,22,3,0,25,0,4,10,1,0,15
HSTA-07-05,HSTA,확률과 통계,7,통계적 추정,5,표본평균의 확률 (2),표본의 크기 계산하기,0,1,6,6,0,13,0,0,6,1,1,8
HSTA-07-06,HSTA,확률과 통계,7,통계적 추정,6,표본평균의 확률 (3),미지수의 값 계산하기,0,0,15,1,0,16,0,0,7,0,2,9
HSTA-07-07,HSTA,확률과 통계,7,통계적 추정,7,모평균의 추정 (1),모표준편차가 주어진 경우,0,0,11,6,0,17,1,5,4,1,0,11
HSTA-07-08,HSTA,확률과 통계,7,통계적 추정,8,모평균의 추정 (2),표본표준편차가 주어진 경우,0,1,12,0,0,13,0,5,3,0,1,9
HSTA-07-09,HSTA,확률과 통계,7,통계적 추정,9,모평균의 추정 (3),표본의 크기 계산하기,0,0,10,0,0,10,0,0,6,0,0,6
HSTA-07-10,HSTA,확률과 통계,7,통계적 추정,10,신뢰구간의 길이 (1),,0,0,16,0,0,16,2,2,4,0,0,8
HSTA-07-11,HSTA,확률과 통계,7,통계적 추정,11,신뢰구간의 길이 (2),표본의 크기 계산하기,0,0,14,1,0,15,0,5,4,0,0,9
HSTA-07-12,HSTA,확률과 통계,7,통계적 추정,12,신뢰구간의 길이 (3),신뢰도 계산하기,0,0,10,1,0,11,0,0,4,2,0,6
HSTA-07-13,HSTA,확률과 통계,7,통계적 추정,13,모평균과 표본평균의 차,,0,0,11,0,0,11,0,0,8,0,1,9
HSTA-07-14,HSTA,확률과 통계,7,통계적 추정,14,신뢰구간의 성질,,0,0,10,1,0,11,1,0,5,2,0,8
HSU1-01-01,HSU1,수1,1,지수,1,거듭제곱근,,10,5,9,3,1,28,3,4,7,0,1,15
HSU1-01-02,HSU1,수1,1,지수,2,거듭제곱근의 계산,,1,8,5,1,0,15,0,0,8,0,0,8
HSU1-01-03,HSU1,수1,1,지수,3,문자를 포함한 거듭제곱근의 계산,,0,0,8,3,1,12,0,0,5,0,1,6
HSU1-01-04,HSU1,수1,1,지수,4,거듭제곱근의 대소 비교,,0,5,6,0,0,11,0,5,7,0,1,13
HSU1-01-05,HSU1,수1,1,지수,5,지수의 확장,,4,44,6,6,0,60,2,2,15,2,1,22
HSU1-01-06,HSU1,수1,1,지수,6,지수를 사용하여 거듭제곱근 표현하기,,1,3,7,4,0,15,1,1,2,0,1,5
HSU1-01-07,HSU1,수1,1,지수,7,다중 거듭제곱근,,0,2,7,2,0,11,0,1,6,0,0,7
HSU1-01-08,HSU1,수1,1,지수,8,주어진 문자로 거듭제곱 표현하기,,1,1,14,1,0,17,1,1,4,0,0,6
HSU1-01-09,HSU1,수1,1,지수,9,a^r 꼴이 자연수가 되게 하는 조건 구하기,,0,3,7,12,2,24,0,1,2,0,1,4
HSU1-01-10,HSU1,수1,1,지수,10,곱셈 공식을 이용한 식의 계산,,0,4,5,1,0,10,1,3,10,0,1,15
HSU1-01-11,HSU1,수1,1,지수,11,aˣ±a⁻ˣ 꼴을 이용하여 식의 값 구하기,,0,4,3,7,0,14,1,9,5,0,1,16
HSU1-01-12,HSU1,수1,1,지수,12,a^(nx) 꼴을 이용하여 식의 값 구하기 ,,0,0,14,2,1,17,0,6,7,0,0,13
HSU1-01-13,HSU1,수1,1,지수,13,aˣ 와 bʸ 의 값을 이용하여 식의 값 구하기,,0,0,13,9,1,23,1,1,15,2,2,21
HSU1-01-14,HSU1,수1,1,지수,14,지수의 실생활에의 활용,,0,1,14,3,0,18,1,0,7,4,0,12
HSU1-02-01,HSU1,수1,2,로그,1,로그의 정의,,6,11,7,3,0,27,1,4,8,0,0,13
HSU1-02-02,HSU1,수1,2,로그,2,로그가 정의되기 위한 밑과 진수의 조건,,0,1,15,3,0,19,0,1,10,1,0,12
HSU1-02-03,HSU1,수1,2,로그,3,로그의 기본성질,,3,19,20,5,0,47,3,2,8,2,1,16
HSU1-02-04,HSU1,수1,2,로그,4,로그의 밑의 변환,,0,2,17,4,0,23,1,2,10,0,2,15
HSU1-02-05,HSU1,수1,2,로그,5,로그의 여러 가지 성질과 대소관계,,2,2,8,2,1,15,1,7,9,0,0,17
HSU1-02-06,HSU1,수1,2,로그,6,로그의 성질의 활용 (1),logₐb=c 가 주어진 경우,0,2,7,10,0,19,1,0,9,2,1,13
HSU1-02-07,HSU1,수1,2,로그,7,로그의 성질의 활용 (2),aˣ=b 가 주어진 경우,0,0,11,5,0,16,0,0,5,1,0,6
HSU1-02-08,HSU1,수1,2,로그,8,조건을 이용하여 식의 값 구하기,,0,0,7,6,0,13,0,0,16,0,0,16
HSU1-02-09,HSU1,수1,2,로그,9,로그에 대한 증명,,5,0,5,0,0,10,2,0,1,0,0,3
HSU1-02-10,HSU1,수1,2,로그,10,로그의 정수 부분과 소수 부분,,0,3,7,3,2,15,0,0,10,1,1,12
HSU1-02-11,HSU1,수1,2,로그,11,이차방정식과 로그,,0,0,7,9,0,16,1,2,14,2,0,19
HSU1-02-12,HSU1,수1,2,로그,12,상용로그의 값,,3,10,4,2,0,19,2,5,9,1,1,18
HSU1-02-13,HSU1,수1,2,로그,13,상용로그의 활용,,0,1,9,2,2,14,2,0,11,6,0,19
HSU1-02-14,HSU1,수1,2,로그,14,자릿수와 상용로그,,0,1,6,4,1,12,0,1,4,2,1,8
HSU1-02-15,HSU1,수1,2,로그,15,소수점 아래 처음으로 0이 아닌 숫자가 나타나는 자리,,0,1,8,1,0,10,0,4,4,1,0,9
HSU1-02-16,HSU1,수1,2,로그,16,가장 큰 자릿수 구하기,,0,1,6,2,1,10,0,0,3,2,0,5
HSU1-02-17,HSU1,수1,2,로그,17,상용로그의 실생활 활용 (1),관계식이 주어질 때,0,0,16,7,0,23,2,1,7,1,0,11
HSU1-02-18,HSU1,수1,2,로그,18,상용로그의 실생활 활용 (2),일정한 비율로 변할 때,0,2,8,5,0,15,0,0,9,1,2,12
HSU1-03-01,HSU1,수1,3,지수함수,1,지수함수의 값,,1,2,7,1,0,11,1,0,4,0,0,5
HSU1-03-02,HSU1,수1,3,지수함수,2,지수함수의 성질과 그래프,,2,0,8,1,0,11,7,1,1,0,0,9
HSU1-03-03,HSU1,수1,3,지수함수,3,지수함수의 그래프의 평행이동과 대칭이동,,0,2,11,13,0,26,3,5,7,0,2,17
HSU1-03-04,HSU1,수1,3,지수함수,4,지수함수의 그래프에서의 활용,,0,2,6,10,0,18,3,1,4,1,1,10
HSU1-03-05,HSU1,수1,3,지수함수,5,지수함수를 이용한 수의 대소관계 판별,,0,1,10,1,1,13,0,1,6,1,0,8
HSU1-03-06,HSU1,수1,3,지수함수,6,지수함수의 역함수,,1,1,6,4,1,13,0,3,3,0,0,6
HSU1-03-07,HSU1,수1,3,지수함수,7,"지수함수의 최대, 최소 (1)",y=pᵃˣ⁺ᵇ 꼴,1,7,8,1,0,17,4,2,4,2,1,13
HSU1-03-08,HSU1,수1,3,지수함수,8,"지수함수의 최대, 최소 (2)",y=pᵃˣ²⁺ᵇˣ⁺ʳ 꼴,0,4,7,0,0,11,1,4,5,0,1,11
HSU1-03-09,HSU1,수1,3,지수함수,9,"지수함수의 최대, 최소 (3)",aˣ 꼴을 치환하는 경우,0,0,11,0,0,11,0,0,11,2,0,13
HSU1-03-10,HSU1,수1,3,지수함수,10,"지수함수의 최대, 최소 (4)",산술평균과 기하평균 관계 이용,0,0,3,12,0,15,0,0,10,2,1,13
HSU1-03-11,HSU1,수1,3,지수함수,11,지수방정식 (1),같은 밑으로 바꿀 수 있는 경우,6,9,4,3,0,22,1,2,6,1,0,10
HSU1-03-12,HSU1,수1,3,지수함수,12,지수방정식 (2),aˣ 꼴을 치환하는 경우,0,1,13,5,1,20,0,1,10,2,1,14
HSU1-03-13,HSU1,수1,3,지수함수,13,지수방정식 (3),밑에 미지수가 포함된 경우,0,7,4,1,0,12,2,5,3,0,0,10
HSU1-03-14,HSU1,수1,3,지수함수,14,지수방정식 (4),연립방정식으로 제시되는 경우,0,2,8,0,0,10,0,2,3,0,0,5
HSU1-03-15,HSU1,수1,3,지수함수,15,근의 조건이 주어진 지수방정식,,0,1,7,5,0,13,0,0,1,5,2,8
HSU1-03-16,HSU1,수1,3,지수함수,16,지수부등식 (1),같은 밑으로 바꿀 수 있는 경우,2,4,8,1,0,15,1,4,4,1,2,12
HSU1-03-17,HSU1,수1,3,지수함수,17,지수부등식 (2),aˣ 꼴을 치환하는 경우,0,1,11,4,0,16,0,2,4,1,0,7
HSU1-03-18,HSU1,수1,3,지수함수,18,지수부등식 (3),밑에 미지수가 포함된 경우,1,0,8,1,0,10,0,1,9,2,1,13
HSU1-03-19,HSU1,수1,3,지수함수,19,지수부등식 (4),연립부등식으로 제시되는 경우,0,2,8,0,0,10,0,0,4,0,0,4
HSU1-03-20,HSU1,수1,3,지수함수,20,지수부등식을 항상 성립하게 만드는 조건 구하기,,0,0,10,0,0,10,0,1,4,1,0,6
HSU1-03-21,HSU1,수1,3,지수함수,21,지수방정식과 지수부등식의 실생활 활용,,0,0,12,0,0,12,1,5,7,0,2,15
HSU1-04-01,HSU1,수1,4,로그함수,1,로그함수의 값,,3,2,4,2,0,11,2,5,4,0,1,12
HSU1-04-02,HSU1,수1,4,로그함수,2,로그함수의 성질과 그래프,,0,2,7,1,1,11,3,3,4,0,0,10
HSU1-04-03,HSU1,수1,4,로그함수,3,로그함수의 그래프의 평행이동과 대칭이동,,0,2,18,6,0,26,2,8,7,0,0,17
HSU1-04-04,HSU1,수1,4,로그함수,4,로그함수를 이용한 대소 관계 판별,,0,0,5,3,2,10,0,1,4,1,1,7
HSU1-04-05,HSU1,수1,4,로그함수,5,로그함수의 역함수,,0,2,7,4,1,14,1,2,6,0,0,9
HSU1-04-06,HSU1,수1,4,로그함수,6,로그함수의 그래프에서의 활용,,0,0,10,11,7,28,2,1,10,4,1,18
HSU1-04-07,HSU1,수1,4,로그함수,7,"로그함수의 최대, 최소 (1)",y=logₐ(p(x)) 꼴,0,4,12,7,0,23,0,0,13,3,0,16
HSU1-04-08,HSU1,수1,4,로그함수,8,"로그함수의 최대, 최소 (2)",지수에 로그가 포함된 경우,0,0,6,3,1,10,0,0,3,3,0,6
HSU1-04-09,HSU1,수1,4,로그함수,9,"로그함수의 최대, 최소 (3)",logₐx 꼴의 식이 반복되는 경우,0,0,0,12,0,12,0,0,13,1,0,14
HSU1-04-10,HSU1,수1,4,로그함수,10,"로그함수의 최대, 최소 (4)",산술평균과 기하평균의 관계 이용,0,0,8,2,0,10,0,1,5,0,0,6
HSU1-04-11,HSU1,수1,4,로그함수,11,로그방정식 (1),같은 밑으로 바꿀 수 있는 경우,2,4,12,2,1,21,0,3,6,0,0,9
HSU1-04-12,HSU1,수1,4,로그함수,12,로그방정식 (2),logₐx 꼴의 식이 반복되는 경우,0,0,5,5,0,10,0,0,14,2,0,16
HSU1-04-13,HSU1,수1,4,로그함수,13,로그방정식 (3),지수에 로그가 포함된 경우,0,1,9,1,0,11,1,2,6,0,0,9
HSU1-04-14,HSU1,수1,4,로그함수,14,로그방정식 (4),연립방정식으로 제시되는 경우,0,0,7,2,0,9,0,0,2,1,1,4
HSU1-04-15,HSU1,수1,4,로그함수,15,로그부등식 (1),같은 밑으로 바꿀 수 있는 경우,1,5,12,2,0,20,2,3,0,0,1,6
HSU1-04-16,HSU1,수1,4,로그함수,16,로그부등식 (2),logₐx 꼴의 식이 반복되는 경우,0,0,11,1,0,12,1,0,8,0,1,10
HSU1-04-17,HSU1,수1,4,로그함수,17,로그부등식 (3),지수에 로그가 포함된 경우,0,0,8,2,0,10,0,0,7,2,0,9
HSU1-04-18,HSU1,수1,4,로그함수,18,로그부등식 (4),연립부등식으로 제시되는 경우,0,0,7,3,0,10,0,0,4,1,0,5
HSU1-04-19,HSU1,수1,4,로그함수,19,로그부등식 (5),진수에 로그가 포함된 경우,0,1,7,2,0,10,0,0,6,0,1,7
HSU1-04-20,HSU1,수1,4,로그함수,20,근의 조건이 주어진 로그방정식과 로그부등식,,0,0,8,2,0,10,0,0,13,1,2,16
HSU1-04-21,HSU1,수1,4,로그함수,21,로그함수의 실생활에의 활용,,0,1,12,4,0,17,0,0,11,1,0,12
HSU1-05-01,HSU1,수1,5,삼각함수,1,동경의 위치 ,,1,6,2,0,0,9,4,3,0,0,0,7
HSU1-05-02,HSU1,수1,5,삼각함수,2,사분면의 각,,1,7,3,0,0,11,1,1,11,0,0,13
HSU1-05-03,HSU1,수1,5,삼각함수,3,호도법과 육십분법,,0,4,7,0,0,11,8,2,2,0,0,12
HSU1-05-04,HSU1,수1,5,삼각함수,4,두 동경의 위치 관계 (1),일치하거나 원점에 대해 대칭인 경우,0,0,8,2,0,10,0,0,7,2,0,9
HSU1-05-05,HSU1,수1,5,삼각함수,5,두 동경의 위치 관계 (2),직선에 대해 대칭인 경우,0,0,7,5,0,12,0,1,8,0,0,9
HSU1-05-06,HSU1,수1,5,삼각함수,6,부채꼴의 호의 길이와 넓이,,3,10,14,6,0,33,3,5,7,1,1,17
HSU1-05-07,HSU1,수1,5,삼각함수,7,"부채꼴의 호의 길이와 넓이의 최대, 최소 ",,0,0,7,4,0,11,0,0,6,1,0,7
HSU1-05-08,HSU1,수1,5,삼각함수,8,삼각함수,,0,13,7,2,1,23,1,4,4,1,1,11
HSU1-05-09,HSU1,수1,5,삼각함수,9,삼각함수의 값의 부호,,0,3,6,2,0,11,5,2,9,0,1,17
HSU1-05-10,HSU1,수1,5,삼각함수,10,삼각함수 사이의 관계 이용 (1),식 간단하게 만들기,0,3,5,2,0,10,0,0,9,1,1,11
HSU1-05-11,HSU1,수1,5,삼각함수,11,삼각함수 사이의 관계 이용 (2),식의 값 구하기,1,10,10,4,0,25,1,0,15,4,1,21
HSU1-05-12,HSU1,수1,5,삼각함수,12,삼각함수 사이의 관계 이용 (3),"sinθ ± cosθ, sinθ cosθ 관계 이용",0,4,9,3,0,16,1,0,8,1,1,11
HSU1-05-13,HSU1,수1,5,삼각함수,13,삼각함수와 이차방정식,,0,0,5,7,0,12,1,0,8,1,1,11
HSU1-06-01,HSU1,수1,6,삼각함수와 그래프,1,주기함수,,0,2,7,1,1,11,0,2,4,1,0,7
HSU1-06-02,HSU1,수1,6,삼각함수와 그래프,2,삼각함수 값의 대소관계 판별,,1,3,5,1,0,10,0,1,1,0,1,3
HSU1-06-03,HSU1,수1,6,삼각함수와 그래프,3,삼각함수 그래프의 대칭성,,0,0,7,4,0,11,2,0,2,0,0,4
HSU1-06-04,HSU1,수1,6,삼각함수와 그래프,4,삼각함수 그래프의 평행이동과 대칭이동,,0,2,8,0,0,10,0,0,6,0,0,6
HSU1-06-05,HSU1,수1,6,삼각함수와 그래프,5,"삼각함수를 포함한 식의 최대, 최소와 주기 ",,0,5,16,1,0,22,1,0,15,0,1,17
HSU1-06-06,HSU1,수1,6,삼각함수와 그래프,6,삼각함수 식의 미정계수 구하기 (1),조건이 주어진 경우,0,0,11,1,0,12,0,2,10,0,0,12
HSU1-06-07,HSU1,수1,6,삼각함수와 그래프,7,삼각함수 식의 미정계수 구하기 (2),그래프가 주어진 경우,0,2,14,8,0,24,0,0,11,2,1,14
HSU1-06-08,HSU1,수1,6,삼각함수와 그래프,8,절댓값 기호가 포함된 삼각함수,,0,3,3,4,0,10,0,3,7,0,1,11
HSU1-06-09,HSU1,수1,6,삼각함수와 그래프,9,삼각함수 그래프에서 넓이 구하기,,0,2,7,1,0,10,0,0,5,0,0,5
HSU1-06-10,HSU1,수1,6,삼각함수와 그래프,10,여러 가지 각의 삼각함수 값 (1),,0,2,19,4,1,26,0,3,11,0,0,14
HSU1-06-11,HSU1,수1,6,삼각함수와 그래프,11,여러 가지 각의 삼각함수 값 (2),각이 일정하게 커지는 경우,0,1,6,4,0,11,0,0,4,3,0,7
HSU1-06-12,HSU1,수1,6,삼각함수와 그래프,12,여러 가지 각의 삼각함수 값 (3),도형에서 활용하기,0,4,4,2,0,10,0,0,2,2,1,5
HSU1-06-13,HSU1,수1,6,삼각함수와 그래프,13,sin²x + cos²x = 1 을 이용해 식의 값 구하기,,1,1,6,2,1,11,0,0,3,0,0,3
HSU1-06-14,HSU1,수1,6,삼각함수와 그래프,14,"삼각함수를 포함한 식의 최대, 최소 (1)",일차식 형태,0,3,7,0,0,10,0,0,2,0,0,2
HSU1-06-15,HSU1,수1,6,삼각함수와 그래프,15,"삼각함수를 포함한 식의 최대, 최소 (2)",유리함수 형태,0,3,7,0,0,10,0,1,8,0,0,9
HSU1-06-16,HSU1,수1,6,삼각함수와 그래프,16,"삼각함수를 포함한 식의 최대, 최소 (3)",이차식 형태,0,0,8,4,0,12,1,1,11,1,1,15
HSU1-06-17,HSU1,수1,6,삼각함수와 그래프,17,"삼각함수를 포함한 식의 최대, 최소 (4)",절댓값 기호를 포함한 경우,0,3,6,1,0,10,0,0,8,2,0,10
HSU1-06-18,HSU1,수1,6,삼각함수와 그래프,18,삼각방정식 (1),일차식 형태,0,8,7,3,0,18,0,3,9,0,2,14
HSU1-06-19,HSU1,수1,6,삼각함수와 그래프,19,삼각방정식 (2),이차식 형태,0,1,13,3,1,18,0,0,11,2,1,14
HSU1-06-20,HSU1,수1,6,삼각함수와 그래프,20,삼각방정식 (3),삼각형이 포함된 경우,0,4,6,0,0,10,0,0,5,1,0,6
HSU1-06-21,HSU1,수1,6,삼각함수와 그래프,21,삼각방정식 (4),그래프의 대칭성 이용하기,0,1,11,4,0,16,0,1,4,2,0,7
HSU1-06-22,HSU1,수1,6,삼각함수와 그래프,22,삼각방정식의 근의 개수와 조건,,1,0,4,10,0,15,0,1,13,1,0,15
HSU1-06-23,HSU1,수1,6,삼각함수와 그래프,23,삼각부등식 (1),일차식 형태,0,4,13,6,0,23,1,1,14,1,0,17
HSU1-06-24,HSU1,수1,6,삼각함수와 그래프,24,삼각부등식 (2),이차식 형태,0,0,7,5,0,12,0,0,11,1,1,13
HSU1-06-25,HSU1,수1,6,삼각함수와 그래프,25,이차방정식에서의 삼각방정식과 삼각부등식 활용,,0,1,12,3,0,16,0,0,16,0,0,16
HSU1-06-26,HSU1,수1,6,삼각함수와 그래프,26,일반각에서 삼각함수 성질 활용하기,,0,3,3,4,0,10,0,0,1,1,1,3
HSU1-07-01,HSU1,수1,7,삼각함수의 활용,1,사인법칙,,3,4,5,0,0,12,3,5,3,0,1,12
HSU1-07-02,HSU1,수1,7,삼각함수의 활용,2,사인법칙과 삼각형의 외접원,,1,4,7,1,0,13,2,2,5,2,1,12
HSU1-07-03,HSU1,수1,7,삼각함수의 활용,3,사인법칙의 변형,,0,5,5,0,0,10,0,2,8,1,0,11
HSU1-07-04,HSU1,수1,7,삼각함수의 활용,4,사인법칙을 이용한 삼각형 모양 판별,,0,1,8,1,0,10,0,2,6,2,1,11
HSU1-07-05,HSU1,수1,7,삼각함수의 활용,5,사인법칙의 활용,,0,2,5,4,0,11,0,1,9,2,1,13
HSU1-07-06,HSU1,수1,7,삼각함수의 활용,6,코사인 법칙,,3,2,2,3,0,10,0,1,9,2,0,12
HSU1-07-07,HSU1,수1,7,삼각함수의 활용,7,코사인법칙의 변형,,0,5,3,7,1,16,1,1,14,2,2,20
HSU1-07-08,HSU1,수1,7,삼각함수의 활용,8,사인법칙과 코사인법칙,,0,2,9,1,0,12,1,3,6,1,0,11
HSU1-07-09,HSU1,수1,7,삼각함수의 활용,9,사인법칙과 코사인법칙을 이용한 삼각형 모양 판별,,0,1,9,0,0,10,0,1,9,2,0,12
HSU1-07-10,HSU1,수1,7,삼각함수의 활용,10,코사인법칙의 활용,,0,4,6,1,0,11,0,2,7,1,1,11
HSU1-07-11,HSU1,수1,7,삼각함수의 활용,11,삼각형의 넓이,,0,1,8,4,0,13,0,1,10,1,1,13
HSU1-07-12,HSU1,수1,7,삼각함수의 활용,12,삼각형의 넓이와 외접원의 반지름,,2,4,5,1,0,12,0,0,2,0,0,2
HSU1-07-13,HSU1,수1,7,삼각함수의 활용,13,세변의 길이를 알때 삼각형의 넓이,헤론의 공식,2,2,3,3,0,10,2,2,7,1,1,13
HSU1-07-14,HSU1,수1,7,삼각함수의 활용,14,"삼각형 넓이의 최대, 최소",,0,0,10,0,0,10,0,0,2,0,0,2
HSU1-07-15,HSU1,수1,7,삼각함수의 활용,15,삼각형으로 나누어 구하는 사각형의 넓이,,1,0,5,1,0,7,2,0,8,1,0,11
HSU1-07-16,HSU1,수1,7,삼각함수의 활용,16,평행사변형의 넓이,,4,1,5,0,0,10,1,0,5,0,0,6
HSU1-07-17,HSU1,수1,7,삼각함수의 활용,17,대각선을 이용한 사각형의 넓이,,3,4,3,0,0,10,3,3,7,0,2,15
HSU1-08-01,HSU1,수1,8,등차수열,1,수열의 일반항,,0,3,7,1,0,11,0,0,4,0,0,4
HSU1-08-02,HSU1,수1,8,등차수열,2,등차수열,,1,3,6,0,0,10,2,1,2,0,1,6
HSU1-08-03,HSU1,수1,8,등차수열,3,등차수열의 일반항,,0,19,25,4,1,49,0,2,6,0,1,9
HSU1-08-04,HSU1,수1,8,등차수열,4,주어진 조건을 만족하는 등차수열의 항,,1,3,5,2,0,11,1,1,12,0,1,15
HSU1-08-05,HSU1,수1,8,등차수열,5,처음으로 양 또는 음 값이 나오는 항,,0,2,11,0,0,13,0,1,2,1,1,5
HSU1-08-06,HSU1,수1,8,등차수열,6,두 수 사이에 새로운 수를 넣어서 만든 등차수열,,2,4,4,0,1,11,1,5,4,2,1,13
HSU1-08-07,HSU1,수1,8,등차수열,7,등차중항,,0,5,6,6,0,17,0,2,9,2,2,15
HSU1-08-08,HSU1,수1,8,등차수열,8,등차수열의 활용,,0,2,8,1,0,11,0,1,14,0,0,15
HSU1-08-09,HSU1,수1,8,등차수열,9,등차수열의 합,,0,3,9,6,1,19,2,1,13,2,1,19
HSU1-08-10,HSU1,수1,8,등차수열,10,두 수 사이에 새로운 수를 넣어서 만든 등차수열의 합,,2,1,11,0,0,14,2,0,3,1,0,6
HSU1-08-11,HSU1,수1,8,등차수열,11,부분 합이 주어진 등차수열,,0,0,10,1,0,11,0,0,8,0,1,9
HSU1-08-12,HSU1,수1,8,등차수열,12,"등차수열 합의 최대, 최소",,0,0,11,1,0,12,1,0,7,5,2,15
HSU1-08-13,HSU1,수1,8,등차수열,13,나머지가 동일한 자연수의 합,,1,3,4,2,0,10,1,2,7,1,2,13
HSU1-08-14,HSU1,수1,8,등차수열,14,등차수열 합의 활용,,0,2,5,3,1,11,0,2,5,1,1,9
HSU1-08-15,HSU1,수1,8,등차수열,15,등차수열의 합과 일반항의 관계,,0,0,14,2,0,16,3,1,11,0,0,15
HSU1-09-01,HSU1,수1,9,등비수열,1,등비수열의 일반항,,3,5,18,6,0,32,1,2,8,0,0,11
HSU1-09-02,HSU1,수1,9,등비수열,2,주어진 조건을 만족하는 등비수열의 항,,0,1,7,3,1,12,0,0,19,2,1,22
HSU1-09-03,HSU1,수1,9,등비수열,3,두 수 사이에 새로운 수를 넣어서 만든 등비수열,,2,1,7,0,0,10,1,8,3,1,0,13
HSU1-09-04,HSU1,수1,9,등비수열,4,등비중항,,0,7,12,12,1,32,5,0,10,2,2,19
HSU1-09-05,HSU1,수1,9,등비수열,5,등비수열의 활용,,0,0,7,5,1,13,0,0,9,1,3,13
HSU1-09-06,HSU1,수1,9,등비수열,6,등비수열과 도형,,0,0,9,1,0,10,0,0,8,1,0,9
HSU1-09-07,HSU1,수1,9,등비수열,7,등비수열의 실생활 활용,,0,4,4,2,0,10,0,1,1,1,0,3
HSU1-09-08,HSU1,수1,9,등비수열,8,등비수열의 합,,0,1,12,4,1,18,1,6,12,1,2,22
HSU1-09-09,HSU1,수1,9,등비수열,9,부분 합이 주어진 등비수열,,0,2,11,2,0,15,0,1,8,1,1,11
HSU1-09-10,HSU1,수1,9,등비수열,10,등비수열 합의 활용,,0,3,4,0,4,11,1,0,0,0,3,4
HSU1-09-11,HSU1,수1,9,등비수열,11,등비수열의 합과 일반항의 관계,,0,0,11,2,0,13,0,0,13,4,0,17
HSU1-09-12,HSU1,수1,9,등비수열,12,원리합계,,0,3,9,6,1,19,0,2,7,0,1,10
HSU1-10-01,HSU1,수1,10,수열의 합,1,합의 기호 ∑,,0,6,4,1,0,11,1,4,10,0,1,16
HSU1-10-02,HSU1,수1,10,수열의 합,2,"등차수열, 등비수열과 ∑",,0,1,9,16,0,26,1,2,3,0,0,6
HSU1-10-03,HSU1,수1,10,수열의 합,3,반복되는 특정 값을 가지는 수열의 합,,0,0,10,6,2,18,0,0,2,0,1,3
HSU1-10-04,HSU1,수1,10,수열의 합,4,∑ 의 성질,,5,4,18,5,0,32,5,0,5,1,1,12
HSU1-10-05,HSU1,수1,10,수열의 합,5,자연수의 거듭제곱의 합,,0,5,11,11,0,27,1,6,7,0,1,15
HSU1-10-06,HSU1,수1,10,수열의 합,6,∑rⁿ의 형태를 가진 식의 계산,,0,1,5,4,0,10,0,1,3,2,0,6
HSU1-10-07,HSU1,수1,10,수열의 합,7,여러 개의 ∑이 포함된 식,,0,2,9,0,0,11,0,0,10,1,1,12
HSU1-10-08,HSU1,수1,10,수열의 합,8,다항식 꼴의 일반항을 갖는 수열의 합,,1,1,16,12,3,33,1,1,12,1,4,19
HSU1-10-09,HSU1,수1,10,수열의 합,9,∑ 으로 표현된 수열의 합과 일반항의 관계,,0,1,10,9,0,20,0,0,13,1,0,14
HSU1-10-10,HSU1,수1,10,수열의 합,10,로그를 포함한 수열의 합,,0,0,11,8,0,19,0,2,2,1,2,7
HSU1-10-11,HSU1,수1,10,수열의 합,11,분수 형태의 수열의 합,,0,1,9,9,2,21,0,0,14,2,1,17
HSU1-10-12,HSU1,수1,10,수열의 합,12,근호를 포함한 수열의 합,,0,0,13,3,0,16,0,0,13,1,1,15
HSU1-10-13,HSU1,수1,10,수열의 합,13,(등차수열)×(등비수열) 형태의 수열의 합,,0,1,8,0,0,9,0,0,4,4,0,8
HSU1-10-14,HSU1,수1,10,수열의 합,14,군수열이 정수로 이루어진 경우,,0,0,12,0,0,12,0,0,5,5,2,12
HSU1-10-15,HSU1,수1,10,수열의 합,15,군수열이 분수로 이루어진 경우,,0,2,8,1,0,11,0,0,5,1,1,7
HSU1-10-16,HSU1,수1,10,수열의 합,16,여러가지 군수열,,0,2,8,0,0,10,0,0,6,2,2,10
HSU1-11-01,HSU1,수1,11,수학적 귀납법,1,등차수열의 귀납적 정의 ,,0,3,8,1,0,12,0,3,9,1,1,14
HSU1-11-02,HSU1,수1,11,수학적 귀납법,2,등비수열의 귀납적 정의,,0,1,12,1,0,14,2,3,4,2,1,12
HSU1-11-03,HSU1,수1,11,수학적 귀납법,3,a_(n+1) = a_n +f(n),,0,0,9,2,0,11,0,0,12,2,0,14
HSU1-11-04,HSU1,수1,11,수학적 귀납법,4,a_(n+1) = a_n f(n),,0,0,9,2,1,12,1,1,5,4,2,13
HSU1-11-05,HSU1,수1,11,수학적 귀납법,5,여러 가지 수열의 귀납적 정의,,0,0,24,15,0,39,1,2,12,4,3,22
HSU1-11-06,HSU1,수1,11,수학적 귀납법,6,반복되는 수가 있는 수열,,0,3,9,4,0,16,0,1,2,0,1,4
HSU1-11-07,HSU1,수1,11,수학적 귀납법,7,Sn을 포함한 수열,,1,2,6,0,1,10,1,1,8,2,2,14
HSU1-11-08,HSU1,수1,11,수학적 귀납법,8,귀납적 정의와 도형에서의 활용,,1,1,5,3,1,11,1,0,2,0,1,4
HSU1-11-09,HSU1,수1,11,수학적 귀납법,9,귀납적 정의의 활용,,1,1,6,3,1,12,0,0,6,2,5,13
HSU1-11-10,HSU1,수1,11,수학적 귀납법,10,수학적 귀납법 (1),,0,3,7,0,0,10,3,0,4,0,0,7
HSU1-11-11,HSU1,수1,11,수학적 귀납법,11,수학적 귀납법 (2),등식의 증명,0,0,12,20,0,32,0,1,5,2,2,10
HSU1-11-12,HSU1,수1,11,수학적 귀납법,12,수학적 귀납법 (3),배수의 증명,0,0,10,0,0,10,0,1,3,0,0,4
HSU1-11-13,HSU1,수1,11,수학적 귀납법,13,수학적 귀납법 (4),부등식의 증명,0,0,8,6,0,14,0,0,4,3,1,8
HSU2-01-01,HSU2,수학2,1,함수의 극한,1,함수의 극한값의 존재,,0,0,1,0,0,1,0,0,0,0,0,0
HSU2-01-02,HSU2,수학2,1,함수의 극한,2,함수의 극한값 구하기,,0,4,29,1,0,34,0,0,0,0,0,0
HSU2-01-03,HSU2,수학2,1,함수의 극한,3,합성함수의 극한,,0,0,0,0,0,0,0,0,0,0,0,0
HSU2-01-04,HSU2,수학2,1,함수의 극한,4,함수의 극한에 대한 성질 (1),,0,0,2,0,0,2,0,0,0,0,0,0
HSU2-01-05,HSU2,수학2,1,함수의 극한,5,함수의 극한에 대한 성질 (2),합답형,0,0,0,0,0,0,0,0,0,0,0,0
HSU2-01-06,HSU2,수학2,1,함수의 극한,6,0/0꼴의 극한 (1),유리식,0,7,1,4,0,12,0,0,0,0,0,0
HSU2-01-07,HSU2,수학2,1,함수의 극한,7,0/0꼴의 극한 (2),무리식,0,0,2,1,0,3,0,0,0,0,0,0
HSU2-01-08,HSU2,수학2,1,함수의 극한,8,∞/∞꼴의 극한 ,,0,2,1,0,0,3,0,0,0,0,0,0
HSU2-01-09,HSU2,수학2,1,함수의 극한,9,∞-∞꼴의 극한,,0,0,0,0,0,0,0,0,0,0,0,0
HSU2-01-10,HSU2,수학2,1,함수의 극한,10,∞×0 꼴의 극한,,0,0,0,0,0,0,0,0,0,0,0,0
HSU2-01-11,HSU2,수학2,1,함수의 극한,11,미정계수의 결정 (1),유리식,0,0,2,0,0,2,0,0,0,0,0,0
HSU2-01-12,HSU2,수학2,1,함수의 극한,12,미정계수의 결정 (2),무리식,0,0,0,1,0,1,0,0,0,0,0,0
HSU2-01-13,HSU2,수학2,1,함수의 극한,13,다항함수의 결정,,0,0,2,9,0,11,0,0,0,0,0,0
HSU2-01-14,HSU2,수학2,1,함수의 극한,14,함수의 극한의 대소 관계,,0,0,0,0,0,0,0,0,0,0,0,0
HSU2-01-15,HSU2,수학2,1,함수의 극한,15,가우스 기호를 포함한 함수의 극한,,0,0,0,0,0,0,0,0,0,0,0,0
HSU2-01-16,HSU2,수학2,1,함수의 극한,16,함수의 극한의 활용,,0,1,0,10,3,14,0,0,0,0,0,0
HSU2-02-01,HSU2,수학2,2,함수의 연속,1,함수의 연속,,0,0,0,2,1,3,0,0,0,0,0,0
HSU2-02-02,HSU2,수학2,2,함수의 연속,2,불연속이 되도록 하는 x의 값,,0,0,0,0,1,1,0,0,0,0,0,0
HSU2-02-03,HSU2,수학2,2,함수의 연속,3,함수의 그래프와 연속 (1),,0,0,0,2,4,6,0,0,0,0,0,0
HSU2-02-04,HSU2,수학2,2,함수의 연속,4,함수의 그래프와 연속 (2),합성함수,0,0,0,2,0,2,0,0,0,0,0,0
HSU2-02-05,HSU2,수학2,2,함수의 연속,5,함수가 연속일 조건 (1),주어진 함수,0,1,9,6,0,16,0,0,0,0,0,0
HSU2-02-06,HSU2,수학2,2,함수의 연속,6,함수가 연속일 조건 (2),새로운 함수,0,0,1,7,9,17,0,0,0,0,0,0
HSU2-02-07,HSU2,수학2,2,함수의 연속,7,가우스 기호를 포함한 함수의 연속,,0,0,0,0,0,0,0,0,0,0,0,0
HSU2-02-08,HSU2,수학2,2,함수의 연속,8,(x-a)f(x) 꼴의 함수의 연속,,0,0,0,0,0,0,0,0,0,0,0,0
HSU2-02-09,HSU2,수학2,2,함수의 연속,9,연속함수의 성질,,0,0,0,1,0,1,0,0,0,0,0,0
HSU2-02-10,HSU2,수학2,2,함수의 연속,10,최대·최소 정리,,0,0,0,0,0,0,0,0,0,0,0,0
HSU2-02-11,HSU2,수학2,2,함수의 연속,11,사잇값의 정리 (1),실근이 존재하는 구간,0,0,1,1,0,2,0,0,0,0,0,0
HSU2-02-12,HSU2,수학2,2,함수의 연속,12,사잇값의 정리 (2),실근의 개수,0,0,0,0,1,1,0,0,0,0,0,0
HSU2-02-13,HSU2,수학2,2,함수의 연속,13,사잇값의 정리 (3),실생활에의 활용,0,0,0,0,0,0,0,0,0,0,0,0
HSU2-03-01,HSU2,수학2,3,미분계수와 도함수,1,평균변화율,,0,1,1,0,0,2,0,0,0,0,0,0
HSU2-03-02,HSU2,수학2,3,미분계수와 도함수,2,평균변화율의 기하적 의미,,0,0,0,0,0,0,0,0,0,0,0,0
HSU2-03-03,HSU2,수학2,3,미분계수와 도함수,3,평균변화율과 미분계수,,0,0,0,0,0,0,0,0,0,0,0,0
HSU2-03-04,HSU2,수학2,3,미분계수와 도함수,4,미분계수를 이용한 극한값의 계산 (1),lim(h→0) {f(a+h)-f(a)}/h,0,0,2,1,0,3,0,0,0,0,0,0
HSU2-03-05,HSU2,수학2,3,미분계수와 도함수,5,미분계수를 이용한 극한값의 계산 (2),lim(x→a) {f(x)-f(a)}/(x-a),0,0,0,1,0,1,0,0,0,0,0,0
HSU2-03-06,HSU2,수학2,3,미분계수와 도함수,6,관계식이 주어질 때 미분계수 구하기,,0,0,1,0,0,1,0,0,0,0,0,0
HSU2-03-07,HSU2,수학2,3,미분계수와 도함수,7,미분계수의 기하적 의미,,0,0,0,1,0,1,0,0,0,0,0,0
HSU2-03-08,HSU2,수학2,3,미분계수와 도함수,8,미분가능성과 연속성,,0,0,3,2,1,6,0,0,0,0,0,0
HSU2-03-09,HSU2,수학2,3,미분계수와 도함수,9,도함수의 정의를 이용하여 도함수 구하기,,0,0,0,1,0,1,0,0,0,0,0,0
HSU2-03-10,HSU2,수학2,3,미분계수와 도함수,10,관계식이 주어질 때 도함수 구하기,,0,0,0,0,0,0,0,0,0,0,0,0
HSU2-03-11,HSU2,수학2,3,미분계수와 도함수,11,다항함수의 미분법,,0,13,5,2,0,20,0,0,0,0,0,0
HSU2-03-12,HSU2,수학2,3,미분계수와 도함수,12,곱의 미분법 (1),y=f(x)g(x) 꼴,0,0,0,2,0,2,0,0,0,0,0,0
HSU2-03-13,HSU2,수학2,3,미분계수와 도함수,13,곱의 미분법 (2),y={f(x)}ⁿ 꼴,0,1,0,0,0,1,0,0,0,0,0,0
HSU2-03-14,HSU2,수학2,3,미분계수와 도함수,14,미분계수를 이용한 극한값의 계산 (3),함수식이 주어질때,0,0,2,1,0,3,0,0,0,0,0,0
HSU2-03-15,HSU2,수학2,3,미분계수와 도함수,15,미분계수를 이용한 미정계수의 결정,,0,0,0,0,0,0,0,0,0,0,0,0
HSU2-03-16,HSU2,수학2,3,미분계수와 도함수,16,함수의 미분가능성을 이용한 미정계수의 결정,,0,0,2,2,1,5,0,0,0,0,0,0
HSU2-03-17,HSU2,수학2,3,미분계수와 도함수,17,치환을 이용한 극한값의 계산,,0,0,0,0,1,1,0,0,0,0,0,0
HSU2-03-18,HSU2,수학2,3,미분계수와 도함수,18,접선의 기울기를 이용한 미정계수의 결정,,0,0,1,0,0,1,0,0,0,0,0,0
HSU2-03-19,HSU2,수학2,3,미분계수와 도함수,19,미분의 항등식에의 활용,,0,0,0,1,0,1,0,0,0,0,0,0
HSU2-03-20,HSU2,수학2,3,미분계수와 도함수,20,다항식의 나눗셈에서 미분법의 활용 (1),나누어 떨어지는 경우,0,0,0,0,0,0,0,0,0,0,0,0
HSU2-03-21,HSU2,수학2,3,미분계수와 도함수,21,다항식의 나눗셈에서 미분법의 활용 (2),나누어 떨어지지 않는 경우,0,0,0,0,0,0,0,0,0,0,0,0
HSU2-04-01,HSU2,수학2,4,도함수의 활용 (1),1,접선의 기울기,,0,0,3,0,0,3,0,0,0,0,0,0
HSU2-04-02,HSU2,수학2,4,도함수의 활용 (1),2,접선의 기울기의 최댓값 또는 최솟값,,0,0,0,0,0,0,0,0,0,0,0,0
HSU2-04-03,HSU2,수학2,4,도함수의 활용 (1),3,접선의 방정식 (1),접점의 좌표가 주어진 경우,0,0,0,1,0,1,0,0,0,0,0,0
HSU2-04-04,HSU2,수학2,4,도함수의 활용 (1),4,접선과 수직인 직선의 방정식,,0,0,0,0,0,0,0,0,0,0,0,0
HSU2-04-05,HSU2,수학2,4,도함수의 활용 (1),5,곡선과 접선의 교점,,0,0,0,1,0,1,0,0,0,0,0,0
HSU2-04-06,HSU2,수학2,4,도함수의 활용 (1),6,접선의 방정식 (2),기울기가 주어진 경우,0,0,0,1,0,1,0,0,0,0,0,0
HSU2-04-07,HSU2,수학2,4,도함수의 활용 (1),7,곡선 위의 점과 직선 사이의 거리의 최솟값,,0,0,0,0,0,0,0,0,0,0,0,0
HSU2-04-08,HSU2,수학2,4,도함수의 활용 (1),8,접선의 방정식 (3),곡선 밖의 한 점이 주어진 경우,0,0,0,1,0,1,0,0,0,0,0,0
HSU2-04-09,HSU2,수학2,4,도함수의 활용 (1),9,공통인 접선,,0,0,0,0,1,1,0,0,0,0,0,0
HSU2-04-10,HSU2,수학2,4,도함수의 활용 (1),10,두 곡선의 교점에서의 접선,,0,0,0,1,0,1,0,0,0,0,0,0
HSU2-04-11,HSU2,수학2,4,도함수의 활용 (1),11,접선과 좌표축으로 둘러싸인 도형의 넓이,,0,0,0,0,0,0,0,0,0,0,0,0
HSU2-04-12,HSU2,수학2,4,도함수의 활용 (1),12,곡선과 원의 접선,,0,0,0,1,0,1,0,0,0,0,0,0
HSU2-04-13,HSU2,수학2,4,도함수의 활용 (1),13,롤의 정리,,0,0,0,0,0,0,0,0,0,0,0,0
HSU2-04-14,HSU2,수학2,4,도함수의 활용 (1),14,평균값 정리 ,,0,0,0,0,0,0,0,0,0,0,0,0
HSU2-04-15,HSU2,수학2,4,도함수의 활용 (1),15,접선의 방정식의 활용 (1),기울기가 주어진 경우,0,0,0,0,0,0,0,0,0,0,0,0
HSU2-04-16,HSU2,수학2,4,도함수의 활용 (1),16,접선의 방정식의 활용 (2),곡선 밖의 한 점이 주어진 경우,0,0,0,1,1,2,0,0,0,0,0,0
HSU2-05-01,HSU2,수학2,5,도함수의 활용 (2),1,함수의 증가와 감소,,0,0,0,1,0,1,0,0,0,0,0,0
HSU2-05-02,HSU2,수학2,5,도함수의 활용 (2),2,삼차함수가 증가 또는 감소하기 위한 조건 (1),실수 전체,0,0,0,0,0,0,0,0,0,0,0,0
HSU2-05-03,HSU2,수학2,5,도함수의 활용 (2),3,삼차함수가 증가 또는 감소하기 위한 조건 (2),주어진 구간,0,0,0,0,0,0,0,0,0,0,0,0
HSU2-05-04,HSU2,수학2,5,도함수의 활용 (2),4,함수의 그래프와 증가·감소,,0,0,0,1,0,1,0,0,0,0,0,0
HSU2-05-05,HSU2,수학2,5,도함수의 활용 (2),5,함수의 극대와 극소,,0,0,3,2,0,5,0,0,0,0,0,0
HSU2-05-06,HSU2,수학2,5,도함수의 활용 (2),6,함수의 극값과 미정계수,,0,0,1,0,0,1,0,0,0,0,0,0
HSU2-05-07,HSU2,수학2,5,도함수의 활용 (2),7,함수의 극대와 극소의 활용,,0,0,0,0,1,1,0,0,0,0,0,0
HSU2-05-08,HSU2,수학2,5,도함수의 활용 (2),8,극값을 이용한 삼차함수의 계수의 부호 결정,,0,0,0,0,0,0,0,0,0,0,0,0
HSU2-05-09,HSU2,수학2,5,도함수의 활용 (2),9,도함수의 그래프와 함수의 극값,,0,0,0,0,0,0,0,0,0,0,0,0
HSU2-05-10,HSU2,수학2,5,도함수의 활용 (2),10,도함수의 그래프의 해석,,0,0,0,1,1,2,0,0,0,0,0,0
HSU2-05-11,HSU2,수학2,5,도함수의 활용 (2),11,삼차함수가 극값을 가질 조건 (1),,0,0,0,0,0,0,0,0,0,0,0,0
HSU2-05-12,HSU2,수학2,5,도함수의 활용 (2),12,삼차함수가 극값을 갖지 않을 조건,,0,0,0,0,0,0,0,0,0,0,0,0
HSU2-05-13,HSU2,수학2,5,도함수의 활용 (2),13,삼차함수가 극값을 가질 조건 (2),주어진 구간,0,0,0,0,0,0,0,0,0,0,0,0
HSU2-05-14,HSU2,수학2,5,도함수의 활용 (2),14,사차함수가 극값을 가질 조건,,0,0,0,0,0,0,0,0,0,0,0,0
HSU2-05-15,HSU2,수학2,5,도함수의 활용 (2),15,사차함수가 극값을 갖지 않을 조건,,0,0,0,0,0,0,0,0,0,0,0,0
HSU2-05-16,HSU2,수학2,5,도함수의 활용 (2),16,함수의 최대·최소,,0,0,2,1,2,5,0,0,0,0,0,0
HSU2-05-17,HSU2,수학2,5,도함수의 활용 (2),17,함수의 최대·최소를 이용한 미정계수의 결정,,0,0,0,4,0,4,0,0,0,0,0,0
HSU2-05-18,HSU2,수학2,5,도함수의 활용 (2),18,최대·최소의 활용 (1),실생활,0,0,0,0,0,0,0,0,0,0,0,0
HSU2-05-19,HSU2,수학2,5,도함수의 활용 (2),19,최대·최소의 활용 (2),"길이, 넓이",0,0,0,0,0,0,0,0,0,0,0,0
HSU2-05-20,HSU2,수학2,5,도함수의 활용 (2),20,최대·최소의 활용 (3),부피,0,0,0,0,0,0,0,0,0,0,0,0
HSU2-06-01,HSU2,수학2,6,도함수의 활용 (3),1,방정식의 실근의 개수,,0,0,0,3,2,5,0,0,0,0,0,0
HSU2-06-02,HSU2,수학2,6,도함수의 활용 (3),2,방정식의 실근의 부호,,0,0,0,0,0,0,0,0,0,0,0,0
HSU2-06-03,HSU2,수학2,6,도함수의 활용 (3),3,삼차방정식의 근의 판별,,0,0,0,0,2,2,0,0,0,0,0,0
HSU2-06-04,HSU2,수학2,6,도함수의 활용 (3),4,두 그래프의 교점의 개수,,0,0,0,2,1,3,0,0,0,0,0,0
HSU2-06-05,HSU2,수학2,6,도함수의 활용 (3),5,접선의 개수,,0,0,0,0,1,1,0,0,0,0,0,0
HSU2-06-06,HSU2,수학2,6,도함수의 활용 (3),6,주어진 구간에서 부등식이 항상 성립할 조건,,0,0,0,2,0,2,0,0,0,0,0,0
HSU2-06-07,HSU2,수학2,6,도함수의 활용 (3),7,부등식이 항상 성립할 조건,,0,0,0,1,0,1,0,0,0,0,0,0
HSU2-06-08,HSU2,수학2,6,도함수의 활용 (3),8,속도와 가속도,,0,0,2,3,0,5,0,0,0,0,0,0
HSU2-06-09,HSU2,수학2,6,도함수의 활용 (3),9,속력의 최댓값,,0,0,0,0,0,0,0,0,0,0,0,0
HSU2-06-10,HSU2,수학2,6,도함수의 활용 (3),10,속도·가속도와 운동 방향,,0,0,0,3,0,3,0,0,0,0,0,0
HSU2-06-11,HSU2,수학2,6,도함수의 활용 (3),11,정지하는 물체의 속도와 움직인 거리,,0,0,0,0,0,0,0,0,0,0,0,0
HSU2-06-12,HSU2,수학2,6,도함수의 활용 (3),12,위로 던진 물체의 위치와 속도,,0,0,0,0,0,0,0,0,0,0,0,0
HSU2-06-13,HSU2,수학2,6,도함수의 활용 (3),13,속도의 그래프의 해석,,0,0,0,0,0,0,0,0,0,0,0,0
HSU2-06-14,HSU2,수학2,6,도함수의 활용 (3),14,위치의 그래프의 해석,,0,0,0,0,0,0,0,0,0,0,0,0
HSU2-06-15,HSU2,수학2,6,도함수의 활용 (3),15,시각에 대한 길이의 변화율,,0,0,0,0,0,0,0,0,0,0,0,0
HSU2-06-16,HSU2,수학2,6,도함수의 활용 (3),16,"시각에 대한 넓이, 부피의 변화율",,0,0,0,0,0,0,0,0,0,0,0,0
HSU2-07-01,HSU2,수학2,7,부정적분,1,부정적분의 정의,,0,1,2,0,0,3,0,0,0,0,0,0
HSU2-07-02,HSU2,수학2,7,부정적분,2,부정적분과 미분의 관계 (1),d/dx∫f(x)dx=f(x),0,1,1,0,0,2,0,0,0,0,0,0
HSU2-07-03,HSU2,수학2,7,부정적분,3,부정적분과 미분의 관계 (2),∫{d/dxf(x)}dx=f(x)+C,0,0,0,0,0,0,0,0,0,0,0,0
HSU2-07-04,HSU2,수학2,7,부정적분,4,부정적분과 미분의 관계를 이용한 함수의 결정,,0,0,0,1,0,1,0,0,0,0,0,0
HSU2-07-05,HSU2,수학2,7,부정적분,5,부정적분의 계산,,0,0,3,0,1,4,0,0,0,0,0,0
HSU2-07-06,HSU2,수학2,7,부정적분,6,도함수가 주어질 때 함수 구하기,,0,0,3,0,1,4,0,0,0,0,0,0
HSU2-07-07,HSU2,수학2,7,부정적분,7,f(x)와 그 부정적분 F(x)의 관계,,0,0,0,0,0,0,0,0,0,0,0,0
HSU2-07-08,HSU2,수학2,7,부정적분,8,부정적분과 함수의 연속성,,0,0,0,0,0,0,0,0,0,0,0,0
HSU2-07-09,HSU2,수학2,7,부정적분,9,부정적분과 접선의 기울기,,0,0,0,0,0,0,0,0,0,0,0,0
HSU2-07-10,HSU2,수학2,7,부정적분,10,미분계수와 부정적분,,0,0,0,1,0,1,0,0,0,0,0,0
HSU2-07-11,HSU2,수학2,7,부정적분,11,도함수의 정의를 이용한 부정적분,,0,0,0,0,0,0,0,0,0,0,0,0
HSU2-07-12,HSU2,수학2,7,부정적분,12,극대·극소와 부정적분,,0,0,0,0,0,0,0,0,0,0,0,0
HSU2-08-01,HSU2,수학2,8,정적분,1,정적분의 정의,,0,2,8,1,1,12,0,0,0,0,0,0
HSU2-08-02,HSU2,수학2,8,정적분,2,정적분의 정의의 활용,,0,0,1,1,0,2,0,0,0,0,0,0
HSU2-08-03,HSU2,수학2,8,정적분,3,정적분의 계산 (1),적분 구간이 같은 경우,0,0,0,0,0,0,0,0,0,0,0,0
HSU2-08-04,HSU2,수학2,8,정적분,4,정적분의 계산 (2),피적분함수가 같은 경우,0,0,1,1,0,2,0,0,0,0,0,0
HSU2-08-05,HSU2,수학2,8,정적분,5,정적분의 계산 (3),구간에 따라 다르게 정의된 함수,0,0,0,0,0,0,0,0,0,0,0,0
HSU2-08-06,HSU2,수학2,8,정적분,6,정적분의 계산 (4),절댓값 기호를 포함한 함수,0,0,1,0,1,2,0,0,0,0,0,0
HSU2-08-07,HSU2,수학2,8,정적분,7,우함수와 기함수의 정적분 (1),피적분함수가 주어진 경우,0,0,0,1,0,1,0,0,0,0,0,0
HSU2-08-08,HSU2,수학2,8,정적분,8,우함수와 기함수의 정적분 (2),피적분함수가 주어지지 않은 경우,0,0,0,0,0,0,0,0,0,0,0,0
HSU2-08-09,HSU2,수학2,8,정적분,9,적분 구간이 상수인 등식,,0,0,0,0,0,0,0,0,0,0,0,0
HSU2-08-10,HSU2,수학2,8,정적분,10,적분 구간에 변수가 있는 등식 (1),아래끝 또는 위끝에 변수가 있는 경우,0,0,4,4,1,9,0,0,0,0,0,0
HSU2-08-11,HSU2,수학2,8,정적분,11,적분 구간에 변수가 있는 등식 (2),피적분함수에 변수가 있는 경우,0,0,0,0,0,0,0,0,0,0,0,0
HSU2-08-12,HSU2,수학2,8,정적분,12,정적분으로 정의된 함수의 극대·극소,,0,0,0,1,2,3,0,0,0,0,0,0
HSU2-08-13,HSU2,수학2,8,정적분,13,정적분으로 정의된 함수의 최대·최소,,0,0,1,3,0,4,0,0,0,0,0,0
HSU2-08-14,HSU2,수학2,8,정적분,14,정적분으로 정의된 함수의 극한 (1),lim(x→0) 1/x∫(a→x+a)f(t)dt 꼴,0,0,0,0,0,0,0,0,0,0,0,0
HSU2-08-15,HSU2,수학2,8,정적분,15,정적분으로 정의된 함수의 극한 (2),lim(x→a) 1/(x-a)∫(a→x)f(t)dt 꼴,0,0,0,0,0,0,0,0,0,0,0,0
HSU2-08-16,HSU2,수학2,8,정적분,16,주기함수의 정적분,,0,0,0,0,0,0,0,0,0,0,0,0
HSU2-09-01,HSU2,수학2,9,정적분의 활용,1,곡선과 x축 사이의 넓이,,0,0,1,2,0,3,0,0,0,0,0,0
HSU2-09-02,HSU2,수학2,9,정적분의 활용,2,곡선과 직선 사이의 넓이,,0,0,0,1,0,1,0,0,0,0,0,0
HSU2-09-03,HSU2,수학2,9,정적분의 활용,3,두 곡선 사이의 넓이,,0,0,0,2,0,2,0,0,0,0,0,0
HSU2-09-04,HSU2,수학2,9,정적분의 활용,4,절댓값 기호를 포함한 그래프의 넓이,,0,0,0,1,1,2,0,0,0,0,0,0
HSU2-09-05,HSU2,수학2,9,정적분의 활용,5,곡선과 접선으로 둘러싸인 도형의 넓이,,0,0,0,0,0,0,0,0,0,0,0,0
HSU2-09-06,HSU2,수학2,9,정적분의 활용,6,넓이가 같은 두 도형,,0,0,0,2,0,2,0,0,0,0,0,0
HSU2-09-07,HSU2,수학2,9,정적분의 활용,7,두 곡선 사이의 넓이의 활용 (1),이등분,0,0,0,0,0,0,0,0,0,0,0,0
HSU2-09-08,HSU2,수학2,9,정적분의 활용,8,두 곡선 사이의 넓이의 활용 (2),넓이의 최솟값,0,0,0,0,1,1,0,0,0,0,0,0
HSU2-09-09,HSU2,수학2,9,정적분의 활용,9,함수와 그 역함수의 정적분,,0,0,0,0,0,0,0,0,0,0,0,0
HSU2-09-10,HSU2,수학2,9,정적분의 활용,10,함수와 그 역함수의 그래프로 둘러싸인 도형의 넓이,,0,0,0,0,0,0,0,0,0,0,0,0
HSU2-09-11,HSU2,수학2,9,정적분의 활용,11,위치와 위치의 변화량,,0,0,0,3,0,3,0,0,0,0,0,0
HSU2-09-12,HSU2,수학2,9,정적분의 활용,12,움직인 거리,,0,0,2,2,0,4,0,0,0,0,0,0
HSU2-09-13,HSU2,수학2,9,정적분의 활용,13,그래프에서의 위치와 움직인 거리,,0,0,0,0,0,0,0,0,0,0,0,0
M1S1-01-01,M1S1,중1-1,1,소인수분해,1,약수와 배수,,0,0,8,1,1,10,2,1,2,0,0,5
M1S1-01-02,M1S1,중1-1,1,소인수분해,2,소수와 합성수,,0,7,12,0,0,19,25,0,9,0,0,34
M1S1-01-03,M1S1,중1-1,1,소인수분해,3,거듭제곱,,0,2,15,0,0,17,34,2,6,0,0,42
M1S1-01-04,M1S1,중1-1,1,소인수분해,4,소인수분해,,1,3,11,0,0,15,17,13,10,0,0,40
M1S1-01-05,M1S1,중1-1,1,소인수분해,5,제곱인 수 만들기,,0,0,10,6,2,18,4,11,12,2,2,31
M1S1-01-06,M1S1,중1-1,1,소인수분해,6,약수 구하기,,0,4,5,2,0,11,3,4,3,1,1,12
M1S1-01-07,M1S1,중1-1,1,소인수분해,7,약수의 개수 구하기,,5,0,5,0,0,10,2,12,4,0,1,19
M1S1-01-08,M1S1,중1-1,1,소인수분해,8,약수의 개수가 주어졌을 때 미지수 구하기,,0,0,11,6,0,17,0,0,4,0,4,8
M1S1-01-09,M1S1,중1-1,1,소인수분해,9,약수의 개수가 주어진 자연수 구하기,,0,0,2,9,1,12,0,0,1,1,3,5
M1S1-02-01,M1S1,중1-1,2,최대공약수와 최소공배수,1,공약수와 최대공약수,,0,6,7,0,0,13,46,13,7,1,1,68
M1S1-02-02,M1S1,중1-1,2,최대공약수와 최소공배수,2,서로소,,0,11,7,0,0,18,2,1,5,0,1,9
M1S1-02-03,M1S1,중1-1,2,최대공약수와 최소공배수,3,공배수와 최소공배수,,0,6,7,0,0,13,48,5,7,0,1,61
M1S1-02-04,M1S1,중1-1,2,최대공약수와 최소공배수,4,최대공약수 또는 최소공배수를 이용한 미지수 계산,,0,0,10,5,2,17,2,4,16,4,3,29
M1S1-02-05,M1S1,중1-1,2,최대공약수와 최소공배수,5,최대공약수의 활용 (1),일정한 양을 최대한 많은 사람에게 나누어 주기,0,0,8,0,2,10,9,1,5,0,1,16
M1S1-02-06,M1S1,중1-1,2,최대공약수와 최소공배수,6,최대공약수의 활용 (2),"직사각형, 직육면체 채우기",0,0,2,10,0,12,4,3,7,0,0,14
M1S1-02-07,M1S1,중1-1,2,최대공약수와 최소공배수,7,최대공약수의 활용 (3),일정한 간격으로 놓기,0,0,4,7,0,11,0,0,6,1,0,7
M1S1-02-08,M1S1,중1-1,2,최대공약수와 최소공배수,8,최대공약수의 활용 (4),자연수로 나누기,0,0,6,4,0,10,2,1,7,1,2,13
M1S1-02-09,M1S1,중1-1,2,최대공약수와 최소공배수,9,최소공배수의 활용 (1),동시에 출발하여 다시 만나는 경우,0,0,6,8,1,15,3,3,7,0,1,14
M1S1-02-10,M1S1,중1-1,2,최대공약수와 최소공배수,10,최소공배수의 활용 (2),톱니바퀴,0,0,4,7,0,11,0,1,5,0,0,6
M1S1-02-11,M1S1,중1-1,2,최대공약수와 최소공배수,11,최소공배수의 활용 (3),"정사각형, 정육면체 만들기",0,0,2,10,0,12,2,4,5,0,0,11
M1S1-02-12,M1S1,중1-1,2,최대공약수와 최소공배수,12,최소공배수의 활용 (4),자연수를 나누기,0,0,0,8,4,12,2,0,8,1,2,13
M1S1-02-13,M1S1,중1-1,2,최대공약수와 최소공배수,13,분수를 자연수로 만들기,,0,0,5,2,5,12,2,2,9,1,1,15
M1S1-02-14,M1S1,중1-1,2,최대공약수와 최소공배수,14,최대공약수와 최소공배수의 관계,,0,2,2,7,1,12,4,0,5,0,6,15
M1S1-03-01,M1S1,중1-1,3,정수와 유리수,1,양의 부호와 음의 부호,,0,17,6,0,0,23,22,0,1,0,0,23
M1S1-03-02,M1S1,중1-1,3,정수와 유리수,2,정수와 유리수의 분류,,0,3,15,0,0,18,10,20,9,0,0,39
M1S1-03-03,M1S1,중1-1,3,정수와 유리수,3,수직선 위에 수 나타내기,,0,3,4,7,0,14,8,1,5,0,0,14
M1S1-03-04,M1S1,중1-1,3,정수와 유리수,4,수직선 위에서 같은 거리에 있는 점,,0,0,6,6,0,12,1,0,4,1,1,7
M1S1-03-05,M1S1,중1-1,3,정수와 유리수,5,절댓값,,3,0,7,3,1,14,10,0,13,1,1,25
M1S1-03-06,M1S1,중1-1,3,정수와 유리수,6,절댓값이 같고 부호가 반대인 두 수,,0,1,12,0,0,13,0,4,3,0,0,7
M1S1-03-07,M1S1,중1-1,3,정수와 유리수,7,절댓값의 대소 관계,,0,1,12,2,0,15,1,4,6,0,1,12
M1S1-03-08,M1S1,중1-1,3,정수와 유리수,8,두 수의 대소 관계와 부등호 사용,,0,6,11,0,0,17,27,9,6,0,1,43
M1S1-03-09,M1S1,중1-1,3,정수와 유리수,9,세 수 이상의 대소 관계,,1,0,7,0,4,12,8,0,2,0,4,14
M1S1-03-10,M1S1,중1-1,3,정수와 유리수,10,주어진 범위에 포함되는 수,,0,0,7,6,0,13,4,1,4,2,2,13
M1S1-04-01,M1S1,중1-1,4,유리수의 계산,1,유리수의 덧셈,,8,6,5,0,0,19,40,3,2,0,0,45
M1S1-04-02,M1S1,중1-1,4,유리수의 계산,2,덧셈의 계산법칙,,0,4,8,0,0,12,21,2,1,0,0,24
M1S1-04-03,M1S1,중1-1,4,유리수의 계산,3,유리수의 뺄셈,,11,2,2,0,0,15,45,1,4,0,0,50
M1S1-04-04,M1S1,중1-1,4,유리수의 계산,4,덧셈과 뺄셈의 혼합계산,,0,3,10,1,1,15,23,16,16,0,1,56
M1S1-04-05,M1S1,중1-1,4,유리수의 계산,5,어떤 수 보다 빈 칸만큼 크거나 작은 수,,0,3,10,0,0,13,0,2,5,0,2,9
M1S1-04-06,M1S1,중1-1,4,유리수의 계산,6,빈 칸 안에 들어갈 수 구하기,"덧셈, 뺄셈",0,0,7,1,4,12,2,2,3,0,1,8
M1S1-04-07,M1S1,중1-1,4,유리수의 계산,7,절댓값이 주어진 수의 덧셈과 뺄셈,,0,2,12,1,0,15,1,0,6,1,0,8
M1S1-04-08,M1S1,중1-1,4,유리수의 계산,8,유리수의 덧셈과 뺄셈의 활용,,0,0,12,0,0,12,2,1,10,1,1,15
M1S1-04-09,M1S1,중1-1,4,유리수의 계산,9,유리수의 곱셈,,6,3,8,1,2,20,29,2,3,1,1,36
M1S1-04-10,M1S1,중1-1,4,유리수의 계산,10,곱셈의 계산법칙,,2,0,7,0,0,9,21,1,0,0,0,22
M1S1-04-11,M1S1,중1-1,4,유리수의 계산,11,곱이 가장 크거나 작은 수,,0,0,10,0,0,10,0,0,4,1,1,6
M1S1-04-12,M1S1,중1-1,4,유리수의 계산,12,거듭제곱의 계산,,0,2,10,2,0,14,13,8,4,2,2,29
M1S1-04-13,M1S1,중1-1,4,유리수의 계산,13,분배법칙,,1,1,12,1,0,15,3,11,5,1,0,20
M1S1-04-14,M1S1,중1-1,4,유리수의 계산,14,역수,,0,2,9,2,0,13,5,3,2,0,0,10
M1S1-04-15,M1S1,중1-1,4,유리수의 계산,15,유리수의 나눗셈,,12,6,11,0,0,29,26,1,7,0,0,34
M1S1-04-16,M1S1,중1-1,4,유리수의 계산,16,곱셈과 나눗셈의 혼합계산,,0,3,5,4,0,12,5,1,5,0,0,11
M1S1-04-17,M1S1,중1-1,4,유리수의 계산,17,"덧셈, 뺄셈, 곱셈, 나눗셈의 혼합계산",,0,6,13,1,0,20,3,7,11,0,1,22
M1S1-04-18,M1S1,중1-1,4,유리수의 계산,18,빈 칸안에 들어갈 수 구하기 ,"곱셈, 나눗셈",0,0,5,5,0,10,2,0,3,3,1,9
M1S1-04-19,M1S1,중1-1,4,유리수의 계산,19,바르게 계산했을 때의 답 구하기,,0,1,11,0,0,12,0,0,8,0,1,9
M1S1-04-20,M1S1,중1-1,4,유리수의 계산,20,문자로 주어진 수의 대소 비교,,0,2,12,1,1,16,0,1,13,0,1,15
M1S1-04-21,M1S1,중1-1,4,유리수의 계산,21,유리수의 혼합 계산과 실생활 활용,,2,1,2,5,0,10,10,1,8,0,5,24
M1S1-05-01,M1S1,중1-1,5,문자와 식,1,곱셈 기호와 나눗셈 기호 생략하기,,1,1,9,0,0,11,49,2,8,0,0,59
M1S1-05-02,M1S1,중1-1,5,문자와 식,2,문자를 사용한 식 (1),"비율, 단위, 수, 금액",0,1,8,1,1,11,3,1,7,0,4,15
M1S1-05-03,M1S1,중1-1,5,문자와 식,3,문자를 사용한 식 (2),도형,0,4,14,0,0,18,1,0,6,0,0,7
M1S1-05-04,M1S1,중1-1,5,문자와 식,4,문자를 사용한 식 (3),속력,0,5,7,1,1,14,2,2,6,0,1,11
M1S1-05-05,M1S1,중1-1,5,문자와 식,5,문자를 사용한 식 (4),종합,0,0,18,3,0,21,0,0,6,0,0,6
M1S1-05-06,M1S1,중1-1,5,문자와 식,6,식의 값,,0,2,15,0,0,17,18,16,8,3,1,46
M1S1-05-07,M1S1,중1-1,5,문자와 식,7,식의 값의 활용,,1,0,6,3,2,12,3,2,14,0,0,19
M1S1-05-08,M1S1,중1-1,5,문자와 식,8,다항식,,0,4,9,0,0,13,4,10,3,0,0,17
M1S1-05-09,M1S1,중1-1,5,문자와 식,9,일차식,,0,7,5,0,0,12,4,1,2,0,0,7
M1S1-05-10,M1S1,중1-1,5,문자와 식,10,일차식과 수의 곱셈과 나눗셈,,4,17,11,0,0,32,19,10,6,0,0,35
M1S1-05-11,M1S1,중1-1,5,문자와 식,11,동류항,,0,3,15,0,0,18,34,3,3,0,0,40
M1S1-05-12,M1S1,중1-1,5,문자와 식,12,일차식의 덧셈과 뺄셈,,2,4,4,0,0,10,17,32,10,1,0,60
M1S1-05-13,M1S1,중1-1,5,문자와 식,13,여러가지 일차식의 덧셈과 뺄셈,,0,0,21,0,0,21,0,0,12,1,1,14
M1S1-05-14,M1S1,중1-1,5,문자와 식,14,일차식을 만족하는 미지수 구하기,,0,1,8,2,0,11,0,0,3,1,0,4
M1S1-05-15,M1S1,중1-1,5,문자와 식,15,일차식을 문자에 대입하기,,0,0,9,2,0,11,0,1,4,1,1,7
M1S1-05-16,M1S1,중1-1,5,문자와 식,16,빈 칸안에 들어갈 식 구하기,,0,0,9,3,0,12,2,0,4,1,1,8
M1S1-05-17,M1S1,중1-1,5,문자와 식,17,바르게 계산했을 때의 식 구하기,,0,0,11,0,0,11,0,0,7,2,0,9
M1S1-05-18,M1S1,중1-1,5,문자와 식,18,일차식의 덧셈과 뺄셈의 활용,,0,0,7,3,0,10,0,0,8,2,1,11
M1S1-05-19,M1S1,중1-1,5,문자와 식,19,(-1)ⁿ 형태가 포함된 일차식 계산하기,,0,1,0,8,1,10,0,0,0,3,1,4
M1S1-06-01,M1S1,중1-1,6,일차방정식의 풀이,1,등식,,0,5,5,0,0,10,8,1,8,0,0,17
M1S1-06-02,M1S1,중1-1,6,일차방정식의 풀이,2,방정식의 해,,1,0,10,0,0,11,8,8,7,1,0,24
M1S1-06-03,M1S1,중1-1,6,일차방정식의 풀이,3,방정식과 항등식,,0,3,12,0,0,15,8,2,4,0,0,14
M1S1-06-04,M1S1,중1-1,6,일차방정식의 풀이,4,항등식이 되도록 하는 조건,,0,0,11,0,0,11,1,1,6,0,1,9
M1S1-06-05,M1S1,중1-1,6,일차방정식의 풀이,5,등식의 성질,,0,1,12,2,0,15,9,4,8,0,1,22
M1S1-06-06,M1S1,중1-1,6,일차방정식의 풀이,6,등식의 성질을 이용하여 방정식 풀기,,0,3,10,0,0,13,1,3,4,0,1,9
M1S1-06-07,M1S1,중1-1,6,일차방정식의 풀이,7,이항,,0,13,6,0,0,19,5,8,3,0,0,16
M1S1-06-08,M1S1,중1-1,6,일차방정식의 풀이,8,일차방정식,,0,5,18,1,0,24,14,11,5,0,0,30
M1S1-06-09,M1S1,중1-1,6,일차방정식의 풀이,9,괄호가 있는 일차방정식,,0,7,10,0,0,17,5,9,6,1,1,22
M1S1-06-10,M1S1,중1-1,6,일차방정식의 풀이,10,계수가 소수인 일차방정식,,0,10,7,0,0,17,10,3,6,0,0,19
M1S1-06-11,M1S1,중1-1,6,일차방정식의 풀이,11,계수가 분수인 일차방정식,,0,0,11,0,0,11,6,8,6,2,1,23
M1S1-06-12,M1S1,중1-1,6,일차방정식의 풀이,12,계수에 소수와 분수가 혼합되어 있는 일차방정식,,0,1,17,1,0,19,0,2,9,1,0,12
M1S1-06-13,M1S1,중1-1,6,일차방정식의 풀이,13,비례식으로 주어진 일차방정식,,0,0,8,2,0,10,1,1,4,1,0,7
M1S1-06-14,M1S1,중1-1,6,일차방정식의 풀이,14,해가 주어진 일차방정식,,0,1,15,1,0,17,1,4,5,1,0,11
M1S1-06-15,M1S1,중1-1,6,일차방정식의 풀이,15,두 일차방정식의 해가 같은 경우,,0,0,11,1,1,13,0,0,4,4,0,8
M1S1-06-16,M1S1,중1-1,6,일차방정식의 풀이,16,방정식의 해의 조건이 주어진 경우,,0,0,8,4,0,12,0,0,2,4,2,8
M1S1-06-17,M1S1,중1-1,6,일차방정식의 풀이,17,방정식이 특수한 해를 갖는 경우,,0,0,9,1,0,10,0,0,6,1,0,7
M1S1-07-01,M1S1,중1-1,7,일차방정식의 활용,1,어떤 수에 대한 문제,,0,3,7,1,0,11,1,6,5,0,1,13
M1S1-07-02,M1S1,중1-1,7,일차방정식의 활용,2,연속하는 자연수에 대한 문제,,0,1,9,1,0,11,2,5,3,0,1,11
M1S1-07-03,M1S1,중1-1,7,일차방정식의 활용,3,자릿수에 대한 문제,,0,0,9,1,0,10,1,1,6,2,1,11
M1S1-07-04,M1S1,중1-1,7,일차방정식의 활용,4,도형에 대한 문제,,0,1,15,2,1,19,1,4,6,0,1,12
M1S1-07-05,M1S1,중1-1,7,일차방정식의 활용,5,일정한 합,,1,0,9,0,0,10,0,4,5,0,1,10
M1S1-07-06,M1S1,중1-1,7,일차방정식의 활용,6,나이에 대한 문제,,0,0,15,3,0,18,1,1,5,0,1,8
M1S1-07-07,M1S1,중1-1,7,일차방정식의 활용,7,예금액에 대한 문제,,0,0,10,0,1,11,0,1,4,0,0,5
M1S1-07-08,M1S1,중1-1,7,일차방정식의 활용,8,원가와 정가에 대한 문제,,0,0,10,2,0,12,2,1,3,3,3,12
M1S1-07-09,M1S1,중1-1,7,일차방정식의 활용,9,"증가, 감소에 대한 문제",,0,0,11,1,0,12,1,1,5,0,1,8
M1S1-07-10,M1S1,중1-1,7,일차방정식의 활용,10,과부족에 대한 문제,,0,1,10,8,1,20,1,1,5,3,2,12
M1S1-07-11,M1S1,중1-1,7,일차방정식의 활용,11,전체에 대한 비율에 대한 문제,,0,0,11,4,0,15,0,0,7,0,1,8
M1S1-07-12,M1S1,중1-1,7,일차방정식의 활용,12,속력에 대한 문제 (1),총 걸린 시간에 대한 문제,0,0,16,2,0,18,3,5,3,1,1,13
M1S1-07-13,M1S1,중1-1,7,일차방정식의 활용,13,속력에 대한 문제 (2),시간차가 주어진 경우,0,0,11,3,0,14,0,2,4,1,1,8
M1S1-07-14,M1S1,중1-1,7,일차방정식의 활용,14,속력에 대한 문제 (3),시간 차를 두고 출발하는 경우,0,0,9,1,0,10,0,0,7,0,1,8
M1S1-07-15,M1S1,중1-1,7,일차방정식의 활용,15,속력에 대한 문제 (4),마주 보고 걷거나 둘레를 도는 경우,0,0,11,0,0,11,0,0,6,1,1,8
M1S1-07-16,M1S1,중1-1,7,일차방정식의 활용,16,속력에 대한 문제 (5),열차가 다리 또는 터널을 지나는 경우,0,0,9,1,0,10,0,0,3,2,2,7
M1S1-07-17,M1S1,중1-1,7,일차방정식의 활용,17,농도에 대한 문제 (1),소금 또는 물을 넣거나 물을 증발시키는 경우,0,1,13,5,2,21,1,5,9,0,1,16
M1S1-07-18,M1S1,중1-1,7,일차방정식의 활용,18,농도에 대한 문제 (2),두 소금물을 섞는 경우,0,0,11,1,0,12,1,1,4,2,1,9
M1S1-07-19,M1S1,중1-1,7,일차방정식의 활용,19,일에 대한 문제,,0,0,11,7,0,18,1,0,7,1,1,10
M1S1-07-20,M1S1,중1-1,7,일차방정식의 활용,20,시계에 대한 문제,,0,0,11,0,0,11,0,0,3,0,1,4
M1S1-07-21,M1S1,중1-1,7,일차방정식의 활용,21,규칙적인 수에 대한 문제,,0,2,3,2,0,7,0,0,3,0,2,5
M1S1-08-01,M1S1,중1-1,8,좌표평면과 그래프,1,순서쌍과 좌표평면,,0,0,13,1,0,14,10,4,4,0,1,19
M1S1-08-02,M1S1,중1-1,8,좌표평면과 그래프,2,x축 또는 y축 위의 점,,0,6,9,1,0,16,6,2,3,0,0,11
M1S1-08-03,M1S1,중1-1,8,좌표평면과 그래프,3,좌표평면 위의 도형의 넓이,,0,0,10,2,0,12,0,3,4,1,1,9
M1S1-08-04,M1S1,중1-1,8,좌표평면과 그래프,4,사분면,,0,0,15,0,0,15,10,4,2,0,0,16
M1S1-08-05,M1S1,중1-1,8,좌표평면과 그래프,5,사분면의 결정,,0,0,9,9,0,18,1,1,10,2,3,17
M1S1-08-06,M1S1,중1-1,8,좌표평면과 그래프,6,대칭인 점,,0,7,9,1,1,18,1,3,3,1,1,9
M1S1-08-07,M1S1,중1-1,8,좌표평면과 그래프,7,그래프의 해석,,0,1,3,0,1,5,13,8,5,1,1,28
M1S1-08-08,M1S1,중1-1,8,좌표평면과 그래프,8,그래프로 표현하기,,0,3,4,0,3,10,4,2,6,0,0,12
M1S1-09-01,M1S1,중1-1,9,정비례와 반비례 유형,1,정비례 관계,,0,3,13,0,0,16,7,2,3,0,0,12
M1S1-09-02,M1S1,중1-1,9,정비례와 반비례 유형,2,정비례 관계식 구하기,,0,0,4,8,0,12,9,9,9,0,1,28
M1S1-09-03,M1S1,중1-1,9,정비례와 반비례 유형,3,정비례 관계 y=ax (a≠0) 의 그래프,,0,0,10,2,0,12,8,4,8,0,0,20
M1S1-09-04,M1S1,중1-1,9,정비례와 반비례 유형,4,정비례 관계 y=ax (a≠0) 의 그래프가 지나는 점,,0,1,7,0,0,8,3,8,12,0,1,24
M1S1-09-05,M1S1,중1-1,9,정비례와 반비례 유형,5,정비례 관계 y=ax (a≠0) 의 그래프가 주어진 경우,,0,0,13,1,2,16,0,2,5,0,2,9
M1S1-09-06,M1S1,중1-1,9,정비례와 반비례 유형,6,정비례 관계 y=ax (a≠0) 의 그래프와 도형의 넓이,,0,0,7,5,2,14,0,3,5,2,0,10
M1S1-09-07,M1S1,중1-1,9,정비례와 반비례 유형,7,반비례 관계,,0,5,13,0,0,18,7,3,2,0,0,12
M1S1-09-08,M1S1,중1-1,9,정비례와 반비례 유형,8,반비례 관계식 구하기,,0,0,1,9,0,10,3,9,10,2,1,25
M1S1-09-09,M1S1,중1-1,9,정비례와 반비례 유형,9,반비례 관계 y=a/x (a≠0) 의 그래프,,0,0,5,1,0,6,7,5,7,1,0,20
M1S1-09-10,M1S1,중1-1,9,정비례와 반비례 유형,10,반비례 관계 y=a/x (a≠0) 의 그래프가 지나는 점,,0,0,10,9,0,19,1,8,10,1,1,21
M1S1-09-11,M1S1,중1-1,9,정비례와 반비례 유형,11,반비례 관계 y=a/x (a≠0) 의 그래프와 식의 관계,,0,0,4,3,0,7,0,1,12,0,1,14
M1S1-09-12,M1S1,중1-1,9,정비례와 반비례 유형,12,반비례 관계 y=a/x (a≠0) 의 그래프와 도형의 넓이,,0,1,6,2,1,10,0,2,6,1,0,9
M1S1-09-13,M1S1,중1-1,9,정비례와 반비례 유형,13,y=ax (a≠0) 와 y=a/x (a≠0) 의 그래프가 만나는 점,,0,0,10,2,1,13,0,2,4,1,1,8
M2S1-01-01,M2S1,중2-1,1,유리수와 순환소수,1,유한소수와 무한소수,,6,3,1,0,0,10,4,0,1,0,0,5
M2S1-01-02,M2S1,중2-1,1,유리수와 순환소수,2,순환소수와 순환마디,,0,1,12,0,0,13,8,0,6,1,1,16
M2S1-01-03,M2S1,중2-1,1,유리수와 순환소수,3,순환소수의 대소관계,,3,4,5,1,0,13,4,0,3,0,0,7
M2S1-01-04,M2S1,중2-1,1,유리수와 순환소수,4,소수점 아래 n번째 자리 숫자,,0,0,10,2,2,14,0,0,9,0,3,12
M2S1-01-05,M2S1,중2-1,1,유리수와 순환소수,5,분수를 10의 거듭제곱을 이용하여 소수로 나타내기,,0,4,6,0,0,10,0,4,4,0,0,8
M2S1-01-06,M2S1,중2-1,1,유리수와 순환소수,6,유한소수로 나타낼 수 있거나 나타낼 수 없는 분수,,0,0,8,5,0,13,3,4,7,3,2,19
M2S1-01-07,M2S1,중2-1,1,유리수와 순환소수,7,유한소수가 되도록 하는 미지수 구하기(1),(Bx)/A 인 경우,0,1,5,6,1,13,1,4,11,0,1,17
M2S1-01-08,M2S1,중2-1,1,유리수와 순환소수,8,유한소수가 되도록 하는 미지수 구하기(2),B/(Ax) 인 경우,0,4,6,0,0,10,0,2,7,1,1,11
M2S1-01-09,M2S1,중2-1,1,유리수와 순환소수,9,유한소수가 되는 x/A 를 구하고 x/A 를 기약분수로 나타내기,,0,0,10,0,0,10,0,1,4,2,2,9
M2S1-01-10,M2S1,중2-1,1,유리수와 순환소수,10,순환소수 조건을 만족하는 미지수의 값 구하기,,0,0,9,1,0,10,1,0,5,0,0,6
M2S1-01-11,M2S1,중2-1,1,유리수와 순환소수,11,순환소수를 분수로 나타내는 식 구하기,,0,4,9,0,0,13,2,7,4,0,0,13
M2S1-01-12,M2S1,중2-1,1,유리수와 순환소수,12,공식을 이용하여 순환소수를 분수로 나타내기,,0,1,3,5,1,10,1,3,11,2,2,19
M2S1-01-13,M2S1,중2-1,1,유리수와 순환소수,13,"분수의 분모, 분자를 잘못 보고 나타낸 소수",,0,0,10,2,0,12,0,0,6,0,1,7
M2S1-01-14,M2S1,중2-1,1,유리수와 순환소수,14,순환소수가 포함된 식 계산하기,,0,2,6,2,0,10,1,3,4,3,0,11
M2S1-01-15,M2S1,중2-1,1,유리수와 순환소수,15,순환소수가 포함된 방정식과 부등식,,0,0,19,3,0,22,1,0,7,1,0,9
M2S1-01-16,M2S1,중2-1,1,유리수와 순환소수,16,순환소수를 자연수 또는 유한소수로 만드는 미지수 구하기,,0,0,5,2,4,11,0,0,11,0,1,12
M2S1-01-17,M2S1,중2-1,1,유리수와 순환소수,17,유리수와 소수,,0,1,12,0,0,13,2,1,7,0,0,10
M2S1-02-01,M2S1,중2-1,2,단항식의 계산,1,지수법칙 (1),지수의 합,7,5,3,0,0,15,4,3,5,0,1,13
M2S1-02-02,M2S1,중2-1,2,단항식의 계산,2,지수법칙 (2),지수의 곱,5,1,3,1,0,10,6,2,3,0,1,12
M2S1-02-03,M2S1,중2-1,2,단항식의 계산,3,지수법칙 (3),지수의 차,9,4,1,0,0,14,1,3,9,0,0,13
M2S1-02-04,M2S1,중2-1,2,단항식의 계산,4,지수법칙 (4),지수의 분배,9,2,13,4,1,29,3,1,12,1,2,19
M2S1-02-05,M2S1,중2-1,2,단항식의 계산,5,지수법칙 (5),종합 문제,1,1,24,0,0,26,0,0,10,0,0,10
M2S1-02-06,M2S1,중2-1,2,단항식의 계산,6,거듭제곱의 대소 관계,,0,0,8,2,0,10,0,0,0,2,3,5
M2S1-02-07,M2S1,중2-1,2,단항식의 계산,7,지수법칙과 실생활 활용,,0,1,11,0,0,12,0,0,6,0,0,6
M2S1-02-08,M2S1,중2-1,2,단항식의 계산,8,같은 수의 덧셈식 간단히 하기,,0,2,8,2,0,12,0,2,6,4,2,14
M2S1-02-09,M2S1,중2-1,2,단항식의 계산,9,문자를 사용하여 거듭제곱 나타내기,,0,0,9,4,0,13,0,0,12,2,2,16
M2S1-02-10,M2S1,중2-1,2,단항식의 계산,10,aⁿ 형태의 일의 자리 숫자 구하기,,0,0,9,1,0,10,0,0,0,0,4,4
M2S1-02-11,M2S1,중2-1,2,단항식의 계산,11,자릿수 계산,,0,0,6,6,2,14,0,3,4,2,3,12
M2S1-02-12,M2S1,중2-1,2,단항식의 계산,12,단항식의 곱셈,,2,10,8,0,0,20,1,3,9,0,0,13
M2S1-02-13,M2S1,중2-1,2,단항식의 계산,13,단항식의 나눗셈,,1,12,8,3,0,24,0,1,11,0,1,13
M2S1-02-14,M2S1,중2-1,2,단항식의 계산,14,단항식의 곱셈과 나눗셈의 혼합 계산,,0,0,12,5,0,17,0,0,9,0,1,10
M2S1-02-15,M2S1,중2-1,2,단항식의 계산,15,빈 칸안에 알맞은 식 구하기,,0,0,17,2,0,19,0,2,11,0,1,14
M2S1-02-16,M2S1,중2-1,2,단항식의 계산,16,도형에서의 활용 (1),넓이 또는 부피 구하기,1,0,9,3,1,14,1,2,5,0,1,9
M2S1-02-17,M2S1,중2-1,2,단항식의 계산,17,도형에서의 활용 (2),길이 구하기,0,0,18,0,0,18,0,3,4,0,3,10
M2S1-03-01,M2S1,중2-1,3,다항식의 계산,1,다항식의 덧셈과 뺄셈,,0,11,2,0,0,13,4,4,4,1,1,14
M2S1-03-02,M2S1,중2-1,3,다항식의 계산,2,이차식의 덧셈과 뺄셈,,0,5,6,0,0,11,4,5,3,0,0,12
M2S1-03-03,M2S1,중2-1,3,다항식의 계산,3,여러 가지 괄호가 있는 식의 계산,,0,0,15,0,0,15,0,0,9,1,0,10
M2S1-03-04,M2S1,중2-1,3,다항식의 계산,4,다항식과 단항식의 덧셈과 뺄셈,빈 칸안에 알맞은 식 구하기,0,0,6,6,1,13,1,0,6,2,2,11
M2S1-03-05,M2S1,중2-1,3,다항식의 계산,5,바르게 계산한 식 ,,0,0,11,0,0,11,0,0,8,0,1,9
M2S1-03-06,M2S1,중2-1,3,다항식의 계산,6,단항식과 다항식의 곱셈,,0,6,5,0,0,11,1,7,4,0,0,12
M2S1-03-07,M2S1,중2-1,3,다항식의 계산,7,다항식과 단항식의 나눗셈,,0,9,7,0,0,16,4,2,6,0,0,12
M2S1-03-08,M2S1,중2-1,3,다항식의 계산,8,다항식과 단항식의 곱셈과 나눗셈,빈 칸안에 알맞은 식 구하기,0,0,8,1,0,9,0,0,6,0,0,6
M2S1-03-09,M2S1,중2-1,3,다항식의 계산,9,사칙계산이 혼합된 식,,0,2,9,1,1,13,1,3,9,0,1,14
M2S1-03-10,M2S1,중2-1,3,다항식의 계산,10,도형에서의 활용 (1),넓이 또는 부피 구하기,2,1,9,1,0,13,1,2,6,1,1,11
M2S1-03-11,M2S1,중2-1,3,다항식의 계산,11,도형에서의 활용 (2),길이 구하기,0,0,10,1,0,11,1,0,7,0,1,9
M2S1-03-12,M2S1,중2-1,3,다항식의 계산,12,식의 값,,0,0,14,2,1,17,1,1,7,0,2,11
M2S1-03-13,M2S1,중2-1,3,다항식의 계산,13,식의 대입,,0,4,8,2,0,14,1,1,5,0,1,8
M2S1-03-14,M2S1,중2-1,3,다항식의 계산,14,변형한 식 대입하기,,0,3,12,2,0,17,0,0,3,0,2,5
M2S1-03-15,M2S1,중2-1,3,다항식의 계산,15,등식을 변형하여 식 계산하기,,0,0,6,5,2,13,0,0,3,0,2,5
M2S1-04-01,M2S1,중2-1,4,일차부등식,1,부등식,,1,3,8,0,0,12,6,0,0,0,0,6
M2S1-04-02,M2S1,중2-1,4,일차부등식,2,부등식으로 나타내기,,0,7,4,0,0,11,4,0,4,0,0,8
M2S1-04-03,M2S1,중2-1,4,일차부등식,3,부등식의 해,,0,0,16,0,0,16,7,2,4,0,0,13
M2S1-04-04,M2S1,중2-1,4,일차부등식,4,부등식의 성질,,0,0,9,5,0,14,1,2,11,0,2,16
M2S1-04-05,M2S1,중2-1,4,일차부등식,5,부등식의 성질을 이용한 식의 값 범위,,0,0,10,0,0,10,2,0,11,1,1,15
M2S1-04-06,M2S1,중2-1,4,일차부등식,6,일차부등식,,0,0,12,2,0,14,2,4,3,0,1,10
M2S1-04-07,M2S1,중2-1,4,일차부등식,7,일차부등식의 풀이,,0,1,9,0,0,10,5,3,5,0,0,13
M2S1-04-08,M2S1,중2-1,4,일차부등식,8,부등식의 해와 수직선,,0,6,12,0,0,18,4,1,2,0,0,7
M2S1-04-09,M2S1,중2-1,4,일차부등식,9,괄호가 있는 일차부등식,,0,3,10,0,0,13,3,2,11,0,0,16
M2S1-04-10,M2S1,중2-1,4,일차부등식,10,계수가 소수 또는 분수인 일차부등식,,0,0,14,0,0,14,0,0,16,0,0,16
M2S1-04-11,M2S1,중2-1,4,일차부등식,11,x의 계수가 문자인 일차부등식,,0,0,6,4,0,10,0,0,10,1,2,13
M2S1-04-12,M2S1,중2-1,4,일차부등식,12,부등식의 해가 주어졌을 때 미지수 구하기,,0,0,7,6,0,13,0,0,14,0,1,15
M2S1-04-13,M2S1,중2-1,4,일차부등식,13,해가 같은 두 일차부등식,,0,0,7,3,0,10,0,0,8,0,0,8
M2S1-04-14,M2S1,중2-1,4,일차부등식,14,부등식의 해의 조건이 주어졌을 때,,0,0,4,7,0,11,0,0,4,5,2,11
M2S1-04-15,M2S1,중2-1,4,일차부등식,15,부등식의 해가 존재하지 않을 때,,0,4,5,0,2,11,0,0,0,2,2,4
M2S1-05-01,M2S1,중2-1,5,일차부등식의 활용,1,수와 일차부등식의 활용,,0,4,7,1,0,12,0,3,10,0,0,13
M2S1-05-02,M2S1,중2-1,5,일차부등식의 활용,2,예금액과 일차부등식의 활용,,0,3,6,1,0,10,1,3,3,0,0,7
M2S1-05-03,M2S1,중2-1,5,일차부등식의 활용,3,평균과 일차부등식의 활용,,0,3,7,1,0,11,1,3,4,0,1,9
M2S1-05-04,M2S1,중2-1,5,일차부등식의 활용,4,최대 개수와 일차부등식의 활용,,0,1,11,0,1,13,0,4,15,0,0,19
M2S1-05-05,M2S1,중2-1,5,일차부등식의 활용,5,추가 요금과 일차부등식의 활용,,0,1,6,4,1,12,0,0,8,0,1,9
M2S1-05-06,M2S1,중2-1,5,일차부등식의 활용,6,유리한 방법을 선택하는 문제에서 일차부등식의 활용,,0,1,18,3,0,22,0,1,15,0,1,17
M2S1-05-07,M2S1,중2-1,5,일차부등식의 활용,7,"정가, 원가와 일차부등식의 활용",,0,0,10,1,0,11,0,0,7,2,1,10
M2S1-05-08,M2S1,중2-1,5,일차부등식의 활용,8,도형에 대한 일차부등식의 활용,,0,1,7,1,0,9,1,3,7,0,1,12
M2S1-05-09,M2S1,중2-1,5,일차부등식의 활용,9,"거리, 속력, 시간과 일차부등식의 활용 (1)",중간에 속력이 바뀌는 경우,0,0,10,0,0,10,0,0,8,0,0,8
M2S1-05-10,M2S1,중2-1,5,일차부등식의 활용,10,"거리, 속력, 시간과 일차부등식의 활용 (2)",왕복하는 경우,0,0,6,10,2,18,0,0,8,1,0,9
M2S1-05-11,M2S1,중2-1,5,일차부등식의 활용,11,"거리, 속력, 시간과 일차부등식의 활용 (3)",반대방향으로 출발하는 경우,0,2,8,0,0,10,0,0,4,0,1,5
M2S1-05-12,M2S1,중2-1,5,일차부등식의 활용,12,농도와 일차부등식의 활용 (1),추가 또는 증발시키는 경우,0,2,8,0,0,10,0,0,5,2,2,9
M2S1-05-13,M2S1,중2-1,5,일차부등식의 활용,13,농도와 일차부등식의 활용 (2),두 소금물을 섞는 경우,0,1,9,0,0,10,0,0,8,0,0,8
M2S1-06-01,M2S1,중2-1,6,연립일차방정식,1,미지수가 2개인 일차방정식,,0,0,8,2,1,11,6,0,6,0,0,12
M2S1-06-02,M2S1,중2-1,6,연립일차방정식,2,미지수가 2개인 일차방정식의 해,,0,0,10,4,0,14,5,3,5,0,0,13
M2S1-06-03,M2S1,중2-1,6,연립일차방정식,3,일차방정식의 해 또는 계수가 문자인 경우,,0,0,12,1,0,13,5,0,7,0,0,12
M2S1-06-04,M2S1,중2-1,6,연립일차방정식,4,연립방정식과 해,,0,5,8,1,0,14,3,5,3,0,1,12
M2S1-06-05,M2S1,중2-1,6,연립일차방정식,5,연립방정식의 해 또는 계수가 문자인 경우,,0,0,21,0,0,21,0,0,12,0,1,13
M2S1-06-06,M2S1,중2-1,6,연립일차방정식,6,대입법을 이용한 연립방정식의 풀이,,0,4,4,2,0,10,3,8,5,0,0,16
M2S1-06-07,M2S1,중2-1,6,연립일차방정식,7,가감법을 이용한 연립방정식의 풀이,,0,4,8,3,0,15,3,8,4,0,1,16
M2S1-06-08,M2S1,중2-1,6,연립일차방정식,8,괄호가 있는 연립방정식,,0,0,10,0,0,10,0,5,8,0,0,13
M2S1-06-09,M2S1,중2-1,6,연립일차방정식,9,계수가 분수 또는 소수인 연립방정식,,0,0,9,8,0,17,2,8,13,1,2,26
M2S1-06-10,M2S1,중2-1,6,연립일차방정식,10,비례식이 포함된 연립방정식,,0,2,7,1,1,11,0,4,1,1,1,7
M2S1-06-11,M2S1,중2-1,6,연립일차방정식,11,A=B=C 형태의 방정식,,0,0,10,1,0,11,1,6,8,0,1,16
M2S1-06-12,M2S1,중2-1,6,연립일차방정식,12,연립방정식의 해가 주어진 경우 미지수 구하기,,0,2,8,1,0,11,2,0,9,0,0,11
M2S1-06-13,M2S1,중2-1,6,연립일차방정식,13,연립방정식의 해가 일차방정식을 만족하는 경우,,0,0,12,1,1,14,0,0,9,0,2,11
M2S1-06-14,M2S1,중2-1,6,연립일차방정식,14,해에 대한 조건이 주어진 경우,,0,0,2,9,0,11,0,3,6,2,0,11
M2S1-06-15,M2S1,중2-1,6,연립일차방정식,15,두 연립방정식의 해가 서로 같을 경우,,0,0,5,5,1,11,0,0,8,0,1,9
M2S1-06-16,M2S1,중2-1,6,연립일차방정식,16,계수 또는 상수항을 잘못 보고 구한 해,,0,1,4,3,2,10,0,0,10,1,0,11
M2S1-06-17,M2S1,중2-1,6,연립일차방정식,17,해가 무수히 많을 경우,,0,2,10,2,0,14,1,7,2,0,1,11
M2S1-06-18,M2S1,중2-1,6,연립일차방정식,18,해가 없을 경우,,0,1,11,0,1,13,0,5,6,0,1,12
M2S1-06-19,M2S1,중2-1,6,연립일차방정식,19,분모에 문자가 있는 연립방정식,,0,4,3,2,1,10,0,0,1,1,1,3
M2S1-07-01,M2S1,중2-1,7,연립일차방정식의 활용,1,수와 연립방정식의 활용,,0,1,7,0,0,8,1,3,3,0,1,8
M2S1-07-02,M2S1,중2-1,7,연립일차방정식의 활용,2,자연수와 연립방정식의 활용,,0,0,9,1,1,11,0,0,8,0,1,9
M2S1-07-03,M2S1,중2-1,7,연립일차방정식의 활용,3,평균과 연립방정식의 활용,,0,3,3,0,1,7,1,1,4,0,1,7
M2S1-07-04,M2S1,중2-1,7,연립일차방정식의 활용,4,"가격, 개수와 연립방정식의 활용",,0,2,10,1,1,14,1,9,9,0,3,22
M2S1-07-05,M2S1,중2-1,7,연립일차방정식의 활용,5,나이와 연립방정식의 활용,,0,0,9,0,0,9,1,2,2,0,1,6
M2S1-07-06,M2S1,중2-1,7,연립일차방정식의 활용,6,비율과 연립방정식의 활용,,0,0,9,1,0,10,0,1,4,1,2,8
M2S1-07-07,M2S1,중2-1,7,연립일차방정식의 활용,7,도형과 연립방정식의 활용,,0,1,9,1,0,11,0,2,9,1,0,12
M2S1-07-08,M2S1,중2-1,7,연립일차방정식의 활용,8,"득점, 감점과 연립방정식의 활용",,0,1,10,2,0,13,0,0,13,0,0,13
M2S1-07-09,M2S1,중2-1,7,연립일차방정식의 활용,9,"증가, 감소와 연립방정식의 활용",,0,0,14,0,0,14,0,0,3,5,2,10
M2S1-07-10,M2S1,중2-1,7,연립일차방정식의 활용,10,"이익, 할인과 연립방정식의 활용",,0,1,8,1,0,10,1,0,5,2,2,10
M2S1-07-11,M2S1,중2-1,7,연립일차방정식의 활용,11,일과 연립방정식의 활용,,0,0,9,3,0,12,0,0,11,0,0,11
M2S1-07-12,M2S1,중2-1,7,연립일차방정식의 활용,12,"거리, 속력, 시간과 연립방정식의 활용 (1)",중간에 속력이 바뀌는 경우,0,1,10,3,1,15,0,1,6,0,1,8
M2S1-07-13,M2S1,중2-1,7,연립일차방정식의 활용,13,"거리, 속력, 시간과 연립방정식의 활용 (2)",왕복하는 경우,0,0,9,0,1,10,0,0,4,1,1,6
M2S1-07-14,M2S1,중2-1,7,연립일차방정식의 활용,14,"거리, 속력, 시간과 연립방정식의 활용 (3)",마주보고 출발하는 경우,0,2,7,1,1,11,0,0,5,0,1,6
M2S1-07-15,M2S1,중2-1,7,연립일차방정식의 활용,15,"거리, 속력, 시간과 연립방정식의 활용 (4)",같은 방향으로 출발하는 경우,0,3,7,0,0,10,0,0,5,0,1,6
M2S1-07-16,M2S1,중2-1,7,연립일차방정식의 활용,16,"거리, 속력, 시간과 연립방정식의 활용 (5)",트랙을 도는 경우,0,0,2,8,1,11,0,0,1,4,1,6
M2S1-07-17,M2S1,중2-1,7,연립일차방정식의 활용,17,"거리, 속력, 시간과 연립방정식의 활용 (6)",배 또는 강물의 속력,0,0,10,0,0,10,0,0,4,1,1,6
M2S1-07-18,M2S1,중2-1,7,연립일차방정식의 활용,18,"거리, 속력, 시간과 연립방정식의 활용 (7)",터널을 지나는 기차,0,0,5,3,1,9,0,0,2,2,3,7
M2S1-07-19,M2S1,중2-1,7,연립일차방정식의 활용,19,농도와 연립방정식의 활용 (1),추가 또는 증발시키는 경우,0,0,8,1,0,9,0,0,2,0,0,2
M2S1-07-20,M2S1,중2-1,7,연립일차방정식의 활용,20,농도와 연립방정식의 활용 (2),두 소금물을 섞는 경우,0,0,4,5,1,10,0,0,11,3,3,17
M2S1-07-21,M2S1,중2-1,7,연립일차방정식의 활용,21,"합금, 식품과 연립방정식의 활용",,0,0,12,2,1,15,0,0,5,2,2,9
M2S1-08-01,M2S1,중2-1,8,일차함수와 그래프,1,함수,,0,0,10,0,1,11,0,0,7,0,1,8
M2S1-08-02,M2S1,중2-1,8,일차함수와 그래프,2,함숫값,,0,2,8,0,0,10,3,3,7,0,2,15
M2S1-08-03,M2S1,중2-1,8,일차함수와 그래프,3,일차함수,,0,2,11,0,0,13,5,0,4,0,0,9
M2S1-08-04,M2S1,중2-1,8,일차함수와 그래프,4,일차함수를 만족하는 조건,,0,1,7,0,2,10,0,0,4,0,0,4
M2S1-08-05,M2S1,중2-1,8,일차함수와 그래프,5,일차함수의 값,,0,4,12,1,0,17,1,4,4,0,0,9
M2S1-08-06,M2S1,중2-1,8,일차함수와 그래프,6,일차함수의 그래프 위의 점,,0,7,8,0,0,15,4,1,8,0,1,14
M2S1-08-07,M2S1,중2-1,8,일차함수와 그래프,7,일차함수의 그래프의 평행이동,,4,4,20,0,0,28,2,4,12,0,1,19
M2S1-08-08,M2S1,중2-1,8,일차함수와 그래프,8,일차함수의 그래프의 x절편과 y절편,,0,2,11,2,0,15,3,6,12,0,1,22
M2S1-08-09,M2S1,중2-1,8,일차함수와 그래프,9,일차함수의 그래프의 기울기,,1,4,9,0,0,14,5,4,7,0,0,16
M2S1-08-10,M2S1,중2-1,8,일차함수와 그래프,10,두 점을 지나는 일차함수 그래프의 기울기,,0,6,6,1,0,13,4,5,7,0,1,17
M2S1-08-11,M2S1,중2-1,8,일차함수와 그래프,11,세 점이 한 직선 위에 있을 조건,,0,2,6,5,0,13,0,0,6,0,1,7
M2S1-08-12,M2S1,중2-1,8,일차함수와 그래프,12,일차함수의 그래프,,1,4,5,0,0,10,5,0,4,0,1,10
M2S1-08-13,M2S1,중2-1,8,일차함수와 그래프,13,좌표축과 일차함수의 그래프로 둘러싸인 도형의 넓이,,0,0,5,5,2,12,0,1,12,3,3,19
M2S1-09-01,M2S1,중2-1,9,일차함수와 그래프의 성질과  활용,1,"a, b 의 부호에 따른 y=ax+b 그래프",,0,2,3,6,1,12,0,6,9,1,5,21
M2S1-09-02,M2S1,중2-1,9,일차함수와 그래프의 성질과  활용,2,두 일차함수 그래프가 평행한 경우,,0,2,9,2,0,13,2,5,8,1,1,17
M2S1-09-03,M2S1,중2-1,9,일차함수와 그래프의 성질과  활용,3,두 일차함수 그래프가 일치하는 경우,,0,0,11,1,0,12,1,1,8,0,0,10
M2S1-09-04,M2S1,중2-1,9,일차함수와 그래프의 성질과  활용,4,y=ax+b 그래프와 성질,,0,2,13,2,0,17,2,3,15,0,1,21
M2S1-09-05,M2S1,중2-1,9,일차함수와 그래프의 성질과  활용,5,일차함수의 식 계산 (1),기울기와 y절편이 주어진 경우,0,3,8,1,0,12,1,3,7,0,0,11
M2S1-09-06,M2S1,중2-1,9,일차함수와 그래프의 성질과  활용,6,일차함수의 식 계산 (2),기울기와 한 점의 좌표가 주어진 경우,0,2,7,4,0,13,0,0,11,0,0,11
M2S1-09-07,M2S1,중2-1,9,일차함수와 그래프의 성질과  활용,7,일차함수의 식 계산 (3),두 점의 좌표가 주어진 경우,1,6,3,4,0,14,0,4,8,0,0,12
M2S1-09-08,M2S1,중2-1,9,일차함수와 그래프의 성질과  활용,8,일차함수의 식 계산 (4),"x절편, y절편이 주어진 경우",0,4,7,0,0,11,0,5,5,0,1,11
M2S1-09-09,M2S1,중2-1,9,일차함수와 그래프의 성질과  활용,9,일차함수의 활용 (1),온도,1,4,11,0,0,16,0,0,5,0,1,6
M2S1-09-10,M2S1,중2-1,9,일차함수와 그래프의 성질과  활용,10,일차함수의 활용 (2),길이,0,2,9,0,0,11,0,1,3,0,0,4
M2S1-09-11,M2S1,중2-1,9,일차함수와 그래프의 성질과  활용,11,일차함수의 활용 (3),물의 양,0,6,6,0,1,13,0,0,5,0,0,5
M2S1-09-12,M2S1,중2-1,9,일차함수와 그래프의 성질과  활용,12,일차함수의 활용 (4),규칙,0,1,4,4,2,11,0,0,1,0,0,1
M2S1-09-13,M2S1,중2-1,9,일차함수와 그래프의 성질과  활용,13,일차함수의 활용 (5),속력,0,1,5,4,0,10,0,1,2,2,1,6
M2S1-09-14,M2S1,중2-1,9,일차함수와 그래프의 성질과  활용,14,일차함수의 활용 (6),도형,0,1,7,3,0,11,0,0,4,1,1,6
M2S1-09-15,M2S1,중2-1,9,일차함수와 그래프의 성질과  활용,15,여러 가지 일차함수의 활용,,0,1,9,0,0,10,1,0,1,0,2,4
M2S1-09-16,M2S1,중2-1,9,일차함수와 그래프의 성질과  활용,16,그래프와 일차함수의 활용,,0,1,8,3,0,12,0,0,5,0,0,5
M2S1-10-01,M2S1,중2-1,10,일차함수와 일차방정식,1,일차함수와 일차방정식,,0,3,9,0,0,12,2,6,9,0,0,17
M2S1-10-02,M2S1,중2-1,10,일차함수와 일차방정식,2,일차방정식의 그래프 위의 점,,0,1,8,1,0,10,3,4,8,0,0,15
M2S1-10-03,M2S1,중2-1,10,일차함수와 일차방정식,3,직선의 방정식 ,,0,2,11,0,0,13,0,1,2,0,1,4
M2S1-10-04,M2S1,중2-1,10,일차함수와 일차방정식,4,좌표축과 평행한 직선의 방정식,,0,4,10,1,0,15,1,9,7,0,1,18
M2S1-10-05,M2S1,중2-1,10,일차함수와 일차방정식,5,좌표축에 평행한 네 직선으로 둘러싸인 도형의 넓이,,0,0,7,3,0,10,0,0,6,0,1,7
M2S1-10-06,M2S1,중2-1,10,일차함수와 일차방정식,6,"a, b, c 의 부호와 일차방정식 ax+by+c=0 그래프",,0,0,6,4,0,10,0,0,7,1,4,12
M2S1-10-07,M2S1,중2-1,10,일차함수와 일차방정식,7,연립일차방정식의 해와 그래프,,0,3,9,3,0,15,0,4,4,0,2,10
M2S1-10-08,M2S1,중2-1,10,일차함수와 일차방정식,8,두 직선의 교점의 좌표를 이용한 미지수 계산,,0,2,5,4,0,11,1,2,8,0,1,12
M2S1-10-09,M2S1,중2-1,10,일차함수와 일차방정식,9,두 직선의 교점을 지나는 직선의 방정식,,0,0,10,1,0,11,0,0,13,0,0,13
M2S1-10-10,M2S1,중2-1,10,일차함수와 일차방정식,10,세 직선이 한 점에서 만날 때,,0,0,8,1,3,12,0,0,6,1,1,8
M2S1-10-11,M2S1,중2-1,10,일차함수와 일차방정식,11,연립방정식의 해의 개수와 직선의 위치 관계,,0,0,9,2,1,12,2,8,1,0,0,11
M2S1-10-12,M2S1,중2-1,10,일차함수와 일차방정식,12,직선으로 둘러싸인 도형의 넓이,,0,0,13,3,3,19,1,1,11,1,3,17
M2S1-10-13,M2S1,중2-1,10,일차함수와 일차방정식,13,직선과 선분이 만나는 조건,,0,0,4,8,2,14,0,0,2,3,1,6
M2S1-10-14,M2S1,중2-1,10,일차함수와 일차방정식,14,도형의 넓이를 이등분하는 직선의 방정식,,0,0,5,7,0,12,0,0,1,6,1,8
M2S1-10-15,M2S1,중2-1,10,일차함수와 일차방정식,15,직선의 방정식의 활용,,0,1,6,6,0,13,0,0,0,3,0,3
M3S1-01-01,M3S1,중3-1,1,제곱근의 뜻과 성질,1,제곱근의 뜻과 표현,,1,0,3,9,0,13,52,8,14,0,0,74
M3S1-01-02,M3S1,중3-1,1,제곱근의 뜻과 성질,2,근호 없이 제곱근 표현하기,,1,0,9,0,0,10,10,0,5,0,0,15
M3S1-01-03,M3S1,중3-1,1,제곱근의 뜻과 성질,3,제곱근의 성질,,0,0,10,0,0,10,18,4,10,0,0,32
M3S1-01-04,M3S1,중3-1,1,제곱근의 뜻과 성질,4,제곱근의 성질을 이용해 계산하기,,0,6,15,1,0,22,4,13,10,1,0,28
M3S1-01-05,M3S1,중3-1,1,제곱근의 뜻과 성질,5,근호를 포함한 문자식 간단히 하기,,0,0,4,11,1,16,20,12,19,1,7,59
M3S1-01-06,M3S1,중3-1,1,제곱근의 뜻과 성질,6,주어진 식이 자연수가 되도록 하는 자연수 x 의 값 구하기 (1),√(Ax) 또는 √(Axy) 가 포함된 식,0,0,8,8,1,17,1,0,7,2,4,14
M3S1-01-07,M3S1,중3-1,1,제곱근의 뜻과 성질,7,주어진 식이 자연수가 되도록 하는 자연수 x 의 값 구하기 (2),√(A/x)가 포함된 식,0,0,3,5,3,11,0,0,5,1,2,8
M3S1-01-08,M3S1,중3-1,1,제곱근의 뜻과 성질,8,주어진 식이 자연수가 되도록 하는 자연수 x 의 값 구하기 (3),√(A+x) 또는 √(A-x) 가 포함된 식,0,0,7,4,1,12,2,0,9,2,1,14
M3S1-01-09,M3S1,중3-1,1,제곱근의 뜻과 성질,9,제곱근의 대소 관계,,0,0,8,1,3,12,14,2,7,0,1,24
M3S1-01-10,M3S1,중3-1,1,제곱근의 뜻과 성질,10,제곱근이 포함된 부등식,,0,2,7,1,1,11,1,6,9,2,1,19
M3S1-02-01,M3S1,중3-1,2,무리수와 실수,1,유리수와 무리수의 구분,,1,6,15,0,0,22,26,1,7,0,2,36
M3S1-02-02,M3S1,중3-1,2,무리수와 실수,2,무리수의 이해,,0,2,9,0,0,11,2,0,2,0,0,4
M3S1-02-03,M3S1,중3-1,2,무리수와 실수,3,실수의 분류,,0,2,9,0,0,11,1,1,1,0,0,3
M3S1-02-04,M3S1,중3-1,2,무리수와 실수,4,제곱근을 이용한 정사각형 한 변 길이 계산,,0,0,8,6,2,16,0,0,2,1,1,4
M3S1-02-05,M3S1,중3-1,2,무리수와 실수,5,수직선 위의 무리수,,0,2,8,2,2,14,11,0,11,1,4,27
M3S1-02-06,M3S1,중3-1,2,무리수와 실수,6,실수와 수직선,,0,0,10,2,0,12,12,3,15,0,2,32
M3S1-02-07,M3S1,중3-1,2,무리수와 실수,7,√x 보다 작은 자연수,,0,1,1,8,3,13,1,1,2,0,1,5
M3S1-02-08,M3S1,중3-1,2,무리수와 실수,8,실수의 대소 관계,,0,2,12,8,3,25,13,0,22,0,2,37
M3S1-03-01,M3S1,중3-1,3,제곱근의 곱셈과 나눗셈,1,제곱근의 곱셈과 나눗셈,,0,3,28,3,0,34,28,5,18,0,3,54
M3S1-03-02,M3S1,중3-1,3,제곱근의 곱셈과 나눗셈,2,근호를 포함한 식 변형하기,,0,1,6,2,1,10,27,1,15,0,3,46
M3S1-03-03,M3S1,중3-1,3,제곱근의 곱셈과 나눗셈,3,분모의 유리화,,0,11,12,2,0,25,25,0,9,0,0,34
M3S1-03-04,M3S1,중3-1,3,제곱근의 곱셈과 나눗셈,4,제곱근표와 값을 이용한 계산,,0,4,10,5,0,19,6,0,3,0,1,10
M3S1-03-05,M3S1,중3-1,3,제곱근의 곱셈과 나눗셈,5,제곱근표에 없는 수의 제곱근의 값 구하기,,0,1,20,1,1,23,9,1,0,0,0,10
M3S1-03-06,M3S1,중3-1,3,제곱근의 곱셈과 나눗셈,6,문자를 이용하여 제곱근 표현하기,,0,1,8,2,0,11,0,0,9,0,1,10
M3S1-03-07,M3S1,중3-1,3,제곱근의 곱셈과 나눗셈,7,제곱근의 곱셈과 나눗셈의 도형에서의 활용,,0,0,12,2,0,14,0,0,7,0,3,10
M3S1-04-01,M3S1,중3-1,4,제곱근의 덧셈과 뺄셈,1,제곱근의 덧셈과 뺄셈,,0,14,15,6,3,38,18,0,16,2,4,40
M3S1-04-02,M3S1,중3-1,4,제곱근의 덧셈과 뺄셈,2,분배법칙을 이용하여 무리수 계산하기,,0,7,2,1,0,10,12,1,6,0,0,19
M3S1-04-03,M3S1,중3-1,4,제곱근의 덧셈과 뺄셈,3,분배법칙을 이용하여 분모 유리화하기,,0,0,7,3,0,10,9,1,4,0,1,15
M3S1-04-04,M3S1,중3-1,4,제곱근의 덧셈과 뺄셈,4,곱셈공식을 이용하여 무리수 계산하기,,0,8,4,0,0,12,23,0,9,2,1,35
M3S1-04-05,M3S1,중3-1,4,제곱근의 덧셈과 뺄셈,5,곱셈공식을 이용하여 분모 유리화하기,,1,0,7,6,1,15,14,4,7,1,0,26
M3S1-04-06,M3S1,중3-1,4,제곱근의 덧셈과 뺄셈,6,식의 값 계산 (1),두 개의 수가 주어진 경우,0,0,26,10,4,40,0,1,10,3,3,17
M3S1-04-07,M3S1,중3-1,4,제곱근의 덧셈과 뺄셈,7,식의 값 계산 (2),한 개의 수가 주어진 경우,0,0,12,5,1,18,2,0,7,0,1,10
M3S1-04-08,M3S1,중3-1,4,제곱근의 덧셈과 뺄셈,8,근호가 포함된 식의 혼합계산,,0,9,16,0,0,25,1,0,6,1,2,10
M3S1-04-09,M3S1,중3-1,4,제곱근의 덧셈과 뺄셈,9,근호가 포함된 식의 값이 유리수가 되도록 하는 조건,,0,2,4,1,3,10,0,0,8,1,2,11
M3S1-04-10,M3S1,중3-1,4,제곱근의 덧셈과 뺄셈,10,값이 주어진 제곱근의 계산,,0,0,10,3,1,14,0,0,8,0,2,10
M3S1-04-11,M3S1,중3-1,4,제곱근의 덧셈과 뺄셈,11,제곱근의 덧셈과 뺄셈과 도형,,0,0,8,3,1,12,0,0,7,2,1,10
M3S1-04-12,M3S1,중3-1,4,제곱근의 덧셈과 뺄셈,12,제곱근의 덧셈과 뺄셈과 수직선,,0,2,9,3,1,15,0,0,4,0,2,6
M3S1-04-13,M3S1,중3-1,4,제곱근의 덧셈과 뺄셈,13,무리수의 정수부분과 소수부분,,0,0,7,7,1,15,3,1,6,1,2,13
M3S1-05-01,M3S1,중3-1,5,다항식의 인수분해,1,인수와 인수분해,,0,0,15,0,0,15,5,0,1,0,0,6
M3S1-05-02,M3S1,중3-1,5,다항식의 인수분해,2,공통인수를 이용하여 인수분해하기,,0,0,10,2,1,13,12,6,3,0,1,22
M3S1-05-03,M3S1,중3-1,5,다항식의 인수분해,3,a²−b² 형태의 인수분해,,0,0,8,3,1,12,24,1,4,1,1,31
M3S1-05-04,M3S1,중3-1,5,다항식의 인수분해,4,a²±2ab+b² 형태의 인수분해,,0,0,3,7,0,10,15,3,4,0,1,23
M3S1-05-05,M3S1,중3-1,5,다항식의 인수분해,5,완전제곱식 계산,,0,1,8,5,0,14,13,1,5,0,1,20
M3S1-05-06,M3S1,중3-1,5,다항식의 인수분해,6,완전제곱식을 이용한 인수분해,,0,0,7,3,0,10,0,3,6,0,2,11
M3S1-05-07,M3S1,중3-1,5,다항식의 인수분해,7,x²+(a+b)x+ab 형태의 인수분해,,0,0,5,7,0,12,26,0,6,1,2,35
M3S1-05-08,M3S1,중3-1,5,다항식의 인수분해,8,acx²+(ad+bc)x+bd 형태의 인수분해,,1,6,7,0,0,14,20,0,9,0,0,29
M3S1-05-09,M3S1,중3-1,5,다항식의 인수분해,9,인수를 이용한 이차식의 미지수 값 계산,,1,5,4,1,1,12,4,0,3,0,2,9
M3S1-05-10,M3S1,중3-1,5,다항식의 인수분해,10,계수 또는 상수항을 잘못보고 인수분해한 경우,,0,0,11,0,0,11,0,0,0,3,3,6
M3S1-05-11,M3S1,중3-1,5,다항식의 인수분해,11,인수분해 공식과 도형,,0,2,7,2,0,11,0,0,5,0,1,6
M3S1-06-01,M3S1,중3-1,6,인수분해 공식의 활용,1,공통부분을 묶어서 인수분해 하기,,0,0,6,4,0,10,4,1,7,0,0,12
M3S1-06-02,M3S1,중3-1,6,인수분해 공식의 활용,2,치환을 이용한 인수분해,,0,2,25,4,0,31,4,0,15,2,7,28
M3S1-06-03,M3S1,중3-1,6,인수분해 공식의 활용,3,( )( )( )( )+k 형태의 인수분해,,0,0,7,3,0,10,0,0,4,3,2,9
M3S1-06-04,M3S1,중3-1,6,인수분해 공식의 활용,4,여러 항이 있을 때 항끼리 묶어 인수분해하기 (1),두 항씩 묶어서 인수분해하기,0,0,18,2,2,22,3,10,2,0,3,18
M3S1-06-05,M3S1,중3-1,6,인수분해 공식의 활용,5,여러 항이 있을 때 항끼리 묶어 인수분해하기 (2),( )²−( )² 형태 인수분해하기,0,0,11,0,0,11,0,7,7,0,2,16
M3S1-06-06,M3S1,중3-1,6,인수분해 공식의 활용,6,내림차순으로 정리한 후 인수분해하기,,0,0,11,2,0,13,0,0,4,1,4,9
M3S1-06-07,M3S1,중3-1,6,인수분해 공식의 활용,7,인수분해 공식을 이용한 수의 계산,,0,2,13,3,1,19,20,1,6,2,1,30
M3S1-06-08,M3S1,중3-1,6,인수분해 공식의 활용,8,인수분해 공식을 이용한 식의 계산,,0,2,8,5,2,17,14,3,7,3,4,31
M3S1-06-09,M3S1,중3-1,6,인수분해 공식의 활용,9,인수분해의 도형에서의 활용,,0,3,7,5,0,15,0,1,8,0,4,13
M3S1-07-01,M3S1,중3-1,7,이차방정식의 풀이,1,이차방정식의 뜻,,0,7,9,0,0,16,4,0,4,0,0,8
M3S1-07-02,M3S1,중3-1,7,이차방정식의 풀이,2,이차방정식의 해,,0,9,2,0,0,11,18,1,2,0,0,21
M3S1-07-03,M3S1,중3-1,7,이차방정식의 풀이,3,AB=0 을 이용하여 이차방정식 풀기,,2,6,6,1,0,15,3,0,2,0,0,5
M3S1-07-04,M3S1,중3-1,7,이차방정식의 풀이,4,인수분해를 이용하여 이차방정식 풀기,,0,0,7,4,1,12,25,3,8,0,1,37
M3S1-07-05,M3S1,중3-1,7,이차방정식의 풀이,5,중근을 가지는 이차방정식,,0,0,8,4,0,12,23,5,6,2,3,39
M3S1-07-06,M3S1,중3-1,7,이차방정식의 풀이,6,한 근이 주어졌을 때의 미지수 계산,,0,0,9,6,0,15,0,3,11,1,1,16
M3S1-07-07,M3S1,중3-1,7,이차방정식의 풀이,7,한 근이 주어졌을 때의 식 계산,,0,1,3,3,4,11,1,3,2,2,2,10
M3S1-07-08,M3S1,중3-1,7,이차방정식의 풀이,8,공통 근을 가지는 두 이차방정식,,0,0,7,2,1,10,0,2,10,0,3,15
M3S1-07-09,M3S1,중3-1,7,이차방정식의 풀이,9,제곱근을 이용한 이차방정식의 풀이,,0,0,14,2,4,20,25,3,5,0,1,34
M3S1-07-10,M3S1,중3-1,7,이차방정식의 풀이,10,(x+p)²=q 형태의 이차방정식의 근의 조건,,0,2,8,0,0,10,1,0,2,0,0,3
M3S1-07-11,M3S1,중3-1,7,이차방정식의 풀이,11,완전제곱식 형태로 바꾸기,,0,0,9,4,0,13,1,0,7,0,0,8
M3S1-07-12,M3S1,중3-1,7,이차방정식의 풀이,12,완전제곱식을 이용하여 이차방정식 풀기,,0,4,6,0,3,13,15,1,7,0,1,24
M3S1-08-01,M3S1,중3-1,8,이차방정식의 근의 공식,1,이차방정식의 근의 공식,,0,1,26,3,0,30,13,4,6,1,1,25
M3S1-08-02,M3S1,중3-1,8,이차방정식의 근의 공식,2,계수에 소수 또는 분수가 있는 이차방정식의 계산,,0,0,13,0,0,13,8,3,9,1,2,23
M3S1-08-03,M3S1,중3-1,8,이차방정식의 근의 공식,3,치환을 이용한 이차방정식의 계산,,0,0,10,1,1,12,4,2,4,1,3,14
M3S1-08-04,M3S1,중3-1,8,이차방정식의 근의 공식,4,이차방정식의 근의 판별,,0,4,4,2,0,10,2,3,4,0,0,9
M3S1-08-05,M3S1,중3-1,8,이차방정식의 근의 공식,5,이차방정식이 중근을 가지도록 하는 조건,,0,0,23,7,1,31,0,2,9,1,1,13
M3S1-08-06,M3S1,중3-1,8,이차방정식의 근의 공식,6,근의 개수를 이용한 값의 범위 계산,,0,0,12,0,0,12,0,0,4,0,1,5
M3S1-08-07,M3S1,중3-1,8,이차방정식의 근의 공식,7,근과 계수의 관계,,0,0,10,1,2,13,5,0,4,0,1,10
M3S1-08-08,M3S1,중3-1,8,이차방정식의 근의 공식,8,근과 계수의 관계의 활용,,0,3,16,11,2,32,2,1,21,3,6,33
M3S1-08-09,M3S1,중3-1,8,이차방정식의 근의 공식,9,두 근의 차 또는 비를 이용한 미지수 값 계산,,0,0,13,1,0,14,0,0,5,2,2,9
M3S1-08-10,M3S1,중3-1,8,이차방정식의 근의 공식,10,한 근이 무리수일 때 미지수 값 계산,,0,1,8,1,0,10,0,3,3,0,2,8
M3S1-08-11,M3S1,중3-1,8,이차방정식의 근의 공식,11,잘못 보고 푼 이차방정식,,0,0,12,1,0,13,0,0,1,1,0,2
M3S1-09-01,M3S1,중3-1,9,이차방정식의 활용,1,식이 주어졌을 때의 이차방정식의 활용,,0,0,6,2,2,10,0,0,9,0,2,11
M3S1-09-02,M3S1,중3-1,9,이차방정식의 활용,2,새로운 기호에 대한 이차방정식의 활용,,0,0,8,2,0,10,0,0,2,0,1,3
M3S1-09-03,M3S1,중3-1,9,이차방정식의 활용,3,수에 대한 이차방정식의 활용,,0,1,17,0,0,18,0,1,5,0,0,6
M3S1-09-04,M3S1,중3-1,9,이차방정식의 활용,4,연속되는 수에 대한 이차방정식의 활용,,0,0,12,0,0,12,0,0,9,0,0,9
M3S1-09-05,M3S1,중3-1,9,이차방정식의 활용,5,실생활에서의 이차방정식의 활용,,0,0,10,5,0,15,0,0,7,0,2,9
M3S1-09-06,M3S1,중3-1,9,이차방정식의 활용,6,쏘아올린 물체에 대한 이차방정식의 활용,,0,0,14,1,0,15,0,0,9,0,1,10
M3S1-09-07,M3S1,중3-1,9,이차방정식의 활용,7,삼각형과 사각형에 대한 이차방정식의 활용,,0,1,10,3,1,15,0,0,5,1,3,9
M3S1-09-08,M3S1,중3-1,9,이차방정식의 활용,8,둘 이상의 도형에 대한 이차방정식의 활용,,0,0,7,5,0,12,0,0,3,0,2,5
M3S1-09-09,M3S1,중3-1,9,이차방정식의 활용,9,원에 대한 이차방정식의 활용,,0,0,8,0,2,10,0,0,4,2,1,7
M3S1-09-10,M3S1,중3-1,9,이차방정식의 활용,10,평면도형 혹은 입체도형에 대한 이차방정식의 활용,,0,4,13,9,0,26,0,0,9,1,0,10
M3S1-09-11,M3S1,중3-1,9,이차방정식의 활용,11,도로의 길이에 대한 이차방정식의 활용,,0,0,8,1,1,10,0,0,5,1,1,7
M3S1-10-01,M3S1,중3-1,10,이차함수의 그래프(1),1,이차함수,,0,0,11,3,0,14,18,1,1,0,0,20
M3S1-10-02,M3S1,중3-1,10,이차함수의 그래프(1),2,이차함수를 만족하는 조건,,0,1,10,0,0,11,0,1,1,0,0,2
M3S1-10-03,M3S1,중3-1,10,이차함수의 그래프(1),3,이차함수의 값,,0,4,6,3,0,13,2,2,5,0,1,10
M3S1-10-04,M3S1,중3-1,10,이차함수의 그래프(1),4,이차함수 y=ax² 의 그래프와 성질,,0,4,8,0,0,12,11,0,10,0,0,21
M3S1-10-05,M3S1,중3-1,10,이차함수의 그래프(1),5,"이차함수 y=ax², y=−ax²의 그래프의 관계",,0,3,6,4,0,13,5,1,2,0,1,9
M3S1-10-06,M3S1,중3-1,10,이차함수의 그래프(1),6,이차함수 y=ax² 의 식 계산,,0,0,11,1,0,12,1,0,7,1,1,10
M3S1-10-07,M3S1,중3-1,10,이차함수의 그래프(1),7,y축 방향으로의 평행이동,,0,1,7,2,1,11,16,1,11,2,1,31
M3S1-10-08,M3S1,중3-1,10,이차함수의 그래프(1),8,x축 방향으로의 평행이동,,1,1,8,0,0,10,18,3,7,1,0,29
M3S1-10-09,M3S1,중3-1,10,이차함수의 그래프(1),9,"이차함수 y=a(x-p)²+q 의 그래프, 꼭짓점과 축",,0,3,11,3,0,17,16,2,8,1,2,29
M3S1-10-10,M3S1,중3-1,10,이차함수의 그래프(1),10,"이차함수 y=a(x-p)²+q 의 그래프의 증가, 감소 범위",,0,0,10,0,0,10,0,0,3,1,0,4
M3S1-10-11,M3S1,중3-1,10,이차함수의 그래프(1),11,이차함수 y=a(x-p)²+q 의 그래프의 평행이동,,0,0,8,5,0,13,3,0,5,3,1,12
M3S1-10-12,M3S1,중3-1,10,이차함수의 그래프(1),12,이차함수 y=a(x-p)²+q 의 그래프의 대칭이동,,0,4,7,1,0,12,0,1,5,2,1,9
M3S1-10-13,M3S1,중3-1,10,이차함수의 그래프(1),13,이차함수 y=a(x-p)²+q 의 식 계산,,0,0,10,0,0,10,1,0,10,4,2,17
M3S1-10-14,M3S1,중3-1,10,이차함수의 그래프(1),14,"이차함수 y=a(x-p)²+q 의 그래프에서 a, p, q 의 부호",,0,0,6,6,0,12,6,0,6,1,1,14
M3S1-11-01,M3S1,중3-1,11,이차함수의 그래프(2),1,이차함수 y=ax²+bx+c 를 y=a(x-p)²+q 형태로 바꾸기,,0,3,8,1,0,12,5,2,3,0,0,10
M3S1-11-02,M3S1,중3-1,11,이차함수의 그래프(2),2,"이차함수 y=ax²+bx+c 의 그래프, 꼭짓점과 축",,0,0,7,8,0,15,1,5,6,1,2,15
M3S1-11-03,M3S1,중3-1,11,이차함수의 그래프(2),3,이차함수 y=ax²+bx+c 의 그래프의 평행이동,,0,0,11,2,0,13,0,0,7,1,0,8
M3S1-11-04,M3S1,중3-1,11,이차함수의 그래프(2),4,"이차함수 y=ax²+bx+c 의 그래프에서의 증가, 감소 범위",,0,0,10,0,0,10,0,0,5,1,1,7
M3S1-11-05,M3S1,중3-1,11,이차함수의 그래프(2),5,이차함수 y=ax²+bx+c 의 그래프의 성질,,0,0,14,0,0,14,0,0,5,0,0,5
M3S1-11-06,M3S1,중3-1,11,이차함수의 그래프(2),6,이차함수 그래프가 좌표축과 만나는 점,,0,0,7,7,0,14,0,0,7,1,0,8
M3S1-11-07,M3S1,중3-1,11,이차함수의 그래프(2),7,이차함수 그래프가 x축과 만나는 점의 개수,,0,3,9,1,0,13,0,0,6,1,1,8
M3S1-11-08,M3S1,중3-1,11,이차함수의 그래프(2),8,이차함수 y=ax²+bx+c 의 그래프가 지나는 사분면,,0,0,8,6,0,14,0,1,2,0,0,3
M3S1-11-09,M3S1,중3-1,11,이차함수의 그래프(2),9,"이차함수 y=ax²+bx+c 의 그래프에서 a, b, c 의 부호",,0,0,5,5,0,10,1,6,6,1,2,16
M3S1-11-10,M3S1,중3-1,11,이차함수의 그래프(2),10,이차함수 그래프와 도형의 넓이,,0,0,3,8,5,16,0,0,4,2,3,9
M3S1-12-01,M3S1,중3-1,12,이차함수의 활용,1,이차함수의 식 계산 (1),꼭짓점과 다른 한 점이 주어진 경우,0,0,13,2,0,15,1,0,6,2,1,10
M3S1-12-02,M3S1,중3-1,12,이차함수의 활용,2,이차함수의 식 계산 (2),축의 방정식과 두 점이 주어진 경우,0,0,15,0,0,15,1,0,6,1,1,9
M3S1-12-03,M3S1,중3-1,12,이차함수의 활용,3,이차함수의 식 계산 (3),세 점이 주어진 경우,0,1,11,2,0,14,2,4,4,1,3,14
M3S1-12-04,M3S1,중3-1,12,이차함수의 활용,4,이차함수의 식 계산 (4),x축과의 교점이 주어진 경우,0,0,10,0,0,10,2,0,6,1,1,10
M3S1-12-05,M3S1,중3-1,12,이차함수의 활용,5,이차함수의 최댓값과 최솟값,,0,1,10,5,0,16,13,4,7,0,1,25
M3S1-12-06,M3S1,중3-1,12,이차함수의 활용,6,최댓값 또는 최솟값이 주어졌을 때 미지수 구하기,,0,3,19,8,0,30,5,0,15,0,4,24
M3S1-12-07,M3S1,중3-1,12,이차함수의 활용,7,최댓값의 최솟값 또는 최솟값의 최댓값,,0,0,10,0,0,10,0,0,4,3,1,8
M3S1-12-08,M3S1,중3-1,12,이차함수의 활용,8,이차함수의 활용 (1),합 또는 차가 일정한 두 수의 곱,0,0,9,4,1,14,0,3,3,1,1,8
M3S1-12-09,M3S1,중3-1,12,이차함수의 활용,9,이차함수의 활용 (2),도형의 넓이,0,0,17,2,0,19,0,1,13,1,3,18
M3S1-12-10,M3S1,중3-1,12,이차함수의 활용,10,이차함수의 활용 (3),내접하는 도형의 넓이,0,0,8,3,0,11,0,0,0,2,3,5
M3S1-12-11,M3S1,중3-1,12,이차함수의 활용,11,이차함수의 활용 (4),식이 주어진 경우,0,0,10,0,0,10,0,1,7,0,2,10
qtid,difficulty,qbase_question_id
EXEP-01-01,5,5306302
EXEP-01-01,3,5827547
M3S1-01-01,1,4977996
M3S1-01-01,4,4983775
EXEP-01-01,3,5824049
M3S1-01-01,4,4986843
M3S1-01-01,4,4976798
M3S1-01-01,4,4982835
M3S1-01-02,3,4982606
M3S1-01-03,3,4976413
M3S1-01-03,3,4983812
M3S1-01-03,3,4981142
HSU1-07-10,3,5628751
EXEP-01-01,3,5827289
M3S1-01-03,3,4976579
M3S1-01-03,3,4977598
M3S1-01-04,3,4978189
M3S1-01-04,3,4983335
EXEP-01-01,1,5570350
M3S1-01-04,2,4987436
M3S1-01-05,3,4983992
M3S1-01-05,3,4976877
M3S1-01-05,3,4983070
M3S1-01-05,3,4983942
EXEP-01-01,1,5570351
M3S1-01-05,4,4984280
EXEP-01-01,1,5570352
EXEP-01-01,1,5570353
M3S1-01-05,4,4977799
M3S1-01-05,4,4977098
M3S1-01-01,4,4982505
M3S1-01-01,4,4981189
EXEP-01-01,2,5573386
M3S1-01-03,3,4985933
EXEP-01-01,3,5828305
M3S1-01-04,2,4983043
EXEP-01-01,3,5828973
M3S1-01-02,3,4980963
M3S1-01-04,2,4977492
M3S1-01-04,2,4982533
M3S1-01-02,3,4983691
M3S1-01-04,3,4983941
M3S1-01-02,3,4977571
M3S1-01-06,4,4981251
M3S1-01-06,4,4987555
M3S1-01-06,4,4981134
M3S1-01-06,3,4986044
M3S1-01-06,4,4977801
M3S1-01-06,5,4983389
EXEP-01-01,3,5828979
M1S1-02-07,3,5415748
M3S1-01-08,3,4986610
M3S1-01-08,3,4976802
M3S1-01-08,3,4982521
M3S1-01-08,3,4976365
M3S1-01-09,3,4986603
M3S1-01-09,4,4976195
M3S1-01-09,3,4982607
M3S1-01-09,3,4983334
M3S1-01-09,5,4976338
M3S1-01-09,3,4976803
M3S1-01-09,3,4982747
M3S1-01-10,2,4987410
EXEP-01-01,2,5413671
M3S1-01-10,3,4980376
M3S1-01-10,5,4983044
M3S1-01-10,4,4977077
M3S1-01-10,3,4986847
M3S1-02-01,2,4983510
M3S1-02-01,2,4988632
M3S1-02-01,2,4976543
M1S1-05-03,3,5411342
M3S1-02-02,2,4976415
M3S1-02-03,3,4986604
M3S1-02-04,4,4977900
M3S1-02-04,3,4987080
M3S1-02-04,4,4987604
M3S1-02-05,2,4978447
M1S1-05-02,5,5415969
M3S1-02-05,3,4976416
M3S1-02-05,3,4983072
M3S1-02-05,3,4983779
M3S1-02-06,3,4976142
M3S1-02-06,3,4983814
M1S1-02-09,4,5415429
M3S1-02-06,4,4977582
M3S1-02-06,4,4982756
EXEP-01-01,,5162052
M3S1-02-07,2,4985905
M3S1-02-07,3,4976275
M3S1-04-12,4,4986762
M3S1-02-08,3,4981248
M3S1-02-08,3,4982701
M3S1-02-08,3,4978255
M3S1-02-08,3,4982840
EXEP-01-01,2,5841919
EXEP-01-01,2,5842104
M3S1-02-08,5,4982917
M3S1-03-01,3,4982752
M3S1-03-01,2,4983253
EXEP-01-01,3,5843721
M3S1-03-01,3,4977521
EXEP-01-01,3,5843779
M3S1-03-01,3,4981167
M3S1-03-02,3,4982612
M3S1-03-02,3,4987166
HSU1-11-13,3,5576506
M3S1-03-02,4,4977779
M3S1-03-02,5,4982934
M3S1-03-02,3,4978134
M3S1-03-02,2,4986325
M3S1-01-06,3,4978190
M3S1-01-06,3,4981209
M3S1-01-06,3,4987082
M3S1-01-06,4,4986348
HSU1-11-08,3,5308784
HSU1-10-02,4,3451471
HSU1-11-08,3,5305238
HSU1-11-08,4,5308946
EXEP-01-01,3,5576105
M3S1-01-08,5,4988533
M3S1-01-08,3,4976345
EXEP-01-01,4,5576500
M3S1-01-08,3,4978001
M3S1-01-09,5,4981173
M3S1-01-09,3,4988631
M3S1-01-10,3,4978005
M3S1-01-10,3,4977097
M3S1-01-10,3,4977599
M3S1-01-10,2,4986047
M3S1-02-02,3,4976544
M3S1-02-03,3,4983095
M3S1-02-03,3,4983388
M3S1-02-03,3,4977577
M3S1-02-03,3,4983994
EXEP-01-01,4,5576502
HSU1-10-06,4,5847954
M3S1-02-06,3,4982809
M3S1-02-06,3,4985910
M3S1-02-06,3,4986328
M3S1-02-06,3,4976580
M3S1-02-06,3,4976277
M3S1-02-07,5,4986096
M3S1-02-07,4,4976552
M3S1-02-07,4,4983726
M3S1-02-08,4,4987559
M3S1-02-08,4,4976340
M3S1-02-08,4,4977863
M3S1-03-01,4,4987908
M3S1-03-02,3,4981194
M3S1-01-08,3,4983099
M3S1-01-09,5,4984191
M3S1-02-03,2,4981143
M3S1-02-04,4,4976547
M3S1-02-04,3,4977597
M3S1-02-07,4,4983620
M3S1-02-07,4,4986045
M3S1-02-07,4,4982705
M3S1-03-02,3,4983594
M3S1-02-03,2,4977902
M3S1-03-03,2,4983693
M3S1-03-03,2,4977498
M3S1-03-04,4,4983495
M3S1-03-04,4,4976809
M3S1-03-04,4,4977804
M3S1-03-06,3,4977602
M3S1-03-06,3,4982751
M3S1-03-07,3,4976933
M3S1-04-12,3,4983511
M3S1-04-12,2,4978260
M3S1-04-12,3,4978125
M3S1-04-12,2,4983612
M3S1-03-06,3,4982920
M3S1-03-04,4,4976276
M3S1-03-01,3,4981144
M3S1-03-01,3,4985915
M3S1-01-08,4,4978544
M3S1-01-06,4,4987160
M3S1-01-06,3,4982843
M3S1-01-06,3,4980275
M3S1-01-03,3,4976137
M3S1-03-07,3,4977780
M3S1-03-07,3,4985124
M3S1-04-01,2,4982754
EXEP-01-01,4,5576503
M3S1-04-01,3,4987720
M3S1-04-01,3,4982615
M3S1-04-02,3,4982531
HSU1-11-05,3,5827441
M3S1-04-03,4,4976418
M3S1-04-03,4,4977470
M3S1-04-03,4,4982510
M3S1-04-05,3,4983610
M3S1-04-05,3,4987403
M3S1-04-05,4,4984008
M3S1-04-05,3,4977176
M3S1-04-05,4,4986748
EXEP-01-01,4,5827462
M3S1-04-06,3,4986105
M3S1-04-06,5,4982515
HSU1-07-11,3,5628754
M2S1-06-08,3,5534734
M1S1-07-10,4,5414889
M3S1-04-07,5,4978446
M3S1-04-07,3,4978193
M3S1-04-07,3,4987609
M3S1-04-07,3,4976893
M3S1-04-07,3,4983947
EXEP-01-01,2,5413672
M1S1-09-02,4,5411317
M3S1-04-08,3,4988540
M3S1-04-08,2,4983944
M3S1-04-08,3,4976806
EXEP-01-01,3,5393171
M3S1-04-09,4,4982924
M3S1-04-09,3,4978321
M1S1-05-05,4,5414573
H1S1-10-12,4,4988573
EXEP-01-01,4,3456300
M3S1-04-11,3,4977472
M3S1-04-11,4,4977828
M3S1-04-12,3,4985913
M3S1-04-12,3,4982507
M3S1-04-12,4,4981145
M2S1-03-10,1,6038062
M3S1-04-12,4,4982916
M3S1-04-13,3,4985918
M3S1-04-13,4,4976489
M3S1-04-13,3,4978013
M3S1-04-13,5,4986046
M3S1-04-13,3,4982543
M3S1-04-13,3,4982455
M3S1-04-13,3,4986116
M3S1-04-13,4,4977800
M3S1-05-01,3,4987615
M3S1-05-01,3,4976252
M3S1-05-02,3,4978195
M3S1-05-02,3,4978192
M3S1-05-02,3,4982462
M3S1-05-03,5,4978008
M3S1-05-03,3,4987093
M3S1-05-04,4,4981175
M3S1-05-04,4,4982762
M3S1-05-04,4,4980426
M3S1-05-05,3,4987451
M3S1-05-05,2,4987617
M3S1-05-05,3,4987726
M3S1-05-05,3,4977479
HCAL-07-07,4,5395051
M3S1-05-05,4,4987405
M3S1-05-05,4,4978327
M3S1-05-05,3,4986347
M3S1-05-05,3,4983056
M3S1-05-06,3,4977465
M3S1-05-06,3,4978449
M2S1-03-08,3,5534631
HCAL-10-12,4,5395052
M3S1-05-06,3,4983499
M3S1-05-06,3,4985667
M3S1-05-06,4,4982812
M3S1-05-07,3,4983261
M3S1-05-07,4,4976425
M3S1-05-07,3,4987566
M3S1-05-07,4,4988549
M3S1-05-07,4,4977807
HCAL-04-13,5,5395055
M3S1-05-08,2,4983498
M3S1-05-08,2,4987408
M3S1-05-08,2,4986875
M3S1-05-08,2,4977418
M3S1-05-08,3,4976585
M3S1-05-08,3,4987723
M3S1-05-08,1,4978139
HSU1-01-05,2,5395057
M3S1-05-09,3,4978448
M3S1-05-09,4,4982514
M3S1-05-09,2,4976554
M3S1-05-09,3,4984292
M3S1-05-09,3,4986112
M3S1-05-09,2,4986339
M3S1-05-09,2,4977526
M3S1-05-09,2,4978197
M3S1-05-09,2,4987175
HCAL-06-01,2,5395058
M3S1-05-10,3,4977873
M3S1-05-10,3,4982545
M3S1-05-11,2,4978007
M3S1-05-11,4,4977911
H1S2-07-25,3,5395060
M3S1-06-01,3,4978137
M3S1-06-01,3,4977178
M3S1-06-01,4,4981201
M3S1-06-01,4,4983497
M3S1-06-01,4,4983340
M3S1-06-01,3,4983082
HSU1-01-14,3,5395061
M3S1-06-02,3,4977912
M3S1-06-02,3,4983387
HCAL-04-04,4,5395062
M3S1-06-04,3,4976812
HSTA-02-03,4,5395064
M3S1-06-05,3,4987724
HCAL-08-05,4,5395065
M3S1-06-06,3,4983344
M3S1-06-06,3,4988149
H1S2-07-21,4,5395066
M3S1-06-07,4,4981203
M3S1-06-07,3,4981152
M3S1-06-07,2,4978009
M3S1-06-07,3,4983059
HCAL-07-11,5,5395067
M3S1-06-08,2,4986050
M3S1-06-08,3,4982464
H1S1-01-01,2,5394794
M3S1-06-08,4,4984010
H1S1-04-02,2,5394796
M3S1-06-08,3,4982726
HSU1-01-05,2,5394797
M3S1-06-09,3,4977379
M3S1-06-09,4,4977647
M3S1-06-09,4,4982825
M3S1-06-09,3,4986736
M3S1-06-09,2,4981148
M3S1-07-01,2,4976217
M3S1-07-01,2,4977345
M3S1-07-01,3,4977913
M3S1-07-01,2,4978269
M3S1-07-01,2,4983359
M3S1-07-01,2,4981052
M3S1-07-01,3,4976294
M3S1-07-02,2,4987452
M3S1-07-02,2,4986168
M3S1-07-02,3,4986741
M3S1-07-02,2,4983266
M3S1-07-02,2,4984003
M3S1-07-02,2,4978278
M3S1-07-03,3,4980991
M3S1-07-04,3,4987502
M3S1-07-04,3,4987652
H1S1-09-07,3,5394798
M3S1-07-04,3,4980622
M3S1-07-04,4,4976448
M3S1-07-04,3,4986886
M3S1-07-04,4,4988395
M3S1-07-05,3,4987503
M3S1-07-05,3,4977121
M3S1-07-05,3,4983265
M3S1-07-05,4,4986757
M3S1-07-06,3,4980914
M3S1-07-06,3,4980976
M3S1-07-06,3,4981207
M3S1-07-06,3,4976762
M3S1-07-06,3,4987506
M3S1-07-06,4,4980996
M3S1-06-04,3,4978556
M3S1-04-06,4,4983501
M3S1-04-06,3,4981180
M3S1-04-06,5,4981135
M3S1-03-07,3,4983075
M3S1-02-08,4,4976880
M3S1-02-08,3,4983943
M3S1-02-08,3,4981149
M3S1-07-06,4,4977424
M3S1-07-07,2,4976296
M3S1-07-07,5,4987341
M3S1-07-07,5,4987647
M3S1-07-07,3,4978214
M3S1-07-08,3,4983955
M3S1-07-08,3,4987521
HSU1-07-11,3,5577102
M3S1-07-08,3,4976443
M3S1-07-09,3,4987917
M3S1-07-09,3,4988292
M3S1-07-09,5,4977817
M3S1-07-09,3,4987339
M3S1-07-09,3,4985684
M3S1-07-10,3,4986053
M3S1-07-10,3,4985971
M3S1-07-11,3,4980194
M3S1-07-11,3,4982478
M3S1-07-11,4,4985967
M3S1-07-11,3,4981020
M3S1-07-11,3,4980995
M1S1-07-10,4,5414531
EXEP-01-01,2,5413670
M1S1-04-19,3,5415180
M1S1-07-16,3,5412050
M1S1-03-02,3,5414724
M3S1-08-01,3,4976889
M3S1-08-01,3,4988293
M3S1-08-01,4,4978502
M3S1-08-01,3,4988212
H1S1-10-12,4,4986022
M3S1-08-02,3,4988213
M3S1-08-02,3,4982518
M3S1-08-02,3,4980338
M3S1-08-02,3,4977422
M3S1-08-02,3,4978450
M3S1-08-02,3,4976867
HSU2-01-02,3,3975223
M3S1-08-03,5,4986551
M2S1-07-18,3,5408603
M2S1-10-02,3,5741179
M3S1-08-05,3,4986545
M3S1-08-05,3,4978283
M3S1-08-05,4,4982732
M3S1-08-05,4,4985553
M3S1-08-05,5,4983733
M3S1-08-05,4,4987650
M3S1-08-05,4,4985184
H1S2-04-16,3,5394799
HSU1-09-01,3,5394826
H1S1-07-12,3,5394827
H1S2-06-07,3,5394829
M3S1-08-07,5,4987508
M3S1-08-07,4,4976227
M3S1-08-08,5,4986473
M3S1-08-08,3,4985965
M3S1-08-08,3,4983107
M3S1-08-09,3,4976323
M3S1-08-09,3,4977444
M3S1-08-09,3,4987246
HSU1-02-17,3,5394831
H1S1-07-09,3,5394833
H1S2-03-16,3,5394835
H1S1-10-09,3,5394837
H1S2-05-16,3,5394839
M3S1-08-10,3,4980626
M3S1-08-10,4,4976905
M3S1-09-01,3,4976826
M3S1-09-01,3,4986773
M3S1-09-01,3,4980648
M3S1-09-01,3,4977732
M3S1-09-02,4,4980542
M3S1-09-03,3,4983451
M3S1-09-03,3,4988214
M3S1-09-03,3,4985190
M3S1-09-04,3,4980197
M3S1-09-04,3,4988295
M3S1-09-04,3,4978474
M3S1-09-04,3,4976827
M3S1-09-04,3,4980608
M3S1-09-04,3,4986945
M3S1-09-05,3,4980649
M3S1-09-05,4,4988455
M3S1-09-05,4,4987804
M3S1-09-05,3,4977056
M3S1-09-06,3,4986250
M3S1-09-06,3,4985851
M3S1-09-06,3,4983021
M3S1-09-06,3,4978284
M3S1-09-06,3,4978094
M3S1-09-06,3,4983191
M3S1-09-07,3,4977055
M3S1-09-07,3,4988216
M3S1-09-07,4,4976332
M3S1-09-08,3,4976979
M3S1-09-08,4,4980882
M3S1-09-09,3,4983665
M3S1-09-09,3,4980609
M3S1-09-09,3,4988401
M3S1-09-09,3,4983414
M3S1-09-09,3,4986661
M3S1-09-10,3,4980629
M3S1-09-11,3,4983368
M3S1-09-11,3,4976451
M3S1-10-01,3,4987343
M3S1-10-01,3,4986554
M3S1-10-01,3,4980341
M3S1-10-01,4,4985295
M3S1-10-01,3,4985765
M3S1-10-01,4,4988300
M3S1-10-02,3,4985194
M3S1-10-03,2,4987807
M3S1-10-03,3,4976519
M3S1-10-03,4,4983296
M3S1-10-03,3,4983037
M3S1-10-03,3,4980632
M3S1-10-03,3,4978344
M3S1-10-03,3,4983751
M3S1-10-04,3,4986665
M3S1-10-04,2,4983024
M3S1-10-04,3,4986973
M3S1-10-04,2,4985974
M3S1-10-04,2,4986253
M3S1-10-04,3,4983418
M3S1-10-05,3,4977153
M3S1-10-05,4,4977448
M3S1-10-05,4,4976828
M3S1-10-05,3,4977392
M3S1-10-05,2,4986974
M3S1-10-05,2,4986177
M3S1-10-06,3,4976221
M3S1-10-06,3,4978478
M3S1-10-06,3,4986666
M3S1-10-07,3,4983546
M3S1-10-07,3,4976982
M3S1-10-07,3,4978097
M3S1-10-07,2,4988467
M3S1-10-08,3,4986668
M3S1-10-08,1,4985220
M3S1-10-08,2,4977049
M3S1-10-08,3,4976667
M3S1-10-08,3,4976223
M3S1-10-08,3,4980347
M3S1-10-09,3,4982869
M3S1-10-09,3,4978388
M3S1-10-09,3,4985197
M3S1-10-09,3,4976669
M3S1-10-09,3,4987346
M3S1-10-09,2,4982902
M3S1-10-10,3,4982947
M3S1-10-10,3,4987349
M3S1-10-10,3,4976910
M3S1-10-10,3,4985296
M3S1-10-11,3,4982871
M3S1-10-11,3,4980636
M3S1-10-11,4,4980864
M3S1-10-09,3,4976319
M3S1-09-10,2,4976830
M3S1-09-10,4,4987805
M3S1-09-10,3,4985290
M3S1-09-10,4,4977834
M3S1-09-10,2,4988297
M3S1-09-04,3,4984006
M3S1-08-08,3,4976888
M3S1-08-08,4,4988215
M3S1-08-08,2,4978157
M3S1-08-08,4,4980628
M3S1-08-05,3,4983398
M3S1-08-05,3,4987338
M3S1-08-05,3,4981021
M3S1-08-05,3,4985682
M3S1-08-05,3,4982730
M3S1-08-05,3,4983526
M3S1-07-09,4,4976899
M3S1-07-09,3,4980624
M3S1-07-09,3,4977388
M3S1-07-09,3,4986547
M3S1-07-06,4,4978455
M3S1-10-11,4,4981227
M3S1-10-11,3,4983010
M3S1-10-11,4,4982790
HSU1-07-06,2,6064687
M3S1-10-12,3,4978480
M3S1-10-12,4,4983229
M3S1-10-13,3,4977050
M3S1-10-13,3,4980349
HSU1-07-11,4,5576109
M1S1-02-07,3,5414078
M3S1-10-13,3,4978170
M3S1-10-14,3,4980221
EXEP-01-01,2,5415856
M3S1-10-14,4,4988065
M3S1-10-14,4,4976840
M3S1-10-14,3,4988304
HSU1-10-06,4,5847953
M3S1-11-01,3,4985860
M1S1-04-07,3,5414845
M3S1-11-01,3,4976644
M3S1-11-02,4,4977059
M3S1-11-02,3,4982781
M3S1-11-02,4,4983034
HCAL-02-04,3,266713
M3S1-11-03,3,4985304
M3S1-11-03,3,4984146
M1S1-07-16,3,5412049
M3S1-11-05,3,4986185
M3S1-11-05,3,4980583
M3S1-11-05,3,4988224
M3S1-11-06,3,4976672
M3S1-11-06,4,4985412
M3S1-11-08,3,4978222
M3S1-11-08,4,4980661
M3S1-11-09,3,4978099
M3S1-11-09,4,4982789
M3S1-11-09,4,4980603
M3S1-11-09,4,4977131
M3S1-11-09,3,4983233
M3S1-11-09,3,4982642
M3S1-11-09,4,4976992
M3S1-11-10,3,4988597
HSU1-11-04,3,5306021
M3S1-11-10,5,4981032
EXEP-01-01,,5303306
M3S1-11-10,4,4986671
M3S1-11-10,3,4980779
M3S1-12-01,3,4977740
M3S1-12-01,3,4976459
M3S1-12-01,3,4982560
M3S1-12-01,3,4986186
M3S1-12-01,3,4988218
M3S1-12-01,3,4976525
M3S1-12-01,3,4976458
M3S1-12-01,3,4980635
M3S1-12-02,3,4980604
M3S1-12-03,3,4983031
M3S1-12-03,3,4985298
M3S1-12-03,3,4981113
M1S1-07-14,3,5411920
M3S1-12-03,3,4982420
M2S1-06-07,2,5371309
M3S1-12-04,3,4978224
M3S1-12-05,3,4977013
M3S1-12-05,3,4985863
M3S1-12-05,3,4987255
M2S1-10-02,3,5741180
M3S1-12-05,3,4983762
HSU1-01-05,2,5395584
M3S1-12-06,3,4983038
M3S1-12-06,2,4987670
H1S2-02-01,2,5395586
HCAL-01-04,2,5395587
M3S1-12-07,3,4978393
M3S1-12-07,3,4976231
M3S1-12-07,3,4986269
M3S1-12-07,3,4988330
M3S1-12-07,3,4980664
M3S1-12-07,3,4984142
HSU1-02-03,3,5395588
M3S1-12-08,3,4976673
M3S1-12-08,3,4977454
H1S2-04-10,3,5395590
M3S1-12-09,3,4982793
M3S1-12-09,3,4977361
HSU1-09-01,3,5395592
M3S1-12-09,3,4982982
HSTA-03-12,3,5395596
HSU2-01-02,3,5395597
HSU1-10-04,3,5395598
M3S1-12-10,3,4980587
M3S1-12-10,3,4983763
M3S1-12-10,4,4977849
M3S1-12-11,3,4983760
M3S1-12-11,3,4982886
HSU2-02-05,3,5395599
M3S1-12-11,3,4983232
M3S1-03-03,3,4977635
M3S1-03-03,3,4987611
M3S1-03-03,2,4982753
M3S1-03-03,2,4986717
M3S1-03-03,2,4982842
M3S1-03-03,3,4977705
M3S1-03-06,3,4981200
HSTA-06-01,3,5395600
M3S1-03-06,3,4984195
M3S1-03-06,4,4980380
H1S2-03-05,3,5395601
M3S1-04-01,4,4987563
M3S1-04-05,4,4983491
M3S1-04-06,4,4987732
M3S1-04-06,4,4987613
M3S1-04-06,4,4978014
M3S1-04-07,4,4987445
HSTA-04-02,3,5395603
HSU1-10-12,4,5395604
M3S1-04-09,5,4987722
M3S1-04-09,3,4983697
HSTA-06-09,4,5395606
HCAL-02-16,4,5395608
HSU1-10-08,4,5395610
HSTA-05-05,4,5395611
M3S1-04-11,4,4982811
HSTA-02-01,4,5395612
M3S1-04-11,3,4977637
HSU2-05-05,4,5395614
HSU2-03-17,5,5395616
M3S1-04-12,3,4976149
M3S1-04-13,4,4976808
H1S2-07-15,2,5395617
M3S1-05-02,3,4983259
M3S1-05-03,4,4986620
M3S1-05-03,4,4981257
M3S1-05-05,3,4976284
M3S1-05-08,2,4983102
HSU2-08-01,2,5395618
M3S1-05-09,5,4977085
M3S1-05-10,3,4978382
M3S1-06-02,3,4987725
H1S2-04-16,3,5395620
M3S1-06-04,4,4983732
M3S1-06-05,3,4983790
HSU2-03-16,3,5395621
M3S1-06-08,3,4981255
M3S1-06-08,3,4986882
M3S1-06-08,3,4987177
M3S1-06-08,4,4983393
M3S1-06-09,3,4977814
M3S1-06-09,4,4980885
M3S1-07-03,2,4982666
M3S1-07-04,3,4983952
M3S1-07-04,3,4977356
M3S1-07-04,4,4986549
M3S1-07-06,4,4981023
M3S1-07-07,5,4988448
M3S1-07-07,4,4976778
M3S1-07-07,3,4983364
M3S1-07-08,3,4983016
M3S1-07-09,5,4988399
M3S1-07-09,5,4976326
M3S1-07-09,5,4976890
M3S1-08-02,3,4988057
M3S1-08-08,4,4976388
M3S1-08-08,4,4982671
M3S1-08-08,4,4977833
M3S1-08-08,4,4980573
M3S1-12-09,3,4976957
M3S1-12-06,4,4983302
M3S1-12-03,3,4980660
M3S1-10-11,3,4984058
M3S1-07-09,3,4980337
M3S1-07-09,3,4988209
M3S1-07-07,3,4980765
M3S1-07-01,3,4982467
M3S1-07-01,3,4983365
M3S1-06-05,3,4983948
M3S1-05-09,1,4976205
M3S1-05-01,3,4983053
M3S1-03-07,3,4978131
M3S1-02-08,2,4985908
M3S1-02-08,2,4977633
M3S1-09-05,3,4980465
M3S1-09-05,3,4983529
M3S1-09-07,2,4985762
HSU1-07-12,4,5576226
M2S1-02-16,3,3213123
M3S1-09-09,5,4982553
M1S1-06-16,3,5412688
M1S1-04-05,3,5414392
M1S1-05-07,4,5410751
M1S1-07-21,2,5413607
M3S1-10-03,4,4982784
M3S1-10-04,2,4977393
M3S1-10-04,3,4980633
M3S1-10-05,4,4978169
M3S1-10-05,4,4977394
M3S1-10-05,3,4988459
M3S1-10-07,3,4981028
M3S1-10-07,3,4976614
M1S1-03-10,3,5413242
HSU1-04-06,5,5164544
EXEP-01-01,,5323289
M1S1-05-01,3,5413825
M3S1-10-08,3,4988405
M2S1-09-01,4,5372762
H1S1-11-15,3,4986366
M3S1-10-08,3,4980863
M3S1-10-09,3,4980600
M3S1-10-09,4,4987819
M3S1-10-09,4,4976986
M3S1-10-10,3,4976985
M3S1-10-10,3,4982782
M3S1-10-11,4,4980775
M3S1-10-11,4,4983026
M3S1-10-11,3,4978291
M3S1-10-12,2,4976184
M3S1-10-13,3,4980605
M3S1-10-13,3,4976645
M3S1-10-13,3,4982498
M3S1-10-13,3,4980346
M3S1-10-13,3,4987519
M3S1-10-14,4,4985299
M3S1-10-14,4,4986262
M3S1-11-02,4,4985302
M3S1-11-02,4,4977353
M3S1-11-03,3,4982951
HSTA-03-07,4,5395623
M3S1-11-03,3,4983894
M3S1-11-03,3,4977362
M3S1-11-03,3,4980638
M3S1-11-04,3,4983030
M3S1-11-04,3,4982946
M3S1-11-04,3,4985201
M3S1-11-04,3,4978168
M3S1-11-04,3,4983757
M3S1-11-04,3,4983298
M3S1-11-04,3,4983680
M3S1-11-04,3,4976789
M3S1-11-04,3,4987816
M3S1-11-05,3,4983195
M3S1-11-06,4,4988071
M3S1-11-07,3,4980865
M3S1-11-08,3,4980342
M3S1-11-09,4,4988480
M3S1-11-09,3,4986264
M3S1-11-10,5,4977851
M3S1-11-10,4,4977453
M3S1-11-10,5,4982868
M3S1-11-10,5,4980534
M3S1-12-01,3,4977840
M3S1-12-02,3,4978510
H1S2-01-09,4,5395625
M3S1-12-03,2,4976330
M3S1-12-03,3,4983898
HCAL-10-02,4,5395626
HSU2-08-13,4,5395632
M3S1-12-05,3,4976685
M3S1-12-05,3,4976684
M3S1-12-05,3,4981226
M3S1-12-05,2,4978290
M3S1-12-06,3,4983895
H1S2-06-10,5,5395639
EXEP-01-01,2,5395427
M3S1-12-06,3,4985205
M3S1-12-06,4,4976969
HSU1-03-11,2,5395428
EXEP-01-01,2,5395429
M3S1-12-09,3,4988482
HSTA-03-13,3,5395430
M2S1-05-07,4,3305342
M3S1-12-11,3,4982480
M3S1-12-11,3,4977742
M3S1-12-11,3,4976308
M3S1-02-01,2,4981193
M3S1-02-01,2,4978254
M3S1-03-04,4,4978545
M3S1-03-06,4,4981252
M3S1-03-07,3,4977413
M3S1-04-01,2,4986324
M3S1-04-05,3,4983698
M3S1-04-05,4,4982508
M3S1-04-05,4,4982703
M3S1-04-07,4,4981054
M3S1-04-07,3,4977643
M3S1-04-09,2,4982717
M3S1-04-09,3,4983945
M3S1-05-01,3,4976556
M3S1-05-02,3,4981147
M3S1-05-02,4,4987966
M3S1-05-02,3,4987176
M3S1-05-04,4,4978196
M3S1-05-04,4,4976206
M3S1-05-06,3,4981256
M3S1-05-06,3,4983786
M3S1-05-07,4,4978418
M3S1-05-07,3,4986107
M3S1-05-07,4,4977081
M3S1-05-10,3,4986341
M3S1-05-10,3,4983502
M3S1-05-11,2,4986337
M3S1-05-11,4,4982714
M3S1-05-11,3,4986873
M3S1-06-01,3,4983500
M3S1-06-01,4,4986048
M3S1-06-01,3,4982926
M3S1-06-02,2,4981181
M3S1-06-02,3,4987095
M3S1-06-07,2,4983946
M3S1-06-07,3,4983263
M3S1-06-07,3,4982716
M3S1-06-09,2,4986111
M3S1-07-01,2,4988447
M3S1-07-01,2,4982931
M3S1-07-01,3,4980190
M3S1-07-02,2,4987914
M3S1-07-02,2,4977437
M3S1-07-05,3,4977002
M3S1-07-05,3,4980462
M3S1-07-05,3,4987254
M3S1-07-07,4,4987507
M3S1-07-07,5,4977358
M3S1-07-07,4,4983617
M3S1-07-08,3,4978163
M3S1-07-08,3,4980538
M3S1-07-09,3,4977346
M3S1-07-10,3,4980575
M3S1-07-11,3,4977185
M3S1-07-11,4,4982990
M3S1-07-11,4,4983827
M3S1-07-11,4,4986056
M3S1-08-01,3,4986470
M3S1-08-01,3,4978160
M3S1-08-01,4,4977443
M3S1-08-02,3,4977058
M3S1-08-05,3,4987916
M3S1-08-05,3,4986888
M3S1-08-07,5,4985683
M3S1-08-08,4,4985972
M3S1-08-08,3,4976900
M3S1-08-09,3,4986248
M3S1-12-09,3,4977360
M3S1-12-06,4,4983426
M3S1-10-14,4,4984971
M3S1-10-09,3,4986259
M3S1-10-09,2,4985857
M3S1-10-03,2,4986254
M3S1-10-03,2,4983753
M3S1-10-01,3,4982780
M3S1-09-10,4,4984129
M3S1-09-10,4,4988456
M3S1-08-05,3,4983293
M3S1-08-05,3,4978210
M3S1-08-05,3,4984211
M3S1-08-05,3,4983015
M3S1-04-06,3,4983110
M3S1-03-01,3,4987401
M3S1-03-01,3,4986326
M3S1-02-08,4,4987440
M3S1-02-08,3,4987162
M3S1-02-08,3,4985507
M3S1-02-05,3,4980907
HSU1-07-13,4,5628756
M3S1-08-11,3,4977808
M3S1-09-01,3,4977349
M3S1-09-01,5,4980630
M1S1-06-16,3,5412964
M3S1-09-03,3,4980932
M3S1-09-03,3,4985289
M3S1-09-04,3,4982468
M3S1-09-04,3,4982672
M3S1-09-04,3,4976182
M3S1-09-05,3,4986472
M3S1-09-05,3,4980577
M3S1-09-06,3,4987342
M3S1-09-07,3,4986175
M3S1-09-08,4,4987509
M3S1-09-09,3,4980340
M3S1-09-09,3,4988296
M3S1-09-11,3,4983221
M3S1-09-11,3,4977004
M3S1-10-01,3,4983417
M3S1-10-01,3,4976665
M3S1-10-01,3,4988217
M3S1-10-01,4,4988299
M3S1-10-02,3,4978216
M3S1-10-03,2,4976635
M3S1-10-06,3,4980344
M1S1-07-01,2,5412627
M1S1-01-02,2,5413679
M3S1-10-06,3,4977330
M3S1-10-09,3,4976386
M3S1-10-10,3,4976952
M3S1-10-10,3,4986557
M3S1-10-10,3,4981029
M3S1-10-12,3,4976906
M3S1-10-12,3,4986664
M3S1-10-14,3,4980348
M3S1-10-14,4,4976455
M3S1-10-14,3,4985209
M3S1-11-01,3,4982496
M3S1-11-01,3,4980473
M1S1-03-10,3,5413243
M3S1-11-02,4,4988226
M3S1-11-02,3,4987813
M3S1-11-03,3,4976460
M3S1-11-03,3,4982736
M3S1-11-05,3,4982949
M3S1-11-05,3,4977350
M3S1-11-08,3,4986985
M3S1-11-08,4,4988593
M3S1-12-01,3,4977335
M3S1-12-03,3,4980586
HSU1-11-11,3,5309295
M3S1-12-06,2,4983425
M3S1-12-06,3,4981004
EXEP-01-01,,5351506
M3S1-12-07,3,4986988
M3S1-12-07,3,4986011
M3S1-12-07,3,4987665
M3S1-12-07,3,4985300
M2S1-08-11,3,5371591
M3S1-12-09,3,4983035
M3S1-12-09,3,4976391
H1S1-12-06,3,4981842
M3S1-12-10,3,4978350
M3S1-12-10,3,4980351
M3S1-12-10,4,4976334
M3S1-12-11,3,4983003
M3S1-12-11,3,4985212
M3S1-12-11,3,4987822
M3S1-02-01,1,4977993
H1S1-07-20,4,5560393
M3S1-03-07,4,4982922
M3S1-04-07,4,4985668
M3S1-04-08,2,4982921
HCAL-04-03,3,5395432
HSU2-08-01,3,5395433
M3S1-05-04,4,4983702
M3S1-05-06,3,4977805
M3S1-05-10,3,4977561
HSU1-06-19,3,5395434
M3S1-05-10,3,4985671
M3S1-05-11,3,4976285
M3S1-06-01,3,4985928
M3S1-06-02,2,4986723
M3S1-06-07,3,4981150
M3S1-07-05,3,4983217
M3S1-07-11,3,4981262
M3S1-08-01,3,4985182
EXEP-01-01,3,5395438
HCAL-05-03,3,5395439
M3S1-08-08,3,4985681
M3S1-09-01,3,4978473
HSTA-06-09,3,5395441
M3S1-09-08,4,4978550
M3S1-09-09,3,4980466
HCAL-03-10,3,5395442
HSTA-04-02,3,5395443
HCAL-10-04,3,5395444
M3S1-10-06,3,4983756
M3S1-10-06,3,4977126
M3S1-10-10,3,4978481
HCAL-05-09,4,5395447
M3S1-11-05,3,4987662
M3S1-11-05,3,4980602
M3S1-11-08,4,4976907
H1S2-07-25,4,5395448
M2S1-09-13,3,5597077
M3S1-12-10,4,4977339
M3S1-02-01,2,4983252
M3S1-03-07,4,4977079
M3S1-04-07,4,4982923
M3S1-04-08,3,4978443
M3S1-04-09,3,4977417
M2S1-05-08,3,5596830
M3S1-06-02,3,4977478
HSU1-11-01,2,5843812
HSU1-06-23,2,5576012
M3S1-09-11,3,4976180
M3S1-11-08,4,4982680
M3S1-11-08,4,4976457
H1S1-01-01,4,4984777
H1S1-01-01,3,4984680
H1S1-01-01,2,4986572
H1S1-01-01,3,4979636
EXEP-01-01,4,5395450
H1S1-01-01,3,4988237
H1S1-01-01,4,4980439
H1S1-01-01,3,4988612
H1S1-01-02,4,4981963
H1S1-01-02,3,4979770
H1S1-01-02,3,4984464
H1S1-01-02,3,4987111
H1S1-01-02,3,4979010
H1S1-01-02,4,4984434
M2S1-07-19,3,6037696
H1S1-01-03,4,4988245
H1S1-01-04,3,4984024
H1S1-01-04,3,4983638
H1S1-01-04,4,4985516
H1S1-01-04,4,4988493
H1S1-01-04,4,4980355
H1S1-01-04,4,4980440
M2S1-07-06,3,5370178
H1S1-01-05,4,4985362
H1S1-01-06,4,4988243
H1S1-01-06,3,4980396
H1S1-01-06,3,4980442
HSTA-05-05,4,5395451
H1S1-01-07,4,4987249
H1S1-01-07,3,4988714
EXEP-01-01,4,5395452
H1S1-01-08,3,4986123
H1S1-01-08,2,4980555
H1S1-01-08,3,4988036
M2S1-06-06,2,5372046
H1S1-01-08,3,4985149
HSTA-05-05,3,5827780
H1S1-01-08,4,4985179
H1S1-01-09,2,4978774
H1S1-02-01,3,4988973
H1S1-02-01,4,4988993
H1S1-02-01,3,4987038
H1S1-02-01,3,4984805
HSU1-11-12,3,5309750
M2S1-03-11,3,5370619
H1S1-02-02,4,4984940
H1S1-02-02,4,4984436
H1S1-02-02,4,4980391
H1S1-02-03,4,4984787
H1S1-02-03,4,4981568
H1S1-02-03,4,4980175
H1S1-02-03,4,4986198
H1S1-02-04,4,4986420
H1S1-02-04,4,4988615
H1S1-02-04,4,4987869
H1S1-02-05,4,4986716
M3S1-11-06,3,4980350
M3S1-09-10,4,4988595
M3S1-08-08,2,4982669
M3S1-08-05,3,4988394
M3S1-08-05,3,4976260
M3S1-03-01,3,4976931
H1S1-02-05,4,4985375
H1S1-02-05,4,4985825
H1S1-02-06,4,4987874
H1S1-02-06,3,4984020
H1S1-02-06,2,4988239
HSU1-07-13,2,6064693
H1S1-02-06,2,4988345
H1S1-02-07,3,4989094
HSU1-07-15,3,5843241
H1S1-02-07,4,4988819
H1S1-02-07,4,4978761
H1S1-02-07,4,4987247
H1S1-02-07,3,4980181
M2S1-05-05,3,5596649
M1S1-06-14,3,5412844
H1S1-02-08,3,4989009
H1S1-02-08,4,4985034
H1S1-02-09,3,4984437
H1S1-02-09,3,4980559
H1S1-02-10,3,4984194
H1S1-02-10,3,4986712
M2S1-05-05,3,5740956
H1S1-02-11,2,4986578
H1S1-02-11,2,4984470
H1S1-02-11,3,4986444
H1S1-02-11,3,4987463
H1S1-02-11,3,4980353
HSU1-09-08,3,5827366
H1S1-02-12,3,4988143
HSU1-06-19,3,5626706
H1S1-02-12,4,4987873
H1S1-02-13,3,4985183
HSU1-04-14,3,6064376
H1S1-02-13,2,4987041
EXEP-01-01,,5413735
H1S1-02-14,4,4979013
H1S1-02-14,4,4982028
H1S1-02-14,4,4980257
H1S1-02-14,4,4983868
H1S1-03-01,3,4985306
H1S1-03-01,3,4979880
H1S1-03-01,2,4980243
H1S1-03-01,3,4987199
HSU1-01-06,3,5570240
H1S1-03-02,3,4985517
H1S1-03-02,4,4978939
H1S1-03-02,4,4981572
M1S1-05-18,4,5414419
H1S1-03-02,4,4978754
H1S1-03-02,3,4981958
H1S1-03-03,4,4979058
H1S1-03-03,4,4985377
H1S1-03-04,3,4986422
H1S1-03-04,4,4984944
M1S1-06-07,2,5587166
M1S1-07-20,3,5410199
H1S1-03-04,3,4984743
H1S1-03-04,4,4984784
H1S1-03-04,3,4988994
H1S1-03-04,3,4988950
M2S1-05-03,3,5596760
H1S1-03-06,3,4980135
M3S1-10-13,3,4985861
H1S1-03-06,4,4978778
H1S1-03-06,2,4988035
H1S1-03-06,4,4978762
H1S1-03-06,3,4989053
M1S1-04-19,2,5529757
M1S1-08-01,3,5415721
H1S1-03-09,3,4988995
HSTA-07-07,3,5825019
HSTA-04-07,4,5187256
H1S1-03-09,3,4978765
H1S1-03-09,3,4980153
H1S1-03-09,4,4980453
H1S1-03-09,3,4987043
H1S1-03-09,3,4979011
H1S1-03-10,3,4984818
H1S1-03-10,4,4988500
H1S1-03-11,3,4988810
H1S1-03-11,3,4987114
H1S1-03-11,3,4989119
H1S1-03-11,3,4979059
H1S1-04-01,2,4984016
H1S1-04-01,3,4986231
H1S1-04-02,3,4987468
M2S1-04-10,3,5369973
H1S1-04-02,4,4981933
H1S1-04-02,3,4984439
HSU1-11-11,4,5309872
H1S1-04-04,3,4985525
EXEP-01-01,,5356508
M1S1-03-05,3,5414424
H1S1-04-03,2,4985494
H1S1-04-03,3,4981960
H1S1-04-03,2,4979776
M2S1-09-01,3,5371104
H1S1-04-03,2,4981926
H1S1-04-03,2,4979637
H1S1-04-03,2,4983872
H1S1-04-05,4,4985032
H1S1-04-05,3,4987221
H1S1-04-05,4,4984833
H1S1-04-05,3,4979425
H1S1-04-06,4,4986721
H1S1-04-06,3,4984473
H1S1-04-07,4,4984339
H1S1-04-07,3,4986447
HSTA-01-04,4,5395453
H1S1-04-08,4,4989095
H1S1-04-08,4,4988252
H1S1-04-09,4,4978890
H1S1-04-09,4,4981870
H1S1-04-09,4,4988711
H1S1-04-09,3,4988156
H1S1-04-09,3,4980553
HCAL-04-09,4,5395454
H1S1-05-05,3,4986425
H1S1-05-05,3,4987193
H1S1-05-05,3,4988199
H1S1-05-05,4,4985356
H1S1-05-05,3,4988254
H1S1-05-05,3,4986833
H1S1-05-06,4,4985706
H1S1-05-07,4,4987629
H1S1-05-08,4,4986409
H1S1-05-08,3,4987120
H1S1-05-08,4,4989216
HCAL-08-10,5,5395455
H1S1-05-08,4,4986230
H1S1-05-08,4,4987875
H1S1-05-08,3,4979430
H1S1-05-08,4,4982034
H1S1-05-09,3,4988274
H1S2-07-15,2,5395456
H1S1-05-09,4,4985426
H1S1-05-10,4,4979644
H1S1-05-10,3,4984949
HSU1-04-03,2,5395457
HSTA-03-07,3,5395458
EXEP-01-01,3,5395460
H1S1-05-11,3,4981937
HCAL-05-12,4,5395466
EXEP-01-01,4,5395469
H1S1-05-13,3,4981768
H1S1-05-14,4,4984811
H1S1-05-14,4,4984681
H1S1-05-14,4,4982104
H1S1-05-14,3,4986842
H1S1-05-14,3,4987879
H1S1-05-15,3,4984838
H1S1-06-01,3,4980134
EXEP-01-01,4,5395472
H1S1-06-01,3,4985699
H1S1-06-01,4,4988959
H1S1-06-01,3,4985388
H1S1-06-01,3,4979640
H1S1-06-02,3,4981961
H1S1-06-02,3,4981965
EXEP-01-01,4,5395474
H1S1-06-02,3,4987048
H1S1-06-02,3,4979432
H1S1-06-02,3,4980249
H1S1-06-02,4,4985524
H1S1-06-02,3,4980554
HCAL-05-13,5,5395477
H1S1-06-04,4,4986398
H1S1-06-04,4,4981601
H1S1-06-05,4,4984479
H1S1-06-05,2,4988978
H1S1-06-06,4,4980359
H1S1-06-06,3,4988031
HSU1-02-03,2,5395272
H1S1-06-06,4,4986207
H1S2-02-01,2,5395273
H1S1-06-07,5,4987846
H1S1-06-07,5,4985020
HSU2-01-06,2,5395274
H1S1-06-10,4,4980449
H1S1-06-10,4,4987230
H1S1-06-10,3,4980254
HSU1-01-12,3,5395275
HSU1-09-01,3,5395280
H1S2-03-22,3,5395281
H1S1-06-10,3,4984749
H1S1-06-10,3,4988960
H1S1-06-10,3,4978785
H1S1-07-01,3,4986452
H1S1-07-01,3,4986072
H1S1-09-12,2,4987374
H1S1-07-01,4,4984170
H1S1-07-01,3,4981931
H1S1-07-01,4,4981580
H1S1-07-02,3,4978898
H1S1-07-02,3,4980560
H1S1-07-02,3,4989136
H1S1-07-03,4,4985752
H1S1-07-05,3,4981887
H1S1-07-05,4,4985019
HSU1-09-01,1,5842347
HSU1-07-15,3,5849906
H1S1-07-06,5,4984815
H1S1-07-06,3,4985701
H1S1-07-07,3,4981604
H1S1-07-07,3,4986731
H1S1-07-07,4,4985018
H1S1-07-08,4,4984816
H1S1-07-09,3,4981909
H1S1-07-09,3,4978996
H1S1-07-09,3,4984817
H1S1-07-09,3,4988266
H1S1-07-10,4,4980362
H1S1-07-10,3,4981875
H1S1-07-10,4,4988279
H1S1-07-10,3,4984951
EXEP-01-01,4,5596650
H1S1-07-12,3,4985718
HSU1-09-08,3,5824323
H1S1-07-12,3,4986211
H1S1-07-12,3,4984952
H1S1-07-13,3,4984445
H1S1-07-13,3,4986980
H1S1-07-13,3,4978783
H1S1-07-13,3,4986077
H1S1-07-14,4,4989222
H1S1-07-15,3,4984048
H1S1-07-15,3,4978759
H1S1-07-15,3,4988921
H1S1-07-15,3,4981936
H1S1-07-16,3,4988249
H1S1-07-16,3,4987207
H1S1-07-17,3,4988716
H1S1-07-18,4,4984637
H1S1-07-19,3,4987047
H1S1-07-19,3,4987541
H1S1-08-01,3,4985442
H1S1-08-01,3,4989255
M1S1-06-14,3,5414215
H1S1-08-08,2,4983849
H1S1-08-08,2,4979785
H1S1-08-08,2,4984410
H1S1-08-08,3,4985722
H1S1-08-10,3,4985609
H1S1-08-10,4,4985417
H1S1-08-10,3,4986677
H1S1-08-10,3,4982002
H1S1-08-12,3,4981886
HSU1-04-01,2,6064619
H1S1-08-13,2,4989017
EXEP-01-01,0,5367964
HSU1-02-13,2,5827268
H1S1-08-13,3,4979784
H1S1-08-13,3,4985365
H1S1-08-14,3,4989296
H1S1-08-14,3,4987771
H1S1-08-14,3,4979782
H1S1-08-14,3,4986376
H1S1-08-14,3,4983974
H1S1-08-16,3,4984263
H1S1-08-16,3,4985896
M2S1-04-01,3,3295755
H1S1-08-16,3,4985415
H1S1-08-17,3,4979472
HSU1-03-13,3,5827530
H1S1-08-15,3,4981526
H1S1-08-19,3,4980510
M1S1-07-08,3,3168698
H1S1-08-20,3,4985892
M1S1-05-19,4,6065719
HSTA-06-01,2,5188494
H1S1-08-22,3,4986991
H1S1-08-22,3,4978801
H1S1-08-22,3,4981661
H1S1-08-22,3,4985650
M2S1-01-11,2,5393706
H1S1-08-23,3,4978698
H1S1-08-24,2,4980361
H1S1-08-24,3,4984340
H1S1-08-24,3,4984358
H1S1-08-24,2,4979888
H1S1-08-24,3,4980177
H1S1-08-25,3,4987580
M1S1-07-04,3,5415659
H1S1-09-01,3,4981980
H1S1-09-01,3,4989160
H1S1-09-02,4,4986277
M1S1-07-13,3,5411353
M1S1-07-13,4,5415353
H1S1-09-02,3,4988523
H1S1-09-02,3,4978700
H1S1-09-02,3,4985095
H1S1-09-03,3,4987294
H1S1-09-03,3,4980111
H1S1-09-03,3,4987060
HSU1-11-12,3,5309985
H1S1-09-04,3,4983976
EXEP-01-01,,5346813
M1S1-06-14,3,5413128
M2S1-04-02,3,5370344
H1S1-09-06,3,4984564
H1S1-10-11,3,4986004
H1S1-09-07,4,4989041
H1S1-09-07,3,4984567
H1S1-09-07,4,4985724
H1S1-09-07,4,4985267
H1S1-09-07,3,4986986
HSU1-10-11,3,5395282
H1S1-09-07,3,4978793
H1S1-09-07,3,4986582
H1S1-09-08,4,4988182
H1S1-09-08,4,4981664
H1S1-09-08,4,4981509
H1S1-09-08,3,4984088
H1S1-09-08,3,4985612
H1S1-09-08,4,4979475
H1S1-09-08,4,4985899
H1S1-09-08,3,4987312
H1S1-09-08,3,4978821
H1S1-09-09,3,4980023
H1S1-09-09,3,4978813
HSU1-01-13,3,5395286
H1S1-09-09,3,4980324
H1S1-09-09,3,4985001
H1S1-09-10,3,4981795
HSU2-03-11,3,5395287
H1S1-09-10,3,4986510
H1S1-09-11,3,4984114
H1S1-09-11,3,4979037
H1S1-09-11,3,4986275
H1S2-03-16,3,5395288
H1S1-10-01,3,4989149
H1S1-10-01,4,4989019
H1S1-10-02,3,4980110
H1S1-10-02,3,4988184
H1S2-04-07,3,5395289
HSU1-11-05,3,5395290
H1S1-10-02,3,4988863
H1S1-10-03,4,4980308
H1S1-10-03,3,4986588
H1S1-10-04,3,4984264
H1S1-10-04,3,4988422
HSU1-10-02,3,5395291
H1S1-10-05,3,4979477
HSU2-03-16,4,5395292
H1S1-10-06,3,4989163
H1S1-10-06,3,4984386
H1S1-10-07,4,4981528
H1S1-10-07,4,4987886
H1S1-10-07,3,4978867
H1S1-10-07,4,4986698
H1S1-10-08,3,4981620
H1S1-10-08,3,4989045
H1S1-10-08,3,4980325
HCAL-02-04,4,5395294
H1S1-10-08,3,4979451
H1S1-10-08,3,4982080
H1S1-10-09,3,4981670
H1S1-10-09,3,4987295
H1S1-10-09,3,4984089
H1S1-10-09,3,4985614
H1S1-10-09,3,4978869
HSU2-02-05,4,5395295
H1S2-04-22,4,5395296
HSU2-01-16,4,5395297
HSU1-11-11,4,5395298
HSU2-02-04,4,5395300
HCAL-02-16,5,5395301
HCAL-01-14,2,5395302
H1S1-10-09,3,4980517
H1S1-10-10,4,4981827
H1S1-10-10,4,4984923
H1S1-10-11,3,4988466
H1S1-10-11,4,4987995
H1S1-10-11,3,4987746
H1S1-10-11,3,4989150
H1S1-10-11,3,4988930
HSU1-07-15,3,5849882
HSU1-08-05,3,5847801
H1S1-10-12,4,4979478
H1S1-10-12,3,4985424
H1S1-10-12,3,4988001
H1S1-10-13,4,4980323
H1S1-10-13,3,4989301
H1S1-10-13,3,4987375
H1S1-10-13,3,4982012
H1S1-10-14,3,4988379
H1S1-10-14,3,4987424
H1S1-10-14,4,4988092
H1S1-10-15,3,4987316
M2S1-05-03,3,3305277
H1S1-10-16,3,4984091
H1S1-10-16,4,4981512
H1S1-11-01,3,4984319
H1S1-11-01,4,4988468
H1S1-11-01,2,4985427
H1S1-11-01,3,4989015
H1S1-11-02,3,4986691
H1S1-11-02,3,4986238
H1S1-11-02,3,4988931
M2S1-09-13,3,5597027
H1S1-11-02,3,4987289
M2S1-05-04,3,5596652
H1S1-11-03,3,4987884
H1S1-11-03,3,4985727
H1S1-11-03,3,4978924
H1S1-11-03,3,4989152
HSU1-10-08,3,5847955
H1S1-11-04,3,4984244
HSU1-06-19,3,5843150
H1S1-11-04,3,4989168
H1S1-11-04,3,4980222
HSU1-07-16,1,6038671
M1S1-02-09,4,5413175
H1S1-11-05,3,4984768
H1S1-11-06,3,4984118
H1S1-11-06,3,4984269
H1S1-11-06,3,4988188
H1S1-11-06,4,4979482
H1S1-11-06,4,4986024
HSU1-11-03,4,6064755
H1S1-11-08,3,4978804
H1S1-11-11,4,4984541
HSU1-05-12,2,5162900
H1S1-11-11,4,4979044
H1S1-11-11,4,4988575
M2S1-01-17,3,5368517
M1S1-04-02,3,5413194
H1S1-11-12,3,4981506
H1S1-11-12,4,4981557
H1S1-11-12,4,4985235
H1S1-11-12,3,4985453
H1S1-11-12,4,4985455
H1S1-11-13,4,4982014
H1S1-11-13,4,4985799
H1S1-11-13,4,4978873
H1S1-11-13,4,4986282
M1S1-04-18,4,5529761
H1S1-11-14,3,4984592
H1S1-11-14,4,4986513
H1S1-11-14,4,4987755
H1S1-11-14,4,4988189
H1S1-11-10,3,4988938
H1S1-11-10,3,4987002
HSU1-02-12,2,5570363
H1S1-11-10,4,4986702
H1S1-11-15,4,4987000
M1S1-09-12,4,5732485
H1S1-11-16,3,4984120
H1S1-11-16,3,4989303
H1S1-11-16,3,4989022
H1S1-11-16,3,4981626
HSTA-03-12,3,5581381
H1S1-11-16,3,4979709
H1S1-11-16,3,4984317
H1S1-11-17,3,4986519
H1S1-11-17,3,4987782
H1S1-11-17,4,4981677
H1S1-11-17,4,4986152
H1S1-11-17,3,4978697
H1S1-11-17,4,4986431
H1S1-11-17,3,4986538
H1S1-11-17,4,4979045
H1S1-11-18,3,4987139
HSU1-03-03,4,5164332
H1S1-11-18,3,4984248
H1S1-11-18,3,4979481
M2S1-08-12,2,5371561
H1S1-11-18,3,4984121
H1S1-11-18,3,4988328
H1S1-11-18,4,4987590
H1S1-11-19,3,4986281
M1S1-04-21,4,5410197
H1S1-11-19,4,4978824
H1S1-11-19,3,4987939
H1S1-11-19,3,4989023
H1S1-12-01,3,4985237
H1S1-12-01,2,4987986
H1S1-12-01,2,4984999
H1S1-12-01,2,4983973
H1S1-12-01,3,4984914
H1S1-12-01,3,4987004
H1S1-12-01,3,4988934
M1S1-04-02,3,5411649
M1S1-01-04,3,5391119
H1S1-12-02,3,4980320
HSU1-04-18,3,5159603
H1S1-12-02,3,4980109
M3S1-10-04,3,4982865
H1S1-12-03,3,4984670
M1S1-02-05,3,5410636
H1S1-12-03,3,4986153
M2S1-08-12,3,5371359
H1S1-12-03,3,4988577
H1S1-12-04,4,4981830
H1S1-12-04,3,4985801
H1S1-12-04,3,4980020
H1S1-12-05,3,4985907
H1S1-12-05,4,4986029
H1S1-12-05,4,4981627
H1S1-12-05,4,4986285
H1S1-12-05,4,4985259
H1S1-12-05,4,4987143
H1S1-12-05,3,4983850
H1S1-12-06,4,4985457
H1S1-12-06,4,4988578
H1S1-05-15,3,5998149
H1S1-12-06,4,4981823
H1S1-12-07,4,4985007
HSU1-02-12,2,5395304
H1S1-12-07,4,4982086
H1S1-12-07,4,4985282
H1S1-12-07,3,4979048
H1S1-12-08,4,4985431
H1S1-12-08,4,4980495
H1S1-12-08,4,4989313
H1S1-12-08,3,4980298
H1S1-12-08,4,4988838
H1S1-12-09,3,4987315
H1S1-12-10,3,4987630
H1S1-12-10,3,4981799
HSU1-08-15,3,5395306
H1S1-12-10,4,4981489
H1S1-12-10,3,4987784
H1S1-12-11,3,4988935
H1S1-12-11,4,4988532
H1S1-12-11,4,4983982
H1S2-01-10,3,5395308
HSU2-01-13,4,5395309
H1S1-12-12,4,4981800
H1S1-12-12,3,4981559
H1S1-12-13,4,4982087
H1S1-12-13,4,4985050
HSU1-01-09,4,5395311
H1S1-12-13,4,4984097
HSU1-08-07,4,5395313
H1S1-12-13,3,4985231
H1S1-12-13,2,4980491
H1S1-12-13,3,4978800
H1S1-12-13,3,4984929
H1S1-01-01,2,4985016
H1S1-01-01,2,4980242
H1S1-01-02,4,4985529
H1S1-01-02,3,4986419
H1S1-01-02,3,4984778
H1S1-01-02,2,4980548
H1S1-01-04,3,4985978
H1S1-01-04,4,4986197
H1S1-01-04,3,4981888
HSU1-10-03,4,5395315
H1S2-05-22,5,5395318
HSU1-01-05,2,5395102
H1S2-02-01,2,5395104
HSU1-08-03,2,5395105
H1S1-01-05,4,4984884
H1S1-01-06,4,4984779
M2S1-06-17,2,5594479
HSU1-08-05,3,5847802
H1S1-02-01,3,4986575
HSU1-02-12,2,5570359
H1S1-02-02,3,4986068
H1S1-02-04,2,4983867
M2S1-09-09,3,3305966
M2S1-05-03,3,5740953
HSU1-10-04,4,5843776
H1S1-02-07,4,4981593
H1S1-02-08,4,4984468
H1S1-02-08,4,4984174
HSU1-07-15,4,5576227
H1S1-02-11,2,4980152
H1S2-05-14,3,266714
H1S1-02-11,3,4984208
M1S1-02-05,3,5413265
H1S1-02-12,2,4986126
M1S1-04-19,3,5415920
H1S1-02-12,3,4979879
M1S1-07-09,3,5414217
HSU1-08-04,3,6065312
H1S1-03-02,4,4984901
H1S1-03-03,3,4986445
H1S1-03-03,3,4985696
H1S1-03-06,3,4980354
H1S1-03-06,3,4982030
H1S1-03-06,4,4987039
M1S1-07-11,3,5412908
H1S1-03-08,4,4980393
H1S2-04-18,3,266715
H1S1-03-09,3,4987115
H1S1-03-10,4,4987113
H1S1-03-10,3,4978575
H1S1-03-10,3,4985830
H1S1-03-10,3,4988495
H1S1-03-10,2,4981737
H1S1-03-10,3,4984695
H1S1-03-10,4,4985530
HSU1-02-06,3,266716
H1S1-04-02,2,4985818
M3S1-11-09,3,4982567
HSU1-11-05,3,266717
H1S2-03-16,3,266718
H1S1-08-20,2,4989297
H1S1-04-03,1,4981954
H1S1-04-05,4,4987124
H1S1-04-05,4,4985709
H1S1-04-05,3,4988951
H1S1-04-05,4,4984852
H1S1-04-05,4,4984744
H1S1-05-10,3,5559594
H1S2-04-10,3,5395106
H1S1-05-05,4,4985708
HSU1-06-25,3,5159859
HSU2-01-02,3,5395107
HCAL-01-08,3,5395108
HCAL-06-01,3,5395109
H1S1-05-12,3,4980552
H1S1-05-13,3,4986636
H1S1-05-13,3,4985742
M1S1-06-07,2,5531756
H1S1-05-14,4,4984757
H1S1-05-15,4,4987699
H1S1-06-01,4,4989103
H1S1-06-01,4,4978896
H1S1-06-02,4,4980446
H1S1-06-03,3,4983644
H1S1-06-03,3,4979781
H1S1-06-04,3,4980160
H1S1-06-04,4,4985386
H1S1-06-05,3,4981782
H1S1-07-01,4,4988807
H1S1-07-04,2,4985884
H1S1-07-10,4,4985719
H1S1-07-10,3,4980562
H1S1-07-10,3,4988350
H1S1-07-10,3,4978899
H1S1-07-10,3,4979650
H1S1-07-10,3,4979434
HSU1-02-03,3,5395111
HSTA-07-13,3,6065549
HCAL-09-10,3,5395112
H1S1-07-11,3,4986395
H1S1-07-12,4,4988964
H1S1-07-12,4,4987231
H1S1-07-13,3,4984892
H1S1-07-13,3,4979025
H1S1-07-14,3,4986459
H1S1-07-14,3,4984791
H1S1-07-15,3,4984752
H1S1-07-16,3,4988265
HSTA-05-08,3,5824969
H1S1-07-21,3,4984900
H1S2-03-07,3,5395131
H1S1-08-08,1,4988311
H1S1-08-08,2,4981614
HCAL-02-01,3,5395140
H1S1-08-12,3,4982010
M2S1-07-21,3,5408605
HSU2-05-16,3,5395142
H1S2-01-09,3,5395143
H1S2-06-07,4,5395144
H1S1-08-13,3,4980161
HSU2-09-06,4,5395147
H1S1-08-14,3,4980302
H1S1-08-14,3,4981890
H1S1-08-14,3,4979034
H1S1-08-14,3,4981554
HSU2-06-04,4,5395149
H1S1-08-21,4,4987933
HSU2-02-06,4,5395151
H1S1-08-24,4,4984692
H1S1-08-24,2,4988813
H1S1-08-24,2,4985387
HSU1-11-11,4,5395153
HSU2-08-10,4,5395154
H1S1-09-02,3,4980209
H1S1-09-02,3,4978796
HCAL-02-16,4,5395155
HCAL-01-04,5,5395156
H1S1-09-06,3,4985003
H1S1-09-06,4,4978926
H1S1-09-06,3,4987319
H1S1-09-06,4,4986449
HSU2-01-06,2,5395158
H1S1-09-07,2,4987052
H1S1-09-09,2,4987578
H1S1-09-10,4,4986427
H1S1-09-10,3,4981527
HSU1-09-04,2,5395159
H1S1-10-01,1,4985446
H1S1-10-01,2,4978812
HSU2-09-12,3,5395161
H1S1-10-02,4,4984662
H1S1-10-02,4,4983859
H1S1-10-03,4,4980307
HSU1-02-02,3,5395163
HSU2-03-12,4,5395164
HSU2-08-02,4,5395166
HSU2-01-16,4,5395167
H1S1-10-07,3,4989263
H1S1-10-08,3,4979041
H1S1-10-09,4,4984540
HSU2-09-03,4,5395169
H1S1-10-10,4,4986280
H1S1-10-10,3,4985651
H1S1-10-10,3,4981668
H1S1-10-11,4,4986587
H1S1-10-11,2,4982005
H1S1-11-01,1,4978695
H1S1-11-01,1,4983972
H1S1-11-01,1,4980204
H1S1-11-01,3,4984261
H1S1-11-01,1,4987991
H1S1-11-01,1,4984378
HSU2-05-10,5,5395171
H1S1-11-04,3,4978871
H1S1-11-05,3,4980322
H1S1-11-07,3,4979961
H1S1-11-12,4,4987009
H1S1-11-13,4,4981797
H1S1-11-13,4,4984868
H1S2-02-01,2,5394899
H1S1-01-01,2,5394901
H1S1-11-10,4,4984318
H1S1-11-10,4,4988386
HSU1-09-01,3,266719
H1S1-11-17,2,4983852
H1S1-12-01,2,5394903
H1S1-11-19,3,4983861
H1S1-09-01,3,5394906
H1S1-03-02,3,5394908
H1S1-11-19,3,4981531
H1S1-11-19,3,4984928
H1S1-12-01,2,4981525
H1S1-02-02,3,5394911
H1S1-10-02,3,5394913
H1S1-11-02,3,5394914
H1S1-12-04,4,4989172
H1S1-12-05,4,4985279
H1S1-12-05,4,4984394
H1S1-12-06,4,4988003
H1S1-12-06,3,4979047
M2S1-06-17,3,5594474
HSU1-07-16,3,5849878
M1S1-06-11,3,5412526
H1S1-12-07,3,4983862
H1S1-12-07,3,4988324
H1S1-12-07,3,4980522
H1S1-12-07,4,4988843
H1S1-12-08,4,4989043
H1S1-12-08,4,4989273
H1S1-12-10,4,4980328
HSU1-02-04,3,5570311
HSU1-05-01,1,5843052
H1S1-01-06,3,4980148
H1S1-01-06,4,4979421
H1S1-01-07,3,4984172
H1S1-01-07,4,4987040
H1S1-01-07,3,4978576
M1S1-02-05,3,5413827
H1S1-01-08,3,4988812
H1S1-01-08,3,4986076
H1S1-01-09,2,4984435
H1S1-02-01,4,4988263
H1S1-02-01,3,4980150
HSU1-06-18,2,5575969
H1S1-02-02,3,4978938
H1S1-02-02,3,4988240
H1S1-02-03,4,4981939
HSTA-07-06,3,6065519
H1S1-02-03,4,4986208
H1S1-02-03,3,4985176
H1S1-02-04,4,4978886
H1S1-02-05,3,4985177
H1S1-02-06,4,4985522
M1S1-04-05,3,5415964
HSU1-05-12,2,5164433
H1S1-02-09,4,4985374
H1S1-02-09,4,4986393
H1S1-02-10,4,4986848
H1S1-02-12,4,4985326
H1S1-02-13,3,4984469
M1S1-07-09,3,5414216
H1S1-02-14,4,4988809
H1S1-02-14,4,4986441
H1S1-03-01,3,4986066
H1S1-03-01,4,4978581
H1S1-03-02,3,4978582
H1S1-03-02,3,4985351
H1S1-03-02,4,4984742
H1S1-03-03,3,4988811
H1S1-03-04,3,4984943
HSU1-03-15,3,6043193
H1S1-03-11,3,4981571
H1S1-03-11,3,4980155
H1S1-04-01,3,4986202
H1S1-04-02,3,4988033
M1S1-03-06,3,5586288
H1S1-04-04,3,4978948
H1S1-04-03,3,4984809
H1S1-04-03,4,4989061
H1S1-04-06,3,4989089
H1S1-04-06,3,4981773
HSU1-05-01,2,5834364
H1S1-04-07,3,4986634
M1S1-01-04,2,5411784
H1S1-04-09,4,4980358
H1S1-04-09,3,4986579
H1S1-04-09,3,4988997
H1S1-05-05,3,4980401
M1S1-09-01,3,5587552
HSU1-03-03,4,5164210
H1S1-05-08,3,4987046
H1S1-05-08,4,4985024
H1S1-05-09,4,4987632
H1S1-05-09,3,4984111
H1S1-05-09,3,4988924
M1S1-07-11,3,5732247
H1S1-05-11,3,4986206
H1S1-05-13,3,4978779
H1S1-05-14,4,4978781
H1S1-05-14,4,4978594
H1S1-05-15,3,4978849
H1S1-06-01,3,4988506
H1S1-06-01,4,4984890
H1S1-06-02,3,4978991
H1S1-06-03,3,4985746
H1S1-06-06,3,4978844
H1S1-06-06,3,4978895
H1S1-06-06,3,4978757
H1S1-06-06,3,4987203
H1S1-06-10,3,4983883
H1S1-06-10,3,4980066
H1S1-06-10,3,4982035
H1S1-07-01,3,4982103
H1S1-07-01,3,4988614
H1S1-07-05,2,4984444
H1S1-07-05,3,4988250
H1S1-07-07,3,4986643
H1S1-07-09,3,4979023
H1S1-07-09,3,4988618
M2S1-04-08,3,5369460
H1S1-07-12,3,4987685
H1S1-07-13,3,4979471
H1S1-07-15,3,4978900
H1S1-07-15,3,4979648
H1S1-07-16,3,4988902
H1S1-08-01,3,4986982
H1S1-08-01,3,4986675
H1S1-08-08,4,4987137
H1S1-08-10,3,4986354
H1S1-08-10,3,4984543
H1S1-08-10,3,4988566
H1S1-08-12,3,4980509
H1S1-08-17,4,4985425
H1S1-08-15,4,4982069
H1S1-08-21,4,4980218
H1S1-08-22,3,4986682
H1S1-08-22,3,4980115
H1S1-08-22,3,4978818
H1S1-08-23,3,4982007
H1S1-08-24,3,4981873
M1S1-05-05,4,5414641
H1S1-09-01,3,4986528
H1S1-09-02,3,4987053
H1S1-09-03,3,4980512
H1S1-09-03,3,4987296
H1S1-09-03,3,4984932
H1S1-09-04,3,4980327
HSU1-11-13,3,5309044
H1S1-09-05,3,4989271
H1S1-09-08,4,4987054
H1S1-09-09,3,4987370
H1S1-09-09,3,4984762
H1S1-07-11,3,4978791
H1S1-09-09,3,4987420
H1S1-09-10,4,4986686
H1S1-09-10,4,4985613
H1S1-09-10,4,4983926
H1S1-09-11,3,4986234
H1S1-09-11,3,4988571
H1S1-09-11,3,4988420
H1S1-10-02,2,4989300
H1S1-10-02,2,4984531
H1S1-10-02,2,4983977
H1S1-10-05,3,4985448
H1S1-10-08,3,4985894
H1S1-10-08,3,4981555
M1S1-04-11,3,5415181
H1S1-10-09,3,4979724
H1S1-10-09,3,4979956
H1S1-10-10,4,4984594
H1S1-10-10,4,4986429
M2S1-02-11,4,5367744
H1S1-10-12,4,4986245
H1S1-10-13,3,4979834
H1S1-10-13,2,4985800
H1S1-10-13,2,4987778
H1S1-09-07,4,4980029
H1S1-10-14,3,4979843
H1S1-11-02,3,4981551
H1S1-11-02,3,4988315
H1S1-11-03,3,4984093
H1S1-11-03,3,4981484
H1S1-11-03,3,4981623
H1S1-11-04,4,4979480
H1S1-11-04,4,4978802
H1S1-04-03,3,5394917
H1S1-11-06,4,4986305
H1S1-11-11,3,4984770
H1S1-11-11,3,4988870
H1S1-11-11,3,4987747
H1S1-11-12,3,4984247
H1S1-08-16,3,5394919
H1S1-11-13,3,4979962
H1S1-11-13,3,4985647
H1S1-11-14,3,4986532
H1S2-03-16,3,5394921
EXEP-01-01,3,5394924
H1S1-07-13,3,5394926
H1S1-10-05,4,5394928
H1S1-06-01,4,5394931
H1S1-07-06,4,5394934
H1S1-11-14,3,4986027
H1S1-11-10,3,4985430
H1S1-10-04,3,4988520
H1S1-11-10,4,4989046
H1S1-11-15,4,4988380
H1S1-11-16,3,4983848
H1S1-11-17,3,4986018
M2S1-02-16,3,3213156
H1S1-12-01,2,4989035
H1S1-12-01,2,4983921
H1S1-12-02,3,4987288
H1S1-12-02,3,4980523
H1S1-12-02,3,4981487
H1S1-12-02,3,4989037
H1S1-12-03,3,4985048
H1S1-12-03,3,4985906
H1S1-12-04,3,4979717
H1S1-12-04,3,4988579
H1S1-12-05,4,4987756
H1S1-12-06,4,4981530
M2S1-03-10,3,3295255
H1S1-12-08,4,4979484
H1S1-12-08,4,4985456
HSU1-08-08,3,5847839
HSU1-04-20,3,5847666
H1S1-12-10,4,4986516
HSU1-07-12,3,5843212
H1S1-12-10,3,4987751
HSU1-06-18,3,5628713
H1S1-12-11,4,4980019
M2S1-02-07,3,5740614
H1S1-01-06,3,4985700
H1S1-01-07,3,4981942
H1S1-01-08,3,4985175
H1S1-02-02,3,4986631
H1S1-02-03,4,4986635
M2S1-01-01,2,5367661
HSU1-10-15,2,6038803
H1S1-02-10,3,4980444
H1S1-02-13,3,4987870
H1S1-03-11,3,4985378
H1S1-04-01,2,4984041
H1S1-04-04,3,4981597
H1S1-04-06,3,4984163
M1S1-06-11,3,5412069
H1S1-05-09,3,4985802
H1S1-05-11,3,4987469
H1S1-05-14,3,4980357
HSU1-01-08,2,5827229
HSTA-07-13,3,6065550
H1S1-06-06,3,4985717
H1S1-06-10,3,4987051
H1S1-07-01,3,4978994
H1S1-07-09,3,4980067
M1S1-08-07,2,6037766
H1S1-07-15,4,4988317
H1S1-08-08,4,4979033
H1S1-08-12,3,4980017
H1S1-08-15,3,4980116
H1S1-08-25,3,4980492
H1S1-09-01,2,4986290
H1S1-09-03,3,4982066
H1S1-09-03,4,4981672
H1S1-09-05,3,4985040
H1S1-09-10,3,4985273
H1S1-09-11,3,4980211
H1S1-10-10,4,4981515
H1S1-10-12,4,4979959
H1S1-10-12,4,4989166
H1S1-10-13,3,4989038
H1S1-10-13,3,4987135
H1S1-10-14,3,4985997
H1S1-11-02,3,4988083
H1S1-11-04,3,4980519
H1S1-11-06,3,4985428
H1S1-11-14,3,4985618
H1S1-11-10,3,4988322
H1S1-11-15,4,4980494
H1S1-12-04,3,4985236
H1S1-12-11,3,4984536
H1S1-12-12,3,4987584
H1S1-01-06,2,4985017
H1S1-02-10,3,4979016
H1S1-02-13,3,4984885
H1S1-04-04,3,4986423
M2S1-06-15,3,5371978
H1S1-05-13,3,4988954
H1S1-08-08,4,4980114
H1S1-08-12,3,4985036
H1S1-09-01,3,4988859
H1S1-09-03,3,4984562
M1S1-06-01,2,5415935
H1S1-09-10,4,4986529
H1S1-09-11,3,4987773
H1S1-10-10,4,4986795
H1S1-10-12,4,4988087
H1S1-10-13,3,4985044
H1S1-10-14,3,4981794
H1S1-11-15,4,4986693
H1S1-12-11,3,4989169
HSU1-11-11,3,5305150
H1S1-09-01,3,4978694
H1S1-09-11,3,4980514
EXEP-01-01,,5380695
HSU1-01-01,3,5305280
HSU1-01-01,1,5304798
HSU1-01-01,3,5306425
HSU1-01-01,1,5308982
HSU1-01-01,5,5308524
HSU1-01-01,3,5306445
HSU1-01-01,3,5309785
HSU1-01-01,3,5309840
M1S1-03-07,3,5413192
M1S1-04-04,3,5411641
HSU1-01-03,4,5309717
HSU1-01-04,3,5309513
HSU1-01-04,2,5309014
HSU1-01-05,4,5309950
HSU1-01-05,3,5309043
H1S1-08-21,3,4985416
HSU1-01-06,4,5310380
HSU1-01-07,3,5308142
HSU1-01-09,4,5305107
HSU1-01-10,4,5306327
HSU1-01-11,4,5308866
HSU1-01-12,3,5310382
HSU1-01-12,3,5307653
EXEP-01-01,4,5394935
EXEP-01-01,4,5394936
H1S1-11-11,4,5394937
H1S1-10-01,4,5394939
HSU1-01-13,3,5308509
HSU1-01-13,3,5305285
H1S1-06-04,5,5394940
HSU1-01-14,4,5306528
HSU1-01-14,3,5306147
HSU1-01-14,4,5307654
HSU1-02-01,3,5305762
HSU1-02-01,2,5305102
HSU1-02-01,3,5308875
HSU1-02-02,4,5352854
HSU1-02-02,3,5309541
HSU1-02-02,3,5309600
HSU1-02-02,4,5306219
HSU1-02-02,3,5309885
HSU1-02-02,3,5306648
HSU1-02-02,3,5309016
H1S2-03-07,2,5394941
H1S1-05-05,2,5394945
HSU1-02-05,4,5308623
H1S1-02-06,3,5394946
H1S1-05-08,3,5394948
H1S1-11-10,4,5394949
H1S2-02-09,4,5394950
HSU1-02-07,4,5306575
H1S1-11-19,4,5394951
H1S1-06-10,4,5394953
H1S1-12-13,5,5394955
HSU1-01-05,2,5394705
HSU1-02-08,4,5308968
H1S2-02-01,2,5394709
HSU1-02-11,3,5305200
HSU1-02-11,3,5306620
HSU2-01-06,2,5394711
HSU1-02-11,4,5306262
HSU1-02-12,3,5310363
HSU1-02-12,3,5306448
HSU1-02-13,3,5308899
HSU1-02-13,3,5307591
HSU1-02-13,4,5307986
HSTA-03-12,3,5394714
HSU2-03-14,3,5394715
HSU1-02-13,3,5307655
HSU1-02-13,3,5307812
HSU1-02-14,4,5309528
HSU2-01-02,3,5394717
H1S2-03-07,3,5394720
HSU2-08-01,3,5394721
HSTA-05-07,3,5394722
H1S2-04-16,3,5394723
H1S2-07-25,3,5394724
H1S2-06-11,3,5394725
HSU1-02-15,4,5310033
HSU1-02-15,3,5309841
HSU1-02-15,3,5308940
HSU1-02-16,4,5304311
HSU1-02-16,4,5309921
HSU1-02-16,5,5307543
HSU1-02-17,3,5305220
M2S1-10-07,3,3305767
HSU1-02-17,3,5305092
HSU1-08-01,2,5841918
HSU1-02-17,3,5309522
HSU1-02-17,3,5306527
HSU1-02-17,3,5307720
HSU1-10-10,3,5827428
HSU1-02-18,4,5306431
M1S1-02-11,4,5393115
M3S1-01-03,3,4976143
M1S1-04-04,3,5415734
M1S1-04-17,3,5411787
H1S1-11-11,3,4982040
HSU1-08-01,3,5310019
HSU1-08-02,3,5309859
H1S1-08-14,3,266720
HSU1-08-03,3,5309036
HSU1-08-03,2,5304926
HSU1-08-03,3,5306241
M1S1-05-02,3,5413239
HSU1-05-10,2,5162067
HSU1-08-04,4,5309870
HSU1-08-05,3,5306469
HSU1-08-05,3,5307796
HSU1-08-06,3,5309380
HSU1-08-07,3,5309714
HSU1-08-07,3,5309974
HSU1-02-04,3,5824045
HSU1-08-07,4,5306589
HSU1-04-20,3,5828692
HSU1-07-08,3,5843214
EXEP-01-01,,5386748
HSU1-08-09,2,5304296
HSU1-08-10,3,5309606
HSU1-08-10,3,5306128
HSU1-08-10,3,5307671
HSU1-08-10,3,5305286
HSU1-08-11,4,5309894
HSU1-08-11,3,5304318
HSU1-08-11,3,5309700
M1S1-01-04,1,6106474
H1S1-08-01,3,4978861
H1S1-08-09,3,5998290
HSU1-07-07,3,5628765
HSU1-08-13,3,5304687
HSU1-08-13,4,5305771
HSU1-08-13,4,5306440
HSU1-08-13,3,5309975
HSU1-08-14,4,5310360
HSU1-08-14,4,5308786
HSU1-08-15,3,5306290
HSU1-08-15,3,5307644
HSU1-08-15,3,5310023
HSU1-08-15,3,5306282
HSU1-08-15,4,5309005
HSU1-09-01,3,5306182
HSU1-08-15,3,5394726
HSU1-09-01,3,5310043
HSTA-03-11,4,5394727
HCAL-02-16,4,5394728
HSU1-09-02,3,5309927
HSTA-06-09,4,5394730
HSU1-09-03,3,5307797
HSU1-09-04,3,5306436
HSU1-09-04,4,5304807
HSU1-09-04,4,5305175
HSU1-09-04,3,5309041
HSU1-09-04,4,5306317
HSU1-09-05,4,5309778
HSU1-09-05,3,5305095
HSU1-09-05,3,5306539
HSTA-02-03,4,5394733
HSU2-05-10,4,5394735
M2S1-02-07,2,6065699
HSU1-09-08,3,5309518
HSU1-11-11,4,5394736
HSU1-09-08,4,5307775
HSU2-07-04,4,5394737
HSU1-09-11,3,5308885
HSU1-09-11,3,5309347
HSU1-09-11,4,5309384
HSU1-09-11,3,5307167
HSU1-09-12,3,5306640
H1S2-07-10,5,5394739
HSU1-09-12,2,5307721
HSU1-09-12,4,5307168
HSU1-09-12,2,5307647
HSU1-09-12,3,5306171
HSU1-08-14,3,6065337
HSU1-10-03,3,5306491
HSU1-10-04,3,5308609
HSU1-10-04,3,5306636
HSU1-10-04,4,5308846
HSU1-10-05,3,5305282
HSU1-10-05,3,5304323
HSU1-05-11,2,5162229
HSU1-10-05,2,5310513
HSU1-10-07,3,5306173
HSU1-10-07,3,5309846
HSU1-10-08,3,5309702
HSU1-10-09,4,5308151
HSU1-10-09,3,5304929
HSU1-09-01,2,5394741
HSU1-10-09,4,5309890
HSU1-10-10,4,5305149
HSU1-10-11,4,5308528
M1S1-06-12,3,5587538
HSU1-10-11,4,5304476
HSU1-10-11,4,5307630
HSU1-10-12,3,5305236
HSU1-10-12,3,5306265
HSU1-10-14,3,5307974
HSU1-10-16,3,5307503
HSU1-11-01,3,5305478
HSU1-11-01,3,5304301
HSU1-11-02,3,5310384
M1S1-07-18,3,5530217
HSU1-11-02,4,5306088
HSU1-05-01,2,5834372
HSU1-11-04,3,5309773
M1S1-05-19,2,3168476
HSU1-11-04,5,5306223
HSU1-11-05,3,5306122
HSU1-11-05,3,5310436
HSTA-02-05,2,5394742
HSU1-11-05,3,5308934
HSU1-11-07,3,5309913
HSU1-11-07,3,5309989
HSTA-07-07,3,5827834
HSU1-11-09,4,5309312
M2S1-07-12,2,5372055
HSU1-11-09,3,5309746
HSU1-11-09,4,5307936
HSU1-02-04,3,5394743
HSU1-11-10,3,5309914
HSU1-11-11,3,5306475
HSU1-11-11,3,5304303
HSTA-04-02,3,5394745
HSU1-11-11,3,5309842
HSU1-10-02,4,5394746
HSU1-11-11,3,5307722
HSU1-11-12,3,5306124
HSU1-11-12,3,5307173
HSU1-11-13,3,5310054
HSU1-11-13,3,5310377
HSU1-11-13,3,5306093
HSU1-11-13,4,5307602
HSU2-02-06,4,5394748
HSU1-01-01,3,5307231
HSU1-01-03,3,5307121
HSU1-01-04,3,5307982
HSU1-01-04,2,5308518
HSU1-01-06,4,5305768
HSU1-01-12,3,5304601
HSU1-01-12,3,5308932
HSU1-01-14,3,5309050
HSU1-02-01,2,5309599
HSU1-02-01,3,5307670
HSU1-02-02,4,5304981
HSU1-02-02,3,5305216
HSU1-02-03,3,5305279
HCAL-10-02,4,5394751
HCAL-01-18,4,5394752
HSU2-08-01,5,5394754
H1S2-07-15,2,5394428
HCAL-03-04,2,5394430
EXEP-01-01,2,5394431
HCAL-09-02,3,5394432
HSTA-04-08,3,5394433
HCAL-04-02,3,5394434
HSTA-03-14,3,5394435
H1S2-04-07,3,266721
M2S1-07-17,3,6037689
M2S1-07-17,3,6037691
HSU1-02-08,3,5309396
HSU1-02-08,3,5310051
HSU1-02-11,4,5309984
HSU1-02-11,4,5305347
HSU1-02-13,3,5309919
HSU1-02-15,3,5309047
HSU1-02-17,3,5308989
HSU1-02-17,3,5309703
HSU1-08-01,2,5841917
M2S1-07-17,3,6037693
M2S1-07-17,3,6037694
HSU1-08-01,3,5306536
HSU1-08-01,2,5309926
M1S1-06-01,3,5415713
M1S1-04-07,3,5415565
HCAL-01-18,4,266722
M1S1-07-10,3,5411347
HSU1-08-05,3,5309286
HSU1-08-07,3,5306169
M1S1-08-04,3,5415356
HSU1-08-11,3,5304465
M1S1-07-09,3,5414315
HSU1-11-05,4,5309720
HSU1-08-13,2,5307814
HSU1-08-13,2,5308961
HSU1-08-13,3,5306516
HSU1-08-15,3,5305288
HSU1-09-01,3,5309691
EXEP-01-01,,5391593
HSU1-09-02,4,5352857
HSU1-09-02,3,5309603
M1S1-06-01,3,5414798
M2S1-09-08,2,5596928
HSU1-09-04,4,5306264
HSU1-09-04,2,5310433
HSU1-09-04,4,5309383
HSU1-04-19,4,5847662
HSU1-06-17,3,5834396
HSU1-09-12,4,5309798
HSU1-09-12,3,5305108
HSU1-10-03,4,5305089
HSU1-10-04,3,5309389
HSU1-10-04,3,5307798
HSU1-10-05,3,5304455
HSU1-10-05,4,5307561
HSU1-10-07,3,5309511
HSU1-10-07,3,5307239
HSU1-10-11,3,5308152
HSU1-10-12,3,5306090
HSU1-10-16,3,5307779
HSU1-11-01,3,5309738
HSU1-11-02,3,5307799
HSU1-11-04,4,5310045
HSU1-11-04,4,5308969
HSU1-11-05,3,5309285
HSU1-11-07,3,5304477
HSU1-07-05,4,5843249
HSU1-11-09,3,5307781
HSU1-11-09,3,5308146
M2S1-01-14,4,6106371
HSU1-11-10,3,5310516
M2S1-05-02,4,5408785
HSU1-11-12,3,5306544
HSU1-11-12,3,5310068
HSU1-11-13,3,5305185
HSU1-11-13,3,5305756
HSU1-11-13,4,5310027
HSU1-01-04,2,5310520
M1S1-01-01,3,6037755
HSU1-01-12,3,5307702
HSU1-01-14,3,5308935
HSU1-02-03,3,5305209
H1S1-08-23,3,4980312
H1S1-08-22,3,5998333
HSU2-07-06,3,5394437
M2S1-07-18,5,5367969
HSU1-05-12,2,5160594
HSU1-02-18,3,5306576
EXEP-01-01,3,5394438
EXEP-01-01,3,5394439
HSU1-08-02,3,5309713
HCAL-05-09,3,5394440
HSU1-08-13,2,5307817
HSTA-06-09,3,5394441
HSU1-09-05,4,5308931
HSU1-09-09,2,5305231
HSU1-10-04,3,5308883
HSU1-10-04,3,5306085
HSU1-10-05,4,5310067
HSU1-10-07,3,5307920
HSU1-10-11,3,5310372
HSU1-11-02,3,5306542
HSU1-11-05,3,5309393
EXEP-01-01,3,5394443
M1S1-05-16,3,5586600
HSU1-11-09,1,5306433
HSU1-03-10,4,5827550
HSU1-11-10,3,5305510
HCAL-10-02,4,5394444
HSU1-01-04,3,5308889
HSU1-03-04,4,5394445
HCAL-07-10,4,5394446
HCAL-05-12,4,5394447
HSTA-02-03,4,5394448
HSU1-09-09,2,5309978
HSU1-10-04,3,5304324
HSU1-10-11,3,5309748
HSU1-11-10,3,5305240
EXEP-01-01,4,5394449
HSU1-09-09,3,5307513
HCAL-07-06,4,5394450
HSU1-03-02,3,5163119
HSU1-03-02,3,5160546
HSU1-03-02,4,5164206
HSU1-03-02,3,5160629
HSU1-03-03,4,5163385
HSU1-03-03,3,5163808
HSU1-03-03,4,5162194
HCAL-04-13,5,5394453
HSTA-02-05,2,5394455
HSU1-03-03,4,5163830
M1S1-08-07,3,6037765
HSU1-03-03,4,5160580
HSU1-03-05,3,5160180
HSU1-03-05,3,5161850
HSU1-03-07,2,5161470
HSU1-03-07,2,5162928
HSU1-03-07,3,5163525
HSU1-03-07,3,5164420
HSU1-03-07,2,5158988
HSU1-03-08,3,5159666
HSU1-03-08,2,5160630
HCAL-05-04,2,5394457
HSU1-03-08,2,5160582
HSU1-03-08,3,5160833
M2S1-03-02,3,5372415
H1S2-07-25,3,5394458
HSU1-03-09,3,5162471
HSU1-03-09,3,5162838
HSU1-03-09,3,5160719
HCAL-10-15,3,5394459
HSU1-03-11,2,5163620
HSU1-03-12,3,5162400
HSU1-03-12,3,5161985
HSTA-04-03,4,5394460
HSU1-03-12,3,5163030
HSU1-03-13,4,5159882
HCAL-10-12,4,5394464
HSU1-03-15,3,5159752
EXEP-01-01,4,5394465
EXEP-01-01,4,5394467
HSU1-03-16,3,5161939
HCAL-09-03,5,5394470
HSU1-03-17,3,5162929
HSU1-03-17,3,5161986
HSU1-03-17,3,5162823
HSU1-03-18,3,5160803
HSU1-01-05,2,5394280
HSU1-03-20,3,5161957
HSU1-03-20,3,5162484
HSU1-03-20,3,5164190
HSU1-03-21,3,5162683
H1S2-02-01,2,5394281
HSU1-03-21,3,5164214
HCAL-01-04,2,5394284
H1S2-04-16,3,5394285
H1S2-04-19,3,5394287
HSTA-02-05,3,5394288
H1S2-02-02,3,5394290
HCAL-01-14,3,5394291
HSU1-04-02,3,5160960
HSU2-02-05,3,5394292
HSU2-01-02,3,5394293
H1S2-07-25,3,5394294
HSU1-04-04,4,5161955
HSU1-04-04,5,5160632
HSU1-04-04,3,5164424
HSU1-04-04,3,5163040
HSU1-04-04,3,5161602
HSU1-04-05,3,5160077
HSU1-04-05,3,5161725
HSU1-04-05,4,5159136
M2S1-10-07,3,3305765
HSU1-04-06,3,5159487
HSU1-04-07,2,5162195
HSTA-07-06,3,6065520
HSU1-04-07,3,5164333
HSU1-04-07,3,5163922
HSU1-04-07,3,5162679
HSU1-04-07,4,5162023
HSU1-01-05,4,266723
M1S1-04-07,3,5415566
HSU1-04-08,3,5159739
HSU1-02-01,2,5570276
HSU1-04-09,4,5164182
HSU1-04-09,4,5161491
HSU1-04-09,4,5161663
HSU1-04-10,4,5159155
H1S2-05-23,4,266724
HSU1-04-11,3,5163402
HSU1-06-17,3,5849770
HSU1-04-11,4,5161811
HSU1-04-12,3,5160631
HSU1-07-07,2,5576064
HSU1-04-15,3,5160586
HSU1-04-15,3,5163168
HSU1-04-15,3,5163103
HSU1-04-17,4,5163552
HSU1-04-18,4,5161294
M2S1-05-03,3,6038085
HSU1-04-19,3,5163077
HSU1-04-19,3,5159161
M2S1-08-01,5,6037700
M2S1-08-01,3,6037702
HSU1-04-21,3,5159719
HSU1-04-21,3,5159443
HSU1-04-21,2,5163813
HSU1-04-21,3,5159162
HSU1-05-01,3,5162172
HSU1-05-02,3,5159812
HSU1-05-02,3,5161325
HSU1-05-03,3,5163085
HSU1-05-03,3,5164550
HSU1-05-03,3,5164431
M2S1-08-04,3,6037706
M2S1-08-04,3,6037707
M2S1-08-04,5,6037709
EXEP-01-01,3,5408784
HSU1-05-05,4,5160549
HSU1-05-05,3,5159200
HSU1-05-05,4,5159403
HSU1-05-05,3,5164432
HSU1-05-05,3,5161607
HSU1-05-10,3,5163392
HSU1-06-13,1,6043225
HSU1-05-06,4,5163669
HSU1-05-06,3,5160103
HSU1-05-06,3,5159622
HSU1-05-06,3,5162983
HSU1-05-06,3,5159397
M1S1-08-01,3,5415355
HSU1-05-07,4,5161542
M1S1-07-09,3,5411591
HSU1-05-08,3,5162174
HSU1-05-08,3,5160084
HSU1-05-08,4,5161822
HSU1-05-08,3,5163108
HSU1-05-09,3,5162235
HSU1-05-10,4,5163819
HSU1-05-12,3,5161561
HSU1-05-11,3,5162013
HSU1-05-12,4,5159451
M1S1-07-14,3,5530332
HSTA-02-08,3,6065491
HSU1-05-12,4,5162018
M2S1-07-04,2,5393441
H1S1-10-04,2,4984565
HSU1-05-13,4,5159608
M1S1-07-01,3,6106443
HSTA-06-10,3,5827828
M1S1-07-18,3,5410288
H1S1-10-07,4,4986530
HSU1-06-05,3,5159449
HSU1-06-05,3,5159199
HSU1-06-05,3,5161889
HSU1-06-05,3,5164337
HSU1-06-06,3,5163124
HSU1-06-06,3,5163314
HSU1-06-06,3,5160454
HSU1-06-06,4,5159609
HSU1-06-06,3,5162919
HSU1-08-01,3,5394295
HSU1-06-07,3,5159732
M2S1-08-05,2,6037712
M2S1-08-05,3,6037714
HSU1-06-10,3,5159747
H1S2-03-07,3,5394296
HSU1-06-10,3,5163916
HSU1-06-10,3,5160641
M2S1-08-05,3,6037716
M2S1-08-05,2,6037717
M2S1-07-15,3,6037719
M2S1-07-15,3,6037721
HSU1-06-13,3,5163833
HSU1-06-04,3,5843124
HSU1-06-16,4,5159432
HSU1-06-16,3,5160672
HSU1-06-16,3,5159242
HSTA-02-03,4,5394297
HSU1-06-16,3,5161953
HSU1-06-18,4,5160455
H1S2-06-07,4,5394298
HSU1-06-21,3,5159497
HSU1-06-21,4,5164080
HSU1-06-22,4,5160566
HSU1-06-22,4,5163538
HSU1-06-23,4,5161972
HSU1-06-23,4,5164560
HSU1-06-23,3,5159450
HSU1-06-24,4,5163182
HSU1-06-24,3,5159761
H1S2-03-06,4,5394300
HSU1-06-24,4,5163039
HCAL-02-16,4,5394301
HSU1-06-25,4,5162068
HSU2-05-04,4,5394302
HSU1-06-26,4,5160596
HSU1-03-02,3,5160383
HSU1-03-04,4,5159236
HSU1-03-04,3,5159420
HSTA-04-09,4,5394305
HSU1-03-04,4,5159751
HSU1-03-04,4,5163031
HSU1-03-06,3,5161810
HSU1-03-06,3,5164399
HSU1-03-06,4,5163386
HSU1-03-06,3,5162196
HSU1-03-06,5,5161958
M2S1-07-15,2,6037723
HSU1-03-07,4,5162663
HSU1-11-05,4,5394306
M2S1-07-15,3,6037726
HSU1-03-12,3,5162427
HSU1-03-16,3,5160961
HSU1-03-16,2,5158987
HSU2-06-01,5,5394309
HSU1-04-01,4,5159710
H1S2-07-15,2,5394310
HSU2-03-11,2,5394311
H1S2-07-17,3,5394312
HSU1-04-04,5,5159211
HSU1-04-06,3,5161620
HSU1-04-06,4,5163683
HSU1-04-06,5,5159828
HSU1-04-07,3,5161534
M2S1-09-15,2,6037733
HSU1-04-11,1,5160203
HSU1-04-11,1,5161977
HSU1-04-11,3,5161846
HSU1-04-11,3,5158986
HSU1-04-18,4,5162033
HSU1-04-18,3,5159134
M2S1-09-15,3,6037735
HSU1-04-21,4,5159605
HSU1-04-21,4,5163743
HSU1-04-21,3,5162833
HSU1-05-03,2,5161982
HSU1-09-01,3,5394313
H1S2-05-15,4,5394315
HSTA-04-02,4,5394316
HSU2-05-17,4,5394318
HSU1-05-07,3,5163982
HSU2-03-08,4,5394320
HSU1-04-11,5,5394323
EXEP-01-01,2,5393973
HSU1-05-08,2,5393975
H1S2-07-15,2,5393980
HSU1-05-08,2,5163120
HSU1-05-08,2,5161848
M2S1-10-15,3,3305867
M2S1-02-16,4,5534612
M1S1-01-02,2,5411645
M1S1-05-19,4,5412155
EXEP-01-01,,5412098
M1S1-05-10,2,5410265
M2S1-07-21,3,5534821
HSU1-04-19,4,5827569
HSU1-05-11,4,5159495
HSU1-05-12,3,5161541
HSU1-05-12,3,5161165
HSU1-06-14,3,5163455
EXEP-01-01,4,5414619
HSU1-06-03,4,5159738
HSU1-04-01,1,5573421
HSU1-06-03,4,5160196
M2S1-02-06,3,6065696
M2S1-09-16,3,6037740
M2S1-10-14,3,6037742
HSU1-06-07,4,5163372
HSU1-06-07,4,5159597
HSU1-06-07,4,5162182
HSU1-11-13,4,5308988
M2S1-06-19,2,6038115
HSU1-06-17,2,5160846
M2S1-08-04,5,6037743
HSU1-06-18,2,5162118
HSU1-06-19,3,5162556
M2S1-08-04,2,6037746
M2S1-03-09,3,5368791
M2S1-07-15,3,6037752
M2S1-07-15,2,6037753
HSU1-06-23,3,5162713
HSU1-06-23,3,5160456
H1S1-04-01,3,4981574
EXEP-01-01,0,5369398
EXEP-01-01,3,5371066
HSU1-06-26,4,5161915
HSU1-06-26,4,5159742
HSU1-03-02,3,5159154
HSU1-03-02,3,5161120
HSU1-03-02,3,5162169
HSU1-03-03,4,5161804
HSU1-03-03,4,5161661
HSU1-03-05,3,5160798
HCAL-03-04,3,5393981
HSU1-03-07,2,5163076
HCAL-03-09,3,5393983
HSU1-03-09,3,5163164
HSU1-03-09,3,5161805
M1S1-06-13,3,5587374
HSU1-03-11,2,5164297
HSU1-07-03,2,5849838
HSU1-09-10,5,6065374
HSU1-03-12,3,5163100
HSU1-03-13,2,5160802
HSU1-03-15,4,5159405
HSU1-03-20,3,5160371
HSTA-02-05,3,5393985
HSU1-03-21,3,5160716
HSU1-04-02,3,5162170
HSU1-04-02,3,5162653
M1S1-01-01,3,6037757
M1S1-01-01,3,6037758
HSU1-04-04,3,5160585
HSU1-04-04,4,5161157
HSU1-04-05,3,5159221
HSU1-04-05,4,5162707
HSU1-04-06,3,5160755
HSU1-04-07,3,5163099
M1S1-01-01,5,6037760
HSU1-04-08,3,5161813
M1S1-05-16,4,3173015
M1S1-01-01,3,6037761
HSU1-04-11,3,5160742
HSU1-04-11,3,5162992
HSU1-04-11,3,5162223
M1S1-01-07,1,6106471
HSU1-04-15,3,5159753
HSU1-04-15,4,5161988
HSU1-04-15,3,5159584
HSU1-04-19,3,5163036
HSU1-04-21,3,5163438
HSU1-04-21,3,5159626
HSU1-05-03,3,5159448
M1S1-01-01,3,6037763
HCAL-04-03,3,5393988
HSU1-05-05,3,5164405
HSU1-05-05,4,5161821
HSU1-05-05,3,5160190
H1S2-07-25,3,5393991
HSU1-05-06,3,5161820
HSU1-05-06,3,5162543
HSU1-05-06,3,5160777
HSU1-05-07,3,5162686
HSU1-05-08,2,5164200
HSTA-04-01,3,5393993
HSTA-04-01,3,5393996
HSU1-05-12,3,5160452
HSU1-05-12,3,5163442
HSU1-05-13,4,5160221
HSU1-06-01,3,5160189
HSU1-06-03,3,5160843
HSU1-06-05,3,5160640
HSU1-06-05,3,5164011
HSU1-06-06,3,5163547
HSU1-06-06,3,5159887
HSU1-06-07,2,5159241
HSU1-06-07,4,5163180
HCAL-06-01,3,5394001
HSU1-06-10,3,5163387
HSU1-06-10,3,5159429
HSU1-06-10,3,5160087
EXEP-01-01,3,5394004
HSU1-06-16,4,5159169
HSU1-06-21,3,5160782
HSU1-06-22,4,5159005
HSU1-06-24,4,5162921
HSU1-06-24,4,5159737
H1S1-01-09,2,5593745
HCAL-06-10,3,5394007
HSU1-06-26,4,5163178
HSU1-03-05,3,5163025
HSTA-03-02,4,5394008
HSU1-03-11,2,5159664
HSU1-03-12,3,5161493
HSU1-03-21,3,5163924
HSU1-04-04,3,5164298
HSU1-04-04,4,5163832
HSU1-04-05,3,5158996
HSU1-04-05,4,5159423
HSU1-04-07,3,5162797
HCAL-05-04,4,5394010
HCAL-08-09,4,5394012
HCAL-06-01,4,5394014
EXEP-01-01,4,5394015
HSU1-06-07,3,5160210
HSU1-06-10,4,5163179
M1S1-08-08,3,6037773
HSU1-06-21,3,5164081
HSU1-06-22,4,5160085
HSTA-03-13,4,5394017
HSU1-06-25,3,5162688
HSU1-03-11,1,5159854
HSU1-04-05,3,5163166
HSU1-04-07,3,5160775
HSU1-05-11,2,5162202
HSU1-06-10,4,5163735
HSU1-06-22,4,5161730
M1S1-01-02,3,5415896
M1S1-01-02,2,5413501
M1S1-01-02,3,5393183
HCAL-09-12,4,5394022
M1S1-01-03,3,5393145
M1S1-01-03,3,5410633
M1S1-08-08,2,6037775
M1S1-08-08,5,6037776
M1S1-01-04,3,5411069
M1S1-08-08,2,6037778
M1S1-01-04,3,5415162
M1S1-08-08,3,6037780
HCAL-07-02,5,5394025
M1S1-01-05,4,5415638
M1S1-01-05,4,5414140
M1S1-01-05,3,5414221
M1S1-01-05,3,5413333
M1S1-01-06,3,5393099
M1S1-01-06,3,5412003
M1S1-01-06,4,5413811
M1S1-01-06,2,5415839
M1S1-01-07,3,5393121
M1S1-08-08,3,6037781
M1S1-08-08,5,6037782
HCAL-04-10,2,5394030
EXEP-01-01,2,5394032
H1S2-07-17,3,5394036
HSU1-01-05,3,5394038
EXEP-01-01,4,5394042
HSTA-02-03,4,5394044
M2S1-07-06,3,3295499
M1S1-08-08,5,6037783
H1S2-06-13,4,266725
M1S1-01-08,4,5410581
M1S1-01-08,4,5413967
M1S1-01-08,4,5413635
M1S1-01-09,4,5410229
M1S1-01-09,4,5413075
M1S1-01-09,4,5393146
M1S1-02-01,2,5413503
M1S1-02-01,2,5413777
M1S1-02-01,3,5411833
M1S1-02-01,3,5415730
M1S1-08-08,2,6037785
M1S1-09-06,3,6037786
M1S1-02-01,3,5414830
M1S1-02-02,2,5415796
M1S1-02-02,3,5411657
M1S1-02-02,3,5412568
M1S1-02-02,2,5415215
M1S1-02-02,2,5410366
M1S1-02-02,2,5415316
M1S1-02-02,2,5391144
M1S1-02-03,2,5414065
M1S1-02-03,3,5413676
HSU1-07-17,2,5834406
M1S1-02-03,2,5416111
M1S1-02-04,4,5413253
M1S1-02-04,3,5414811
M1S1-02-04,3,5415898
M1S1-02-04,4,5411087
M1S1-02-04,4,5413990
M1S1-02-04,3,5413839
M1S1-02-04,3,5414405
M1S1-02-04,4,5411842
M1S1-02-04,3,5413160
M1S1-02-05,3,5393187
HSU1-10-08,4,266726
M1S1-02-05,5,5410929
M1S1-02-06,4,5393125
HCAL-02-16,4,266727
M1S1-02-06,4,5411816
M1S1-02-06,4,5411663
M1S1-02-06,4,5411896
H1S1-08-22,4,266728
M1S1-02-07,3,5415413
M1S1-02-07,4,5414736
H1S2-02-11,5,266729
M1S1-02-07,4,5413557
HSU1-02-03,2,266730
HSU1-08-03,2,266731
M1S1-02-08,3,5413161
M1S1-02-08,3,5410917
HCAL-01-02,3,266732
M1S1-02-08,4,5411615
M1S1-02-08,4,5414029
M1S1-02-08,3,5411819
H1S2-06-11,3,266733
HCAL-02-09,4,266734
HSU1-10-11,4,266735
H1S2-02-15,4,266736
HSU1-02-03,4,266737
H1S2-01-06,5,266738
M1S1-02-09,4,5413649
M1S1-02-09,4,5413285
M1S1-09-12,2,6037788
M1S1-02-09,3,5415799
M1S1-02-10,3,5413616
HSU1-05-08,2,266679
H1S2-07-15,2,266680
HCAL-05-04,2,266681
M1S1-02-11,4,5413446
M1S1-02-11,4,5411864
M1S1-02-11,3,5413636
M1S1-02-11,4,5413284
M1S1-02-12,4,5414181
M1S1-02-12,4,5415501
M1S1-02-12,4,5410136
HCAL-09-06,3,266682
M1S1-02-12,4,5411789
M1S1-02-12,4,5411876
HSU1-03-06,3,266683
M1S1-02-12,4,5415360
M1S1-02-12,4,5411136
M1S1-02-12,5,5414223
M1S1-02-13,3,5411266
M1S1-02-13,3,5415899
HSU1-06-06,3,266684
M1S1-02-13,3,5413358
M1S1-02-13,3,5413282
M1S1-02-13,4,5415625
M1S1-02-13,5,5412076
HSU1-10-02,3,266685
M1S1-02-13,5,5411901
M1S1-02-14,4,5413966
M1S1-02-14,3,5414735
M1S1-02-14,5,5413648
M1S1-02-14,4,5413448
M1S1-03-01,3,5415166
M1S1-03-01,3,5411665
M1S1-09-12,3,6037790
M1S1-03-02,3,5410159
HCAL-07-02,3,266686
M1S1-03-02,3,5410367
HCAL-10-04,3,266687
M1S1-03-03,4,5391102
M1S1-03-03,4,5393190
M1S1-03-03,4,5411639
M1S1-03-03,4,5413751
M1S1-03-03,3,5410368
M1S1-03-03,3,5413863
M1S1-03-04,4,5412505
M1S1-03-04,3,5413506
M1S1-03-04,4,5414912
M1S1-09-12,3,6037791
M1S1-03-05,4,5414637
HCAL-04-04,3,266688
M1S1-03-05,3,5410638
M1S1-03-05,3,5412533
HSU1-04-06,3,266689
H1S2-07-13,3,266690
M1S1-03-06,3,5410730
M1S1-03-07,3,5415371
M1S1-03-07,3,5414832
M1S1-03-07,3,5411805
M1S1-03-07,3,5413661
HCAL-03-07,3,266691
M1S1-03-08,3,5413817
M1S1-03-08,3,5413749
M1S1-03-08,3,5411958
HCAL-06-11,4,266692
HSTA-01-01,4,266693
M1S1-07-10,3,6037793
M1S1-07-10,5,6037794
HCAL-09-10,4,266694
HCAL-04-13,4,266695
M1S1-03-09,3,5411541
M1S1-07-10,3,6037796
M1S1-07-10,2,6037798
M1S1-03-10,4,5411905
HCAL-07-10,4,266696
M1S1-03-10,4,5413795
H1S1-07-21,1,5998093
M1S1-03-10,3,5414759
M1S1-03-10,4,5410908
M1S1-03-10,4,5413463
M1S1-04-01,3,5411547
M1S1-04-01,3,5411822
H1S1-07-21,1,5998094
H1S1-07-21,2,5998095
H1S1-07-21,2,5998096
HCAL-10-12,4,266697
M1S1-04-02,3,5416117
M1S1-04-02,3,5393194
M1S1-04-02,3,5413508
HSTA-02-01,4,266698
H1S1-07-21,3,5998098
M1S1-04-03,3,5413397
H1S1-07-21,3,5998099
M1S1-04-04,3,5415271
HSU2-08-10,5,266699
M1S1-04-04,3,5411248
M1S1-04-04,3,5414380
M1S1-04-04,3,5413398
M1S1-04-05,3,5415170
M1S1-04-05,3,5413491
M1S1-04-05,3,5410342
M1S1-04-06,5,5413465
M1S1-04-07,3,5413331
M1S1-04-07,3,5411644
M1S1-04-07,3,5415268
M2S1-07-18,3,3295509
M1S1-04-07,3,5411373
HSU1-03-16,2,266700
M1S1-04-08,3,5413840
M1S1-04-08,3,5413617
M1S1-04-08,3,5414862
HCAL-04-09,2,266701
M1S1-04-10,3,5411672
HCAL-05-11,3,266702
HSU1-05-06,3,266703
M1S1-04-11,3,5411773
HSTA-01-07,4,266704
M1S1-04-11,3,5413090
H1S1-07-21,3,5998100
M1S1-04-12,3,5413453
M1S1-04-12,4,5413888
M1S1-04-12,3,5413168
M1S1-04-13,3,5413429
M1S1-04-13,3,5413822
M1S1-04-13,4,5415417
M1S1-04-13,3,5414230
M2S1-07-05,3,5594613
HSU1-03-04,4,266705
M1S1-04-14,3,5411671
M1S1-04-16,3,5416081
M1S1-04-16,3,5413400
M1S1-04-16,3,5415735
M1S1-04-17,3,5414385
M1S1-04-17,2,5415274
M1S1-04-17,3,5393117
M1S1-04-17,3,5414429
M1S1-04-17,3,5414362
HCAL-10-06,4,266706
M1S1-04-19,3,5413882
M1S1-04-19,3,5414146
M1S1-04-19,3,5414278
H1S1-07-21,4,5998101
H1S2-07-17,4,266707
M1S1-04-20,3,5414488
M1S1-04-20,3,5411825
M1S1-04-20,3,5393130
M1S1-04-20,3,5415189
M1S1-04-20,3,5410595
M1S1-01-02,2,5411646
HSU1-07-16,2,5834407
HCAL-06-03,5,266708
H1S1-08-25,3,5998103
H1S1-01-01,2,267661
H1S1-08-25,3,5998104
H1S1-08-25,3,5998105
H1S1-08-25,3,5998106
H1S1-09-07,2,267662
H1S1-09-12,3,5998108
M1S1-02-12,4,5414660
H1S1-09-12,3,5998110
H1S1-09-12,3,5998111
M1S1-05-02,3,5411857
H1S1-05-08,2,267663
HSU1-05-09,2,5626697
H1S1-04-02,3,267664
M1S1-05-04,3,5414191
H1S2-06-13,3,267665
M1S1-05-05,3,5414652
M1S1-05-05,3,5413551
M1S1-05-06,3,5410164
M1S1-05-06,3,5414193
M1S1-05-06,3,5416031
M1S1-05-06,3,5410333
M1S1-05-06,3,5413319
M1S1-05-07,3,5412247
HSU1-04-19,3,5824789
M1S1-05-07,3,5413831
M1S1-05-07,4,5414120
HSU1-02-07,4,5309696
HSU1-02-04,3,267666
M1S1-05-08,3,5410662
M1S1-05-08,3,5410572
HSU1-07-07,2,5843215
M1S1-05-08,3,5413845
M1S1-05-09,3,5413437
H1S1-10-15,3,5998115
M1S1-05-10,3,5415568
M1S1-05-10,3,5415286
M1S1-05-11,3,5410648
M1S1-05-11,3,5412728
H1S1-10-15,3,5998116
H1S1-10-15,3,5998117
H1S1-10-15,3,5998118
M1S1-05-13,3,5412539
M1S1-05-13,3,5414390
M1S1-05-13,3,5414545
M1S1-05-13,3,5413515
M1S1-05-13,3,5412944
M1S1-05-15,3,5415570
M1S1-05-17,3,5414818
H1S1-10-15,4,5998120
M1S1-05-17,3,5410575
M1S1-05-18,3,5415569
M1S1-05-19,4,5410357
M1S1-06-01,2,5415760
M1S1-06-01,3,5410167
H1S1-11-07,3,5998121
M1S1-06-02,3,5412708
M1S1-06-02,3,5412166
M1S1-06-02,3,5412917
M1S1-06-02,3,5414870
H1S1-11-07,2,5998122
M1S1-06-02,3,5413851
M1S1-06-03,3,5412677
M1S1-06-03,3,5414043
H1S1-11-07,3,5998123
M1S1-06-03,3,5412352
M1S1-06-04,3,5412701
M1S1-06-04,3,5411105
M1S1-06-04,3,5412148
M1S1-06-04,3,5414606
M1S1-06-05,3,5412513
M1S1-06-06,3,5410781
M2S1-09-12,3,5371440
M1S1-06-06,3,5416086
M1S1-06-06,3,5412205
M1S1-09-02,4,5414620
M1S1-06-07,3,5411101
M1S1-06-08,3,5410609
M1S1-06-08,3,5412946
M1S1-06-08,3,5413849
M1S1-06-09,3,5410611
H1S1-11-07,2,5998124
M1S1-06-09,3,5412042
M1S1-06-09,3,5414161
M1S1-06-10,3,5415927
M1S1-06-10,3,5415200
M1S1-06-10,3,5414331
M1S1-06-11,3,5415573
M1S1-06-11,3,5415154
M1S1-06-12,3,5412043
M1S1-06-12,3,5411104
M1S1-06-12,3,5411294
HSU1-10-02,3,6064433
M1S1-06-13,3,5412254
M1S1-06-13,3,5414162
M1S1-06-14,3,5414787
M1S1-06-14,3,5415201
M1S1-06-14,3,5410404
M1S1-06-15,3,5416148
M1S1-06-15,3,5415647
M1S1-06-15,3,5410255
M1S1-06-16,3,5412974
M1S1-06-16,4,5412454
M1S1-06-16,3,5415870
M1S1-06-16,3,5412877
M1S1-06-16,4,5411513
M1S1-07-01,3,5410148
M1S1-07-02,3,5411396
M1S1-07-02,3,5414791
M1S1-07-03,3,5412496
M1S1-07-04,3,5411576
M1S1-07-04,3,5410847
M1S1-07-04,3,5412059
M1S1-07-04,3,5415872
M1S1-07-05,3,5410786
M1S1-07-06,3,5412922
M1S1-07-06,4,5416089
M1S1-07-08,3,5414452
M1S1-07-08,3,5410209
M1S1-07-08,3,5412111
EXEP-01-01,,5308636
M1S1-05-11,3,5410341
EXEP-01-01,,5349148
M2S1-06-12,3,5370195
H1S1-11-02,3,4985451
H1S1-12-10,3,4980032
H1S1-08-09,3,5998289
EXEP-01-01,4,5394048
HCAL-10-14,4,5394050
HCAL-09-10,5,5394051
HSU1-01-02,2,5395996
H1S2-02-01,2,5395997
HCAL-01-04,2,5395998
H1S2-04-16,3,5396000
HSU1-09-01,3,5396002
HCAL-01-12,3,5396003
H1S2-05-14,3,5396007
H1S2-03-16,3,5396008
HSU1-10-05,3,5396009
H1S2-04-19,3,5396010
H1S2-03-25,3,5396011
HSU1-02-13,3,5396012
HSU1-09-04,3,5396013
HSU2-01-07,4,5396014
HSU2-02-03,4,5396015
HCAL-01-08,4,5396017
HSU1-02-17,4,5396018
HSU1-02-04,4,5396019
M1S1-07-08,3,5412681
M1S1-07-09,3,5412355
H1S2-02-02,3,267667
H1S1-02-06,3,267668
H1S2-02-14,3,267669
HSU1-08-03,3,267670
H1S1-07-12,3,267671
H1S1-03-11,3,267672
H1S1-10-06,3,4978797
H1S1-08-19,3,267673
HSU1-07-01,1,5843187
M1S1-07-11,3,5411912
M1S1-07-11,3,5414206
H1S1-01-07,4,267674
HSU1-09-04,4,267675
HSU1-02-07,4,267676
M1S1-07-12,3,5412923
HSU1-11-11,4,267677
H1S1-11-16,4,267678
M1S1-07-13,3,5415649
H1S2-05-24,4,267679
H1S2-04-14,4,267680
M1S1-07-14,3,5410785
M1S1-07-14,3,5414126
HSU1-10-11,5,267681
H1S1-09-01,2,267682
H1S1-06-06,2,267683
M1S1-07-15,3,5413053
M1S1-07-15,3,5415389
HSU1-10-04,3,267684
M1S1-07-16,3,5412019
M1S1-07-16,3,5412952
HSU1-02-03,3,267685
M1S1-07-16,4,5410848
HSU1-01-13,4,267686
H1S1-02-11,4,267687
M1S1-07-17,3,5410426
M1S1-07-17,3,5415535
M1S1-07-18,3,5414333
H1S1-12-04,4,267688
M1S1-07-18,4,5414522
EXEP-01-01,4,267689
HSU1-04-19,3,5577223
M1S1-07-19,4,5414165
M1S1-07-19,3,5414583
M1S1-07-19,3,5414895
M1S1-07-19,4,5411300
H1S2-03-16,5,267690
M1S1-07-20,3,5410432
H1S1-01-01,2,267631
M1S1-08-01,3,5410343
H1S2-02-01,2,267632
M1S1-08-01,3,5412169
HSU1-01-05,2,267633
H1S1-02-06,3,267634
M1S1-08-03,3,5413219
M1S1-08-03,3,5410854
M1S1-08-03,3,5415298
M1S1-08-03,3,5413034
M1S1-08-04,3,5412113
M1S1-08-04,3,5413210
M1S1-08-04,3,5415299
M1S1-08-04,3,5414897
M1S1-08-04,3,5411338
HSU1-11-05,3,267635
M1S1-08-04,3,5415393
M1S1-08-05,4,5414587
M1S1-08-05,3,5412737
H1S1-09-07,3,267636
M1S1-08-05,3,5411913
M1S1-08-05,4,5410434
M1S1-08-08,3,5412373
H1S1-11-07,3,5998125
H1S1-06-10,3,267637
M1S1-09-02,3,5410290
H1S1-11-07,3,5998126
H1S2-05-16,3,267638
M1S1-09-03,3,5412621
M1S1-09-03,3,5415301
M1S1-09-03,3,5410192
M1S1-09-03,4,5415394
M1S1-09-03,3,5413213
M1S1-09-03,3,5412623
M1S1-09-04,3,5410433
H1S1-07-01,3,267639
M1S1-09-04,3,5410763
M1S1-09-04,2,5412898
M1S1-09-04,3,5410437
H1S1-11-08,3,5998128
M1S1-09-05,3,5410622
EXEP-01-01,3,267640
M1S1-09-05,3,5414131
M1S1-09-05,5,5414901
M1S1-09-05,5,5414104
H1S1-11-08,3,5998129
H1S2-06-15,3,267641
M1S1-09-08,4,5414105
M1S1-09-08,3,5410772
H1S1-11-15,1,5998130
H1S1-12-12,3,267642
H1S2-03-16,3,267643
H1S1-11-15,2,5998131
M1S1-09-09,3,5412625
H1S1-11-15,3,5998133
M1S1-09-09,4,5411520
M1S1-09-09,3,5413211
M1S1-09-09,3,5413116
H1S1-12-09,1,5998134
M1S1-09-10,3,5412174
M1S1-09-10,3,5412464
H1S1-03-10,4,267644
H1S2-02-14,4,267645
M1S1-09-10,4,5412114
H1S1-12-09,2,5998135
H1S1-12-09,3,5998136
HSU1-07-06,1,5843197
H1S1-12-12,2,5998139
M1S1-09-11,4,5415931
M1S1-09-12,3,5415525
M1S1-09-12,4,5415996
M1S1-09-13,3,5410716
M1S1-09-13,3,5412504
M1S1-09-13,3,5412601
M1S1-09-13,3,5415594
HSU1-11-11,4,267646
M1S1-09-13,3,5412717
M1S1-01-01,3,5411951
H1S1-12-03,4,267647
M1S1-01-03,3,5391139
M1S1-01-03,3,5413479
M1S1-01-03,3,5415600
M1S1-01-03,3,5410717
M1S1-01-03,3,5415161
M1S1-01-03,3,5410365
M1S1-01-03,3,5416059
M1S1-01-04,3,5415411
M1S1-01-05,3,5410722
M1S1-01-05,3,5391122
M1S1-01-05,5,5411623
M1S1-01-05,5,5410227
M1S1-01-06,2,5411759
M1S1-01-06,3,5410340
H1S1-12-12,2,5998140
M1S1-01-07,3,5393073
HSU1-09-09,4,267648
M1S1-02-02,3,5413158
M1S1-02-02,3,5413583
M1S1-02-03,3,5416061
M1S1-02-03,3,5413410
HSU1-06-12,3,6043220
M1S1-02-03,3,5393124
M1S1-02-04,4,5411363
H1S1-09-09,4,267649
M1S1-02-06,4,5414377
H1S1-12-12,3,5998142
M1S1-02-09,5,5416008
M1S1-02-13,5,5413871
H1S1-12-12,3,5998143
M1S1-02-14,4,5415798
M1S1-03-01,3,5391148
H1S1-05-15,1,5998144
M1S1-03-02,3,5413487
M1S1-03-02,3,5411631
M1S1-03-02,3,5415142
EXEP-01-01,3,5369401
M1S1-03-03,4,5414276
M1S1-03-03,4,5413794
M1S1-03-03,3,5413540
M1S1-03-04,4,5411986
M1S1-03-05,5,5411824
M1S1-03-05,3,5393127
H1S1-05-15,1,5998145
H1S1-05-15,2,5998147
H1S1-05-15,3,5998148
M1S1-03-07,3,5410567
M1S1-03-07,3,5414226
H1S1-06-03,1,5998150
H1S1-06-03,2,5998151
M1S1-04-04,3,5416070
HSU1-06-25,2,5161176
M1S1-07-06,3,5587230
HSU1-07-07,4,5628764
M1S1-03-09,1,6106466
M1S1-01-07,1,6106473
M1S1-04-04,3,5413686
M1S1-04-04,3,5412534
M1S1-04-09,5,5416119
M2S1-07-05,3,5534785
H1S1-06-03,2,5998152
M1S1-04-12,3,5415614
M1S1-04-12,4,5415172
HSU1-10-10,4,267650
M1S1-04-12,3,5415184
M1S1-04-12,3,5413875
M1S1-04-12,3,5415190
M1S1-04-12,3,5413245
M1S1-04-13,3,5413195
M1S1-04-13,3,5412603
M1S1-04-13,3,5413413
H1S1-06-03,3,5998153
M1S1-04-14,4,5411892
H1S2-02-01,5,267651
M1S1-04-15,3,5391111
M1S1-04-15,3,5411642
H1S1-06-03,3,5998154
M1S1-04-15,3,5415613
M1S1-04-16,4,5413652
M1S1-04-16,3,5413511
M1S1-04-17,2,5412756
M1S1-04-17,2,5410565
M1S1-04-17,2,5411827
HSU1-02-03,2,267652
M1S1-04-18,4,5414384
M1S1-04-18,4,5411252
M1S1-04-18,4,5410741
M1S1-04-20,3,5413994
M1S1-04-20,3,5411957
H1S1-05-08,2,267653
H1S1-06-04,1,5998155
M1S1-04-21,4,5413706
M1S1-05-01,3,5415958
M1S1-05-01,3,5415695
M1S1-05-01,3,5412695
M1S1-05-02,3,5414716
M1S1-05-14,4,5393144
M1S1-05-06,3,5412079
M1S1-05-06,3,5410202
M1S1-05-06,3,5414745
HSU1-06-18,3,5843147
H1S1-06-04,2,5998157
M1S1-02-09,3,5415963
M1S1-05-09,3,5415863
M1S1-05-10,3,5415751
H1S1-06-04,3,5998159
M1S1-05-12,2,5411998
H1S1-06-05,1,5998161
H1S1-06-05,2,5998162
M1S1-05-13,3,5412590
M1S1-05-17,3,5414366
M1S1-05-17,3,5414122
M1S1-05-18,4,5391117
H1S1-06-05,3,5998163
M1S1-05-19,4,5410394
H1S1-08-05,3,5998164
M1S1-06-02,3,5411401
M1S1-06-04,3,5410668
HSU1-04-18,3,5828636
M1S1-06-04,3,5412918
M1S1-06-04,3,5410204
M1S1-06-05,3,5412614
M1S1-06-05,3,5415867
M1S1-06-05,3,5414329
M1S1-06-05,3,5410146
M1S1-06-05,3,5412916
M1S1-06-05,3,5413049
M1S1-06-05,3,5410866
M1S1-06-05,3,5412349
M1S1-06-06,3,5414893
M1S1-06-06,3,5412441
M1S1-06-07,3,5413138
H1S1-08-05,3,5998166
M1S1-06-09,3,5414871
M1S1-06-12,3,5415869
M1S1-06-14,3,5412515
M1S1-06-14,3,5412711
M1S1-06-14,3,5415574
M1S1-06-15,3,5414892
M1S1-06-16,3,5412061
H1S1-08-05,3,5998168
M1S1-07-01,2,5412807
M1S1-07-06,4,5414204
M1S1-07-12,4,5412598
M1S1-07-12,3,5410704
M1S1-07-15,3,5412112
H1S1-08-05,3,5998169
M1S1-07-17,4,5415670
M1S1-07-17,5,5410261
M1S1-07-17,2,5414296
M1S1-07-19,3,5415533
M1S1-07-19,4,5412544
M1S1-07-19,4,5412423
M1S1-07-21,2,5412014
H1S1-08-05,3,5998171
M1S1-07-21,3,5410625
M1S1-08-01,3,5416093
M1S1-08-03,3,5414590
M1S1-08-03,3,5410154
M1S1-08-05,4,5415930
M1S1-08-05,4,5414608
M1S1-08-05,4,5415655
M1S1-08-05,4,5414302
M1S1-08-05,3,5414051
M1S1-09-01,3,5412331
H1S1-08-05,3,5998172
M1S1-09-02,4,5415398
H1S1-08-05,3,5998173
H1S1-08-05,4,5998174
M1S1-09-03,3,5412769
M1S1-09-03,3,5412064
M1S1-09-04,3,5410770
M1S1-09-04,3,5412501
H1S1-08-05,4,5998176
H1S1-08-06,3,5998177
H1S1-08-06,3,5998178
M1S1-09-10,3,5411582
M1S1-09-10,3,5416155
M1S1-09-10,4,5416096
M1S1-09-10,4,5411314
M1S1-01-02,2,5413885
M1S1-01-02,3,5413279
M1S1-01-05,4,5414354
M1S1-01-05,4,5413584
M1S1-01-06,2,5411948
M1S1-01-06,3,5391143
M1S1-01-06,4,5413716
M1S1-01-07,3,5414375
H1S1-08-06,3,5998179
H1S1-08-06,3,5998180
M1S1-01-08,4,5410306
M1S1-01-08,4,5413076
M1S1-01-09,4,5412004
M1S1-02-01,3,5413675
H1S1-08-06,3,5998182
M1S1-02-02,2,5411757
M1S1-02-03,3,5413308
M1S1-02-05,3,5415951
M1S1-02-05,3,5412006
M1S1-02-06,4,5410557
M1S1-02-06,3,5413485
M1S1-02-07,4,5411985
M1S1-02-07,4,5415844
M1S1-02-07,4,5414356
M1S1-02-08,3,5393123
M1S1-02-11,4,5413537
HSU1-11-08,4,5843830
HSU1-07-02,2,5628741
EXEP-01-01,3,5414749
EXEP-01-01,3,5412632
M1S1-05-11,3,5414918
HSU1-06-09,3,6065261
M2S1-10-11,3,5371086
H1S1-10-12,4,4984726
H1S1-12-07,2,6106483
HCAL-01-17,4,5396021
HSU1-11-13,4,5396022
HCAL-02-16,5,5396024
HSU2-01-06,2,5396026
HSU1-02-03,2,5396027
HCAL-02-04,3,5396028
H1S2-02-14,3,5396029
HSU1-10-09,4,5396030
HSU1-10-03,4,5396031
HSU1-11-08,4,5396032
HSU1-10-11,4,5396036
HSU1-09-05,5,5396037
HSU1-01-05,2,5395910
HCAL-01-04,2,5395911
H1S2-02-02,2,5395912
HSU1-09-04,3,5395913
H1S2-06-07,3,5395914
HCAL-01-02,3,5395915
HSU1-02-03,3,5395916
H1S2-03-16,3,5395918
H1S2-05-16,3,5395919
H1S2-04-22,3,5395921
HSU2-01-02,3,5395922
M1S1-02-11,4,5410278
M1S1-02-11,4,5413570
M1S1-02-14,4,5411780
M1S1-02-14,4,5414852
M1S1-03-01,3,5413972
HSU1-08-03,3,267654
M2S1-07-01,3,5594512
H1S1-08-06,3,5998183
H1S1-08-06,3,5998184
H1S2-04-19,3,267655
M1S1-03-07,3,5393192
M1S1-03-09,5,5410568
EXEP-01-01,4,267656
H1S1-08-06,3,5998185
M1S1-03-10,4,5415689
HSU1-07-16,3,6038661
H1S1-08-07,3,5998188
M1S1-02-13,5,5415331
M1S1-04-02,3,5415804
M1S1-04-02,3,5410379
M1S1-04-05,3,5393081
M1S1-04-05,3,5414626
M1S1-04-05,3,5410561
M1S1-04-06,5,5411866
M1S1-04-08,3,5411807
M1S1-04-08,3,5413401
M1S1-04-08,3,5412556
M1S1-04-10,3,5411762
M1S1-04-10,3,5410330
M1S1-04-11,3,5412312
M1S1-04-13,3,5415272
M1S1-04-13,3,5414539
M2S1-07-17,3,3295507
M1S1-04-19,3,5410381
M1S1-04-19,3,5391109
M1S1-04-20,3,5415629
M1S1-04-20,3,5410346
H1S1-08-07,3,5998191
M1S1-04-11,3,5411151
H1S1-08-07,3,5998192
H1S1-08-07,3,5998193
EXEP-01-01,,5393179
M1S1-05-05,3,5410743
M1S1-05-05,3,5413975
M1S1-05-06,3,5414495
M1S1-05-08,3,5412051
H1S1-08-07,3,5998195
HSU1-11-05,4,5576110
M1S1-05-10,3,5412698
M1S1-06-04,3,5414106
M1S1-05-11,3,5415287
M2S1-02-06,3,6065695
M1S1-05-13,3,5410166
M1S1-05-13,3,5412105
M1S1-06-01,2,5412163
M1S1-06-02,3,5415290
M1S1-05-06,3,5415711
M1S1-06-03,3,5413137
H1S1-03-07,3,5998199
M1S1-06-05,3,5410666
M1S1-06-06,3,5415976
M1S1-06-08,3,5413050
M1S1-06-08,3,5415291
M1S1-05-16,3,5412593
M1S1-06-08,3,5416159
H1S1-05-06,3,5998200
M1S1-06-10,3,5413103
M1S1-06-11,3,5412173
M1S1-06-12,3,5411296
M1S1-06-12,3,5415293
M1S1-06-12,3,5410147
M1S1-06-13,3,5410871
M1S1-06-14,3,5414251
M1S1-06-15,3,5414332
M1S1-06-15,3,5414164
M1S1-06-15,3,5412487
M1S1-06-16,3,5414345
M1S1-06-16,3,5412517
M1S1-07-01,2,5411574
M1S1-07-03,3,5411911
M1S1-07-09,3,5414520
M1S1-07-10,4,5412977
H1S1-05-06,4,5998201
M1S1-07-13,4,5412060
M1S1-07-14,3,5412894
M1S1-07-16,3,5412494
M1S1-07-16,3,5412879
M1S1-07-17,4,5415770
M1S1-07-18,3,5410874
M1S1-07-20,3,5412765
M1S1-08-01,3,5415297
M1S1-08-01,3,5410211
M1S1-08-02,3,5412332
M1S1-08-03,3,5415664
M1S1-08-03,3,5415986
M1S1-08-03,3,5412749
M1S1-08-04,3,5411578
M1S1-08-04,3,5410762
H1S1-05-06,3,5998202
M1S1-09-03,3,5414899
M1S1-09-03,4,5416156
M1S1-09-05,3,5410767
H1S1-05-06,3,5998203
M1S1-09-08,4,5412933
H1S1-05-06,3,5998204
M1S1-09-08,4,5410795
M1S1-09-08,4,5415399
H1S1-05-07,3,5998205
M2S1-02-07,3,5740630
M1S1-09-09,3,5412567
H1S1-05-07,3,5998207
H1S1-05-07,3,5998208
H1S1-05-07,3,5998209
M1S1-09-13,3,5410711
M1S1-09-13,3,5412842
M1S1-09-13,3,5410789
M1S1-09-13,3,5412088
M1S1-01-02,3,5413555
M1S1-01-08,4,5412591
M1S1-01-09,4,5413536
HSU1-06-07,3,5164439
M1S1-02-10,4,5414709
M1S1-02-14,4,5415606
M1S1-02-14,4,5411369
M1S1-03-01,3,5416009
M1S1-03-09,5,5413818
M1S1-04-05,3,5393108
M1S1-04-06,5,5411374
M1S1-04-07,3,5415907
M1S1-04-08,3,5414632
M1S1-04-08,3,5410590
M1S1-04-08,3,5414279
M1S1-04-10,3,5410737
M1S1-04-10,3,5415498
H1S1-05-11,3,5998210
EXEP-01-01,0,5306183
M1S1-04-13,3,5414540
M1S1-04-14,3,5415632
M1S1-04-19,3,5393110
M1S1-05-05,3,5414496
M1S1-05-05,3,5414820
M2S1-09-09,1,5393701
M1S1-05-08,3,5411281
M1S1-05-11,3,5412832
M1S1-05-11,3,5414838
H1S1-05-11,3,5998213
M1S1-05-15,3,5410337
M2S1-07-08,3,5367258
HSU1-10-15,4,5842997
HSTA-06-04,3,5827801
M1S1-01-07,1,6106470
H1S1-01-09,2,5593743
H1S1-08-09,3,5998300
HSU1-02-17,3,5395923
HSU1-01-05,3,5395924
HSU1-10-12,4,5395925
HSU1-10-09,4,5395926
HSU2-02-06,4,5395927
H1S2-05-22,4,5395928
HSU1-11-11,4,5395929
HCAL-01-17,4,5395930
HCAL-02-16,4,5395931
HSU2-02-06,5,5395932
HSU1-08-03,2,5395933
HSU1-02-03,2,5395934
HSU2-01-13,3,5395935
H1S2-04-10,3,5395936
H1S2-02-01,4,5395937
HCAL-01-04,4,5395939
H1S2-02-14,4,5395940
HSU1-10-02,4,5395941
HSU2-01-16,5,5395945
HSU2-01-16,2,5395649
H1S1-04-02,2,5395650
H1S1-02-06,2,5395651
H1S1-08-12,3,5395652
H1S1-02-01,3,5395653
H1S1-03-11,3,5395654
H1S1-08-08,3,5395656
H1S1-03-02,3,5395657
M1S1-05-17,3,5414550
M1S1-06-03,3,5414249
M1S1-06-08,3,5410758
M1S1-06-10,3,5412878
M1S1-06-11,3,5410425
M1S1-06-12,3,5415648
M1S1-06-15,3,5416088
M1S1-07-04,3,5412893
M1S1-07-04,3,5414792
HSU1-01-09,4,267657
H1S2-04-14,4,267658
M1S1-07-13,3,5414584
M1S1-07-14,3,5410615
M1S1-07-20,3,5412403
M1S1-08-01,3,5414342
M1S1-08-01,3,5410409
HSU1-10-08,4,267659
M1S1-08-03,3,5414883
M1S1-09-05,3,5412334
M2S1-02-16,4,3213151
M1S1-09-08,4,5413036
H1S1-06-04,5,267660
H1S1-05-11,3,5998214
M1S1-03-01,3,5411852
M1S1-04-11,3,5414826
M1S1-05-05,3,5411278
M1S1-05-05,3,5410331
M1S1-06-10,3,5411335
EXEP-01-01,2,267251
M1S1-07-09,3,5414335
M1S1-07-13,3,5412680
M1S1-07-20,3,5413029
M1S1-08-01,3,5410883
M1S1-08-02,3,5410797
H1S1-05-12,3,5998215
M1S1-05-05,3,5410230
M1S1-05-05,3,5412996
M1S1-07-06,3,5411402
M1S1-07-09,3,5410186
M1S1-08-02,3,5414300
HSU1-06-18,2,5843139
M2S1-01-02,3,5368413
M2S1-01-02,3,5369809
M2S1-01-02,3,5372912
M2S1-01-02,3,5409941
M2S1-01-02,3,5369514
M2S1-01-03,3,5367082
M2S1-01-03,3,5372881
M2S1-01-04,5,5408808
M2S1-01-04,3,5369723
M2S1-01-04,3,5372909
M2S1-01-04,3,5370769
M2S1-01-04,3,5368928
M2S1-01-04,3,5370897
M2S1-01-04,4,5369527
M2S1-01-04,5,5371402
M2S1-01-05,3,5370372
M2S1-01-05,2,5408555
M2S1-01-05,3,5372369
M2S1-01-05,2,5368922
M2S1-01-05,3,5368149
M2S1-01-06,3,5408735
EXEP-01-01,2,267252
M1S1-02-12,5,5414369
M2S1-01-06,3,5368780
M2S1-01-06,3,5393278
M2S1-01-06,4,5369483
M2S1-01-06,4,5371191
M2S1-01-06,4,5368514
M2S1-01-07,4,5370157
M2S1-01-07,4,5369890
M2S1-01-07,4,5370965
M2S1-07-13,3,5538095
M2S1-01-07,4,5370385
M2S1-01-08,2,5369479
M2S1-01-08,2,5370773
M2S1-01-08,2,5369721
M2S1-01-08,2,5369641
H1S1-05-12,3,5998216
M2S1-01-09,3,5367657
M2S1-01-09,3,5368186
M2S1-01-09,3,5369829
M2S1-01-09,3,5371271
M2S1-01-09,3,5368634
M2S1-01-10,3,5408518
M2S1-01-10,3,5369887
M2S1-01-10,3,5368794
M2S1-01-10,3,5367508
M1S1-09-02,4,5412434
H1S1-06-07,3,5998217
M2S1-01-11,3,5367129
HSU1-04-17,3,5847659
M2S1-01-11,3,5371384
M2S1-01-11,2,5369193
H1S1-06-07,3,5998218
M2S1-01-11,3,5368513
H1S1-06-07,3,5998219
M2S1-01-12,4,5369084
M2S1-01-12,3,5371962
M2S1-01-12,4,5408680
M2S1-01-12,3,5372823
M2S1-01-12,3,5370687
M2S1-01-12,5,5369845
M2S1-01-13,3,5367715
HSU1-11-04,3,5843815
M2S1-01-13,3,5372018
M2S1-01-13,3,5367515
H1S1-06-07,4,5998221
H1S1-06-07,3,5998222
HSU1-07-02,3,5843192
M2S1-01-14,3,5370012
M2S1-01-15,3,5367083
M2S1-01-15,3,5369671
HSU1-07-10,3,6038711
M2S1-01-16,3,5372484
M2S1-01-16,3,5408698
M2S1-01-16,3,5369526
M2S1-01-16,3,5369087
M2S1-01-16,3,5369741
M2S1-01-16,5,5368636
M2S1-01-17,2,5371640
M2S1-01-17,3,5371482
M2S1-01-17,3,5369538
M2S1-01-17,3,5408517
M2S1-01-17,3,5371187
M2S1-01-17,3,5371238
M2S1-01-17,3,5367712
H1S1-06-08,5,5998224
M2S1-02-01,3,5371807
M2S1-02-01,2,5393493
H1S1-06-08,4,5998225
H1S1-06-08,3,5998226
M2S1-02-02,3,5368464
M2S1-02-02,4,5372793
H1S1-06-09,3,5998227
M2S1-02-03,3,5408519
H1S1-06-09,4,5998228
M2S1-02-04,3,5393711
M2S1-02-04,4,5406469
M2S1-02-04,3,5370778
M2S1-02-05,3,5372024
M2S1-02-05,3,5406445
M2S1-02-05,3,5369540
M2S1-02-05,3,5369414
M2S1-02-06,4,5367724
H1S1-06-09,3,5998229
M2S1-02-08,3,5368796
M2S1-02-08,3,5372358
M2S1-02-08,4,5372025
M2S1-02-08,4,5372263
M2S1-02-08,3,5367421
M2S1-02-09,3,5367723
M2S1-02-09,3,5367981
M2S1-02-09,3,5408521
M2S1-02-09,3,5372825
M2S1-02-09,4,5371488
M2S1-02-09,4,5367934
H1S1-06-09,3,5998230
M2S1-02-11,4,5370776
M2S1-02-11,3,5372658
M2S1-02-11,3,5372023
M2S1-02-11,3,5369690
M2S1-02-11,3,5371806
M2S1-02-11,4,5369501
M2S1-09-09,3,5393703
M2S1-02-13,3,5393494
M2S1-02-13,4,5369095
HSU1-05-09,2,5158999
M2S1-02-14,4,5371618
M2S1-02-14,3,5408585
M2S1-02-14,3,5370376
M2S1-02-14,3,5372587
M2S1-02-14,3,5369894
M1S1-08-02,2,5587645
M2S1-02-15,3,5368371
M2S1-02-15,3,5369681
M2S1-02-15,3,5372717
M1S1-05-11,3,5415753
HSU1-03-11,4,5573387
M1S1-04-21,1,6106458
M2S1-02-17,3,5594029
HSU1-06-18,2,5843138
M2S1-02-16,3,5368936
M2S1-03-04,3,3295216
M2S1-02-17,3,5393498
M2S1-02-17,3,5393641
HSU1-07-15,1,6038681
M2S1-03-02,3,5368641
M2S1-03-03,3,5371990
HSU1-05-07,3,5843061
M2S1-03-03,3,5372145
M2S1-03-04,4,5369956
M2S1-03-04,4,5368520
M2S1-03-04,4,5371014
HSU1-04-16,3,5847652
M2S1-03-05,3,5370780
HSU1-11-03,3,5824488
M2S1-03-05,3,5367649
M1S1-02-10,4,5412605
M2S1-03-05,3,5370332
M2S1-03-06,3,5371811
M2S1-03-06,3,5368643
HSU1-09-10,5,6065375
M2S1-03-07,3,5368604
H1S1-06-09,3,5998231
M2S1-03-07,3,5368726
M2S1-03-09,3,5369902
M2S1-03-09,3,5370334
M2S1-03-09,3,5369674
M2S1-03-09,3,5372786
M2S1-03-09,3,5371013
M2S1-03-09,3,5409907
M2S1-03-09,4,5372361
EXEP-01-01,3,5369400
M2S1-03-10,4,5372251
EXEP-01-01,3,5415936
M1S1-05-17,3,5393180
M2S1-03-11,3,5372492
M2S1-03-11,3,5372828
M2S1-03-12,3,5372030
M2S1-03-13,3,5370909
HSU1-05-12,3,5162482
M2S1-03-14,3,5371532
M2S1-04-01,2,5371549
M2S1-04-02,3,5370421
M2S1-04-02,3,5367163
H1S1-06-09,3,5998232
M2S1-10-15,2,5372575
HSU1-07-04,3,5628743
M2S1-04-03,3,5367103
M2S1-04-03,3,5367544
M2S1-04-03,3,5371930
M2S1-04-03,3,5368656
M2S1-04-04,3,5370017
M2S1-04-04,3,5367240
M2S1-04-04,4,5367263
M2S1-04-04,4,5371093
M2S1-04-04,4,5371851
M2S1-04-04,3,5372558
M2S1-04-05,3,5369458
EXEP-01-01,3,5848196
M2S1-04-05,3,5367053
M2S1-04-05,3,5367106
M2S1-04-06,3,5370660
M2S1-04-06,3,5393249
M2S1-04-06,3,5370423
M2S1-04-06,4,5370451
M2S1-04-06,3,5409873
M2S1-04-06,3,5367052
M2S1-04-06,3,5369754
M1S1-09-06,3,3172904
M2S1-04-07,3,5367105
H1S1-06-09,3,5998233
M2S1-04-07,3,5372512
M2S1-04-07,3,5368986
M2S1-04-07,3,5372268
M2S1-04-07,3,5371040
M2S1-04-07,3,5369355
HSTA-05-05,3,5827773
M2S1-04-09,3,5368072
M2S1-04-09,3,5370592
M2S1-04-09,3,5408609
M2S1-04-09,3,5370751
M2S1-04-10,3,5368894
M2S1-04-10,3,5367396
M2S1-04-10,3,5408653
M1S1-09-08,4,5412413
M2S1-04-11,4,5371325
M2S1-04-11,3,5372117
M2S1-04-11,4,5372560
M2S1-04-12,3,5370793
M2S1-04-12,4,5369913
M2S1-04-12,4,5369459
M2S1-04-12,3,5370039
H1S1-01-09,2,5639130
M2S1-04-13,3,5371381
M2S1-04-13,3,5367381
M1S1-07-08,3,5412935
M2S1-04-13,4,5368071
M2S1-04-13,4,5370642
M2S1-04-14,4,5371372
M2S1-04-14,4,5370720
M2S1-04-14,3,5367169
M2S1-04-14,3,5372219
M2S1-05-01,3,5370349
M1S1-06-15,3,5412764
EXEP-01-01,,5383232
M2S1-01-11,3,5409901
M2S1-05-04,3,5371859
M2S1-05-04,3,5406432
H1S1-07-11,3,4985707
M2S1-05-04,3,5368999
M2S1-05-04,3,5372381
M2S1-05-05,4,5369914
M2S1-05-05,4,5370757
M2S1-05-06,3,5370286
M2S1-05-06,3,5370711
HSTA-05-05,4,4134578
H1S1-03-07,3,5998198
H1S1-07-01,3,5395658
H1S1-01-07,3,5395659
EXEP-01-01,3,5395660
M2S1-05-07,3,5368663
M2S1-05-07,3,5368112
H1S1-07-01,3,5395661
H1S1-07-08,3,5998235
H1S1-06-02,3,5395662
M2S1-05-08,3,5369170
M2S1-05-08,3,5368548
H1S1-06-06,4,5395663
H1S1-07-20,5,5998238
H1S1-04-08,4,5395664
H1S1-05-10,4,5395665
H1S1-04-05,4,5395666
M2S1-05-10,4,5372736
M2S1-05-10,4,5370134
M2S1-05-10,4,5371861
M2S1-05-11,3,5372598
M2S1-05-12,3,5371101
EXEP-01-01,4,5395667
M2S1-06-01,5,5370381
M2S1-06-01,3,5370242
M2S1-06-01,3,5372316
M2S1-06-01,3,5368950
M2S1-06-01,3,5393512
M2S1-06-02,4,5370271
M2S1-06-02,3,5368201
M2S1-06-02,3,5393513
M2S1-06-02,3,5372920
M2S1-06-02,3,5367993
M2S1-06-02,4,5370169
M2S1-06-02,4,5372467
M2S1-06-03,3,5368612
M2S1-06-03,3,5369103
M2S1-06-03,3,5371307
M2S1-06-03,4,5369609
M2S1-06-03,3,5393730
M2S1-06-03,3,5393647
M2S1-06-04,3,5367194
H1S1-07-20,3,5998240
H1S1-05-13,4,5395668
H1S1-01-08,4,5395670
H1S1-08-03,5,5395674
M2S1-06-05,3,5368203
M2S1-06-05,3,5406419
M2S1-06-05,3,5372500
M2S1-06-06,3,5409867
H1S1-07-20,3,5998243
H1S1-07-20,3,5998246
H1S1-04-02,2,5395676
M2S1-06-06,4,5368738
M2S1-06-07,2,5368874
H1S1-07-20,3,5998247
H1S1-01-02,2,5395679
M2S1-06-07,3,5372178
M2S1-06-07,4,5408637
H1S1-08-20,3,5395684
H1S1-05-08,3,5395685
H1S1-02-06,4,5395686
H1S1-06-06,4,5395688
EXEP-01-01,4,5395689
H1S1-06-10,4,5395691
H1S1-07-21,4,5998248
M2S1-06-09,3,5370247
M2S1-06-09,3,5371979
H1S1-07-21,3,5998249
M2S1-06-09,3,5372366
M2S1-06-09,3,5372317
M2S1-06-09,4,5372724
M2S1-06-09,3,5367099
M2S1-06-10,3,5368220
M2S1-06-11,3,5372597
M2S1-06-11,3,5371312
M2S1-06-12,3,5393422
H1S1-07-21,3,5998250
H1S1-07-21,3,5998251
H1S1-07-21,3,5998253
M1S1-04-15,3,5412047
M2S1-06-13,3,5369104
M2S1-06-13,3,5368437
M2S1-06-14,4,5406423
HSU1-02-01,1,5570272
M2S1-06-14,4,5369828
M2S1-07-13,3,5534820
M2S1-06-14,3,5409960
M2S1-06-14,4,5370786
HSU1-04-16,3,5847610
M2S1-06-15,4,5370785
M2S1-06-15,3,5372319
M2S1-06-15,3,5368857
M2S1-06-15,4,5367493
HSU1-11-02,3,5848483
M2S1-06-16,5,5372641
M2S1-03-08,3,6065708
M2S1-06-16,3,5368223
M1S1-02-11,4,5413335
M2S1-06-16,3,5369713
M2S1-06-16,4,5368402
M2S1-06-17,3,5409881
M2S1-06-17,4,5369536
M2S1-06-18,3,5369950
M2S1-06-18,3,5409962
H1S1-07-21,3,5998254
EXEP-01-01,,5415919
M1S1-04-17,3,5413249
M2S1-07-01,3,5393518
M2S1-07-02,3,5372165
M2S1-07-02,3,5371837
M2S1-07-02,3,5370015
M2S1-07-02,3,5372731
M2S1-07-02,3,5372689
M2S1-07-04,3,5367152
M2S1-07-04,3,5408660
M2S1-07-04,3,5368442
M2S1-07-04,3,5369753
HSU1-04-09,4,5573463
HSU1-09-10,2,6065370
M2S1-07-05,3,5368398
M2S1-07-06,3,5369855
M2S1-07-07,3,5408602
M2S1-07-07,3,5393669
M2S1-05-06,3,5370931
M2S1-07-08,3,5368244
M1S1-08-06,2,5532319
M2S1-07-08,3,5393444
M2S1-07-09,3,5367532
M2S1-07-09,3,5372726
HSU1-07-05,3,5849907
M2S1-07-10,3,5406426
M2S1-07-10,3,5369054
M2S1-07-11,3,5371633
M2S1-07-11,3,5371047
M2S1-07-11,3,5372923
M2S1-07-11,3,5371536
H1S1-07-21,3,5998255
M2S1-07-12,3,5370787
M2S1-07-12,4,5406424
M2S1-07-13,3,5370277
M2S1-07-16,4,5372727
M2S1-07-16,4,5372156
M2S1-07-16,4,5370633
HSTA-05-01,3,5581852
HSU1-07-08,2,5849849
M2S1-07-18,4,5367995
M2S1-07-19,3,5369210
M2S1-07-20,3,5368963
M2S1-07-20,4,5372834
M2S1-07-20,4,5368405
M2S1-07-21,3,5408542
M1S1-08-05,3,5412847
M2S1-07-21,4,5371048
M1S1-07-06,3,5415782
H1S1-07-21,3,5998256
H1S1-07-21,3,5998257
H1S1-08-02,3,5998258
H1S1-08-02,3,5998259
H1S1-08-02,3,5998261
M1S1-04-14,3,5391155
M2S1-08-03,2,5393256
M2S1-08-03,3,5372222
M2S1-08-03,3,5408717
M2S1-08-03,2,5368078
M2S1-08-03,3,5409927
M2S1-08-03,3,5370667
M2S1-08-03,3,5408661
H1S1-08-02,3,5998263
M2S1-08-04,3,5371078
M2S1-08-04,3,5408776
M2S1-08-05,3,5372763
M2S1-08-06,2,5369765
M2S1-08-06,3,5408777
EXEP-01-01,,5382518
M2S1-08-06,3,5370138
M2S1-08-07,3,5372384
M2S1-08-07,2,5372122
M2S1-08-07,3,5370925
M2S1-08-07,3,5367121
M2S1-08-07,3,5372691
M2S1-08-07,3,5369767
M2S1-08-07,3,5371221
M2S1-08-07,3,5370139
M2S1-03-02,3,5372914
M2S1-08-08,3,5393262
M2S1-08-08,3,5409928
M2S1-08-08,3,5372572
M2S1-08-08,3,5408779
M2S1-08-08,3,5369120
M2S1-08-08,3,5408509
M2S1-08-08,4,5370473
M2S1-08-09,3,5367120
M2S1-08-09,2,5408505
M2S1-08-09,3,5370994
M2S1-08-09,3,5367250
M2S1-08-09,3,5369117
M2S1-08-10,3,5369768
H1S1-08-02,5,5998264
M2S1-08-10,3,5371333
H1S1-08-02,3,5998265
HSU1-05-01,2,5849709
H1S1-08-25,3,4978973
H1S1-08-04,3,5998277
H1S1-08-03,3,5998268
M2S1-08-11,2,5408726
M2S1-08-11,3,5372336
M2S1-08-11,4,5367374
M2S1-08-11,3,5393687
H1S1-07-16,5,5395692
M2S1-08-12,2,5368909
M2S1-08-12,3,5370760
HSU1-01-05,2,5395418
H1S2-02-02,2,5395419
M2S1-08-13,3,5370363
M2S1-08-13,4,5408667
M2S1-08-13,3,5372821
M2S1-08-13,5,5370995
M2S1-09-01,4,5371051
M2S1-09-01,2,5393268
M2S1-09-01,4,5370401
M2S1-09-02,3,5371602
M2S1-09-02,3,5370146
M2S1-09-02,2,5409879
M2S1-09-02,4,5367557
M2S1-09-02,3,5370881
M2S1-09-02,3,5369474
M2S1-09-02,3,5371871
HCAL-01-04,2,5395420
M2S1-09-03,3,5369025
H1S1-08-03,3,5998270
M2S1-09-04,3,5370715
M2S1-09-04,2,5367692
H1S1-08-03,3,5998271
M2S1-09-04,3,5367703
HSU1-02-04,3,5395421
HSU1-09-01,3,5395422
HSU2-02-05,3,5395423
H1S2-07-25,3,5395426
H1S2-03-03,3,5395483
HSU1-01-01,3,5395484
H1S2-07-17,3,5395485
HCAL-02-04,3,5395486
H1S2-03-16,3,5395487
M2S1-09-04,4,5370398
M2S1-02-16,4,5534608
M2S1-09-05,3,5393271
M2S1-09-05,3,5371113
HSU1-05-09,4,5843076
H1S1-08-03,3,5998273
M2S1-09-05,3,5367867
M2S1-09-06,3,5370824
HSU1-02-01,1,5570271
HSU1-05-02,2,5843060
M2S1-09-06,3,5372337
M2S1-09-06,3,5368568
HSU1-04-16,3,5827558
H1S1-08-04,3,5998275
M1S1-03-09,5,5411675
H1S1-08-04,3,5998276
HSU1-07-02,2,5843184
M2S1-09-07,1,5368775
EXEP-01-01,2,267253
M2S1-09-08,3,5367560
H1S1-08-04,3,5998278
M2S1-09-08,3,5372692
HSU1-06-08,2,6065247
HSU1-03-11,3,5576609
M2S1-09-06,4,5372236
M1S1-08-06,2,5532318
M1S1-02-11,4,5413336
M1S1-08-04,3,5415487
M2S1-09-13,4,5393689
M2S1-09-14,4,5367291
M2S1-09-14,3,5371424
M2S1-09-16,3,5370031
M2S1-10-01,2,5368685
M2S1-10-01,3,5370675
M2S1-10-01,3,5409840
M2S1-10-01,2,5369033
HSTA-07-04,3,5827833
M2S1-10-01,3,5367694
M2S1-10-01,3,5370465
M1S1-03-09,3,5415430
M1S1-07-10,4,5413043
H1S1-08-04,5,5998282
M2S1-10-04,3,5372339
M2S1-10-04,2,5372550
M2S1-10-04,3,5372696
M2S1-10-04,3,5370651
M2S1-10-04,3,5367873
M2S1-10-05,4,5367561
M2S1-10-05,3,5372768
M2S1-10-06,4,5372282
M2S1-10-06,3,5371102
M2S1-10-06,4,5372570
M2S1-10-06,3,5372128
M2S1-10-06,4,5370469
M2S1-10-07,4,5371109
M2S1-10-07,3,5372394
M2S1-10-07,4,5371005
M2S1-10-08,3,5372523
HSU1-07-08,3,5849888
H1S1-08-04,4,5998283
M1S1-05-18,3,5414081
M2S1-10-09,3,5367558
H1S1-08-04,4,5998284
H1S1-08-04,3,5998286
H1S1-08-09,3,5998287
M1S1-07-06,3,5414903
M2S1-10-10,3,5370998
M2S1-10-10,3,5370109
M1S1-04-12,3,5414186
EXEP-01-01,,5160205
EXEP-01-01,3,267254
H1S1-08-09,3,5998291
M2S1-10-11,3,5370676
M2S1-04-10,3,5409922
EXEP-01-01,3,267255
M2S1-10-12,4,5371186
M2S1-10-12,4,5372283
M2S1-10-12,3,5367710
M2S1-10-12,3,5372232
M3S1-11-07,3,5832871
EXEP-01-01,3,267256
M2S1-10-13,4,5371054
M2S1-10-13,5,5372741
M2S1-10-14,4,5367287
M2S1-10-14,4,5369924
H1S1-08-17,3,5998306
M2S1-10-15,4,5371425
M2S1-10-15,4,5369935
EXEP-01-01,3,267257
H1S1-08-09,3,5998296
M2S1-01-02,3,5408514
M2S1-01-02,3,5369539
M2S1-01-02,3,5371294
H1S1-08-09,3,5998297
M2S1-01-03,3,5372294
M2S1-01-03,3,5372910
M2S1-01-03,4,5371188
M2S1-01-04,3,5406465
M2S1-01-04,3,5368591
M2S1-01-05,2,5368253
M2S1-01-05,2,5367131
M2S1-01-05,3,5372924
M2S1-01-05,3,5367925
H1S1-08-09,4,5998298
EXEP-01-01,3,267258
M2S1-01-07,3,5368631
M2S1-01-07,3,5370181
M2S1-01-07,3,5370774
H1S1-08-11,3,5998301
H1S2-06-07,3,5395489
M2S1-01-08,3,5370059
M2S1-01-08,3,5369949
M2S1-01-08,3,5368151
M2S1-01-08,3,5367717
M2S1-01-09,3,5367498
M2S1-01-09,3,5372183
M2S1-01-09,3,5370339
M2S1-01-09,3,5368276
M2S1-01-10,3,5371008
EXEP-01-01,3,267259
HSU2-01-16,4,5395490
M2S1-01-12,4,5371881
M2S1-01-12,4,5370613
H1S1-08-15,3,5998302
HCAL-01-04,4,5395491
HSU1-02-17,4,5395492
H1S1-08-15,4,5998305
H1S2-04-11,4,5395493
M2S1-01-16,4,5371281
M2S1-01-16,5,5372911
M2S1-01-16,5,5369955
M2S1-01-17,3,5369643
M2S1-01-17,3,5371270
EXEP-01-01,3,267260
H1S1-08-17,3,5998307
H1S1-08-17,3,5998308
HSU1-11-11,4,5395494
H1S1-08-17,4,5998310
H1S1-08-18,3,5998311
H1S2-02-02,4,5395496
H1S1-08-18,3,5998314
M2S1-02-05,3,5372026
M2S1-02-05,3,5408560
M2S1-02-05,3,5370063
M2S1-02-05,3,5370211
HCAL-02-16,4,5395497
M2S1-02-09,4,5371966
HCAL-01-18,5,5395498
M2S1-02-10,4,5367520
H1S2-07-15,2,5395499
M2S1-02-12,3,5372172
HSU1-10-05,2,5395505
H1S1-08-18,3,5998316
H1S1-08-18,3,5998318
M2S1-02-13,4,5371389
M2S1-02-13,3,5409902
M2S1-02-14,3,5408588
M2S1-02-14,3,5393284
H1S1-08-19,3,5998319
M2S1-02-17,3,5372491
M2S1-02-17,3,5408565
M2S1-03-01,3,5370166
M2S1-03-03,3,5368799
H1S2-04-10,3,5395506
HSU2-01-07,3,5395507
HSU1-08-03,4,5395508
H1S2-05-22,4,5395509
M2S1-03-07,3,5367092
HSTA-02-03,4,5395511
H1S1-08-19,3,5998321
HSU1-10-08,4,5395512
HSU2-02-06,5,5395513
M2S1-03-08,3,5393640
HCAL-03-04,2,5395334
H1S2-07-15,2,5395335
HCAL-04-15,2,5395336
H1S1-08-19,3,5998322
M2S1-03-12,3,5371889
M2S1-03-13,3,5372664
M2S1-03-14,4,5371972
M2S1-03-14,3,5368271
HSU1-03-20,3,6064368
HSU1-05-09,4,5843077
M2S1-03-03,3,5534628
M2S1-07-08,3,5594842
M2S1-04-04,3,5370392
M2S1-04-04,3,5367395
M2S1-04-04,3,5371413
M2S1-04-05,3,5367244
HSU1-04-14,3,5847601
M2S1-04-07,3,5372217
M2S1-04-08,3,5370940
HSU1-10-15,3,5848189
EXEP-01-01,3,267261
M2S1-04-09,3,5371373
M2S1-04-12,4,5370018
M2S1-04-12,4,5370888
M2S1-05-01,3,5369873
M2S1-06-03,3,5369149
M2S1-06-04,3,5393649
M2S1-06-04,3,5393514
M2S1-06-04,4,5371626
M2S1-06-05,3,5408692
M2S1-06-05,3,5370081
M2S1-06-05,3,5370923
H1S1-08-19,3,5998324
H1S1-08-19,2,5998325
H1S1-08-19,3,5998326
H1S1-08-19,3,5998327
M2S1-06-09,3,5368733
M2S1-06-09,4,5370386
H1S1-08-21,3,5998329
M2S1-06-11,3,5371627
HSU1-07-02,3,5843213
M2S1-06-13,4,5369712
M2S1-06-14,4,5408647
M2S1-06-14,4,5371977
M2S1-06-17,4,5408641
HSU1-07-16,3,6038669
EXEP-01-01,3,267262
EXEP-01-01,3,267263
M2S1-07-02,5,5369980
HSU1-11-07,3,6043178
M2S1-03-05,3,5372188
M1S1-03-07,3,5415431
M2S1-07-04,2,5368054
M1S1-07-10,4,5411056
HSTA-02-08,4,6065508
M1S1-01-07,1,6106472
M1S1-05-14,2,3168478
M1S1-07-14,3,5410863
M1S1-07-06,3,5410862
M1S1-04-14,3,5413821
EXEP-01-01,4,267264
M2S1-07-06,3,5371983
HSU1-07-08,3,5577100
M2S1-04-05,3,5372732
M2S1-07-09,3,5372791
M3S1-10-02,3,5768614
H1S1-12-11,4,4984098
M2S1-07-11,3,5367352
M2S1-07-11,4,5367162
H1S1-06-08,3,5998223
HSU1-02-13,4,5394842
H1S1-06-05,4,5394843
HSU1-11-11,4,5394844
H1S1-03-10,4,5394845
H1S1-08-21,3,5998330
H1S1-08-21,3,5998331
H1S1-10-12,4,5394846
HSU1-10-05,4,5394848
M2S1-07-16,4,5369867
M2S1-07-16,3,5370180
H1S2-03-08,4,5394850
H1S1-12-11,5,5394853
H1S2-02-01,2,5394854
H1S1-02-02,2,5394855
EXEP-01-01,4,267265
H1S1-05-08,3,5394856
M2S1-07-20,4,5371535
M2S1-07-20,5,5368206
M2S1-07-20,3,5368731
M2S1-07-21,3,5367738
M2S1-07-21,3,5370854
H1S1-02-06,3,5394857
HSU1-11-06,2,6043173
M2S1-08-06,3,5409841
HSU1-11-06,3,6043174
HSU1-11-06,2,6043175
HSU1-11-06,3,6043176
HSU1-11-06,2,6043177
H1S2-01-10,4,5394859
M2S1-08-13,4,5371945
M2S1-09-01,2,5370433
HSU1-11-07,1,6043179
M2S1-09-04,3,5370825
HSU1-11-07,3,6043180
HSU1-11-07,2,6043181
HSU1-01-09,4,5394860
H1S1-12-04,4,5394863
M2S1-09-06,2,5371562
H1S1-08-14,4,5394865
HSU1-08-14,5,5394866
H1S1-01-01,2,5394523
H1S1-04-02,2,5394526
HSU1-02-03,2,5394527
M2S1-09-07,2,5371918
H1S2-04-10,3,5394528
HSU1-03-14,2,6043188
HSU1-03-14,2,6043189
M2S1-09-08,3,5369627
H1S1-05-08,3,5394529
HSU1-08-03,3,5394532
M2S1-09-09,3,5393702
H1S1-06-06,3,5394534
M2S1-09-09,3,5409935
H1S2-05-15,3,5394537
M2S1-09-10,3,5369044
M2S1-09-10,3,5372617
H1S1-03-06,3,5394540
H1S1-12-04,3,5394542
H1S2-02-02,3,5394545
M2S1-09-12,4,5371443
M2S1-09-12,3,5368906
EXEP-01-01,3,5394547
M2S1-09-12,4,5369083
H1S1-10-08,3,5394549
HSU1-10-05,4,5394552
M2S1-09-13,4,5370107
HSU1-10-10,4,5394554
M2S1-09-14,4,5371564
H1S2-03-16,4,5394556
HSU1-02-17,4,5394557
M2S1-09-15,3,5372091
M2S1-09-16,3,5409936
HSU1-03-14,3,6043190
H1S2-05-22,4,5394560
HSU1-03-14,3,6043191
HSU1-03-15,3,6043192
M2S1-10-02,3,5367870
HSU1-11-11,4,5394562
M2S1-10-06,4,5371082
M2S1-10-06,3,5372542
EXEP-01-01,4,5394566
M2S1-10-08,4,5368575
M2S1-10-08,4,5367408
M2S1-10-08,4,5409938
HSU1-03-15,2,6043194
M2S1-10-11,3,5370805
M2S1-10-11,4,5372652
M2S1-10-11,4,5370830
M2S1-10-11,3,5367874
M2S1-10-12,3,5370807
M2S1-10-12,3,5369797
H1S1-11-07,5,5394570
M2S1-10-14,4,5367463
H1S1-02-06,2,5394572
H1S2-06-13,2,5394573
H1S1-08-12,3,5394574
M2S1-01-05,3,5369211
M2S1-01-09,3,5372655
M2S1-01-10,3,5369810
M2S1-01-10,3,5371642
HSU1-01-12,3,5394575
H1S2-02-15,4,5394576
H1S1-12-05,4,5394578
HSU1-09-05,4,5394580
EXEP-01-01,4,5394581
M2S1-01-14,3,5406412
M2S1-01-15,3,5368795
M2S1-01-16,5,5371189
HSU1-03-15,3,6043196
HSU1-03-15,3,6043197
M2S1-02-04,3,5368521
M2S1-02-04,4,5368193
M2S1-02-05,3,5370001
HSU1-03-18,1,6043198
H1S1-07-07,5,5394583
HSU1-03-19,2,6043199
M2S1-02-11,4,5368369
M2S1-02-11,3,5371011
M2S1-02-15,3,5371244
M2S1-02-15,4,5370064
M2S1-02-17,3,5370903
M2S1-03-02,3,5406449
M2S1-03-04,4,5369598
M2S1-03-11,3,5408593
M2S1-03-11,3,5409858
M2S1-03-11,3,5371810
M2S1-03-12,3,5371392
M2S1-03-13,3,5408745
M2S1-04-03,3,5367201
M2S1-04-03,3,5370279
M2S1-10-13,3,3305875
M2S1-04-05,3,5406427
M2S1-04-06,3,5370871
HSU1-05-01,3,5849700
M2S1-04-07,3,5409920
M2S1-04-09,3,5406428
M2S1-04-09,3,5372606
HSU1-07-16,3,6038663
M2S1-04-11,3,5371041
M2S1-04-11,3,5368661
M2S1-04-11,3,5369787
M2S1-04-12,3,5409883
M2S1-04-12,4,5367060
M2S1-04-12,3,5372270
HSU1-03-19,3,6043200
M2S1-04-13,3,5408654
M2S1-04-13,4,5369112
M2S1-04-14,4,5369062
M2S1-04-14,3,5371940
HSU1-05-02,1,5843054
M2S1-05-04,3,5408714
HSU1-04-12,4,5576614
M2S1-05-05,4,5369580
HSU1-10-15,3,5827411
M2S1-05-06,3,5369464
HSU1-07-10,2,5843194
M2S1-06-19,4,5740813
M2S1-05-07,3,5393526
M2S1-05-07,3,5408770
HSU1-03-19,3,6043202
HSU1-03-19,3,6043211
M2S1-05-09,3,5368077
M1S1-05-17,3,5393230
M2S1-05-10,4,5370594
M2S1-05-10,5,5367159
M2S1-05-13,3,5371860
M2S1-06-01,4,5370921
HSU1-03-19,2,6043212
M2S1-06-01,3,5372832
M2S1-06-02,4,5371254
M2S1-06-02,3,5368216
M2S1-06-02,3,5372665
M2S1-06-03,3,5367143
M2S1-06-03,3,5370272
M2S1-06-03,3,5369206
M1S1-07-10,4,5411058
HSU1-02-13,3,5306584
M2S1-06-06,3,5367098
M2S1-06-07,2,5370194
M1S1-08-02,3,5413154
M2S1-06-07,4,5370973
M1S1-04-02,2,5529902
HSU1-06-12,2,6043217
M2S1-06-09,3,5372153
HSU1-06-12,2,6043218
M2S1-06-12,3,5372722
M2S1-06-13,3,5368739
M2S1-06-13,3,5370274
M2S1-06-14,4,5372667
M2S1-06-14,3,5406435
M1S1-07-05,3,5414593
M2S1-06-15,4,5370289
M2S1-06-15,4,5372072
M2S1-06-16,4,5367198
M1S1-05-16,3,3168461
M2S1-06-16,4,5368820
M2S1-06-17,3,5372922
M2S1-06-18,3,5369601
M2S1-07-02,3,5393248
M2S1-07-02,3,5370952
HSTA-07-13,3,6065547
M1S1-07-07,3,3168646
M2S1-07-08,3,5369773
M2S1-07-10,3,5370009
M1S1-05-13,3,5415666
M2S1-07-16,4,5369499
M2S1-07-16,4,5369959
M2S1-07-16,4,5372258
HSU1-07-08,4,5576104
M2S1-06-01,4,5370243
M2S1-07-20,3,5367952
M2S1-07-21,3,5370927
M3S1-10-07,5,6037939
H1S1-06-04,3,5998158
HSU1-06-12,2,6043221
HSU1-06-12,2,6043222
M2S1-08-06,2,5368843
M2S1-08-07,3,5372865
M2S1-08-07,2,5408502
M2S1-08-08,2,5370599
M2S1-08-08,3,5369981
M2S1-08-09,1,5367227
M2S1-08-09,3,5408666
M2S1-08-09,2,5393686
HSU1-04-06,3,5395337
M2S1-08-11,3,5370802
M2S1-08-11,3,5371081
M2S1-08-11,4,5371919
HSTA-04-02,3,5395338
M2S1-08-12,2,5370400
M2S1-08-13,3,5393263
M2S1-08-13,4,5372136
M2S1-08-13,5,5370886
M2S1-09-01,4,5367865
M2S1-09-01,4,5369795
M2S1-09-02,3,5369178
M2S1-09-02,4,5372565
M2S1-09-02,2,5368911
M2S1-09-03,3,5408662
M2S1-09-04,3,5372614
H1S2-07-25,3,5395339
M2S1-09-04,3,5369017
HCAL-09-06,3,5395340
M2S1-09-09,3,5393612
M2S1-09-10,3,5371361
HCAL-04-03,3,5395341
HCAL-05-12,3,5395342
HSU1-04-21,3,5395343
EXEP-01-01,3,5395344
EXEP-01-01,3,5395345
M2S1-09-14,3,5369993
M2S1-10-01,3,5367117
EXEP-01-01,3,5395346
M2S1-10-04,2,5367403
M2S1-10-04,3,5370808
M2S1-10-06,3,5368695
M2S1-10-08,4,5371422
M2S1-10-09,3,5372127
M2S1-10-10,3,5370653
HSU1-06-13,3,6043226
M2S1-10-13,4,5372618
M2S1-10-13,5,5367458
HCAL-07-11,4,5395347
HSTA-04-02,4,5395349
HCAL-03-11,4,5395353
M2S1-01-15,3,5370771
HSU1-06-13,3,6043227
M2S1-02-04,4,5369519
M2S1-02-15,3,5369198
M2S1-02-15,3,5408686
M2S1-02-17,3,5409948
M2S1-03-11,3,5369416
M2S1-03-11,3,5368801
M2S1-04-03,3,5371148
M2S1-04-05,3,5369622
M2S1-04-10,3,5370255
M2S1-04-11,4,5367108
M2S1-04-11,3,5370792
M2S1-04-11,4,5369167
M2S1-04-13,3,5368989
EXEP-01-01,4,5395354
M2S1-04-14,4,5372682
M2S1-05-04,3,5367112
HCAL-06-10,4,5395355
M2S1-05-07,3,5367270
HSU1-06-13,3,6043228
HSU1-06-14,3,6043229
M2S1-05-10,4,5369169
M2S1-05-10,4,5370958
M2S1-06-07,2,5372833
HSU1-06-14,3,6043230
M2S1-06-15,3,5370974
HCAL-10-12,4,5395356
HSTA-03-07,4,5395357
EXEP-01-01,5,5395358
HSTA-02-05,2,5395360
HSTA-02-05,2,5395361
EXEP-01-01,3,5395362
EXEP-01-01,4,267266
M2S1-06-18,3,5372804
M2S1-07-02,3,5408550
HSU1-06-21,3,6065276
EXEP-01-01,4,267267
EXEP-01-01,4,267268
EXEP-01-01,4,267269
M2S1-07-20,3,5368551
M2S1-07-07,3,3295532
M2S1-08-06,2,5372613
M2S1-08-11,2,5369946
M2S1-08-12,1,5369127
M2S1-08-12,3,5372123
HSU1-06-14,2,6043231
HSU1-04-12,3,5827556
M2S1-09-13,4,5371165
M2S1-10-01,3,5372698
M2S1-10-04,2,5409880
M2S1-10-13,4,5370460
M2S1-02-04,4,5368713
M2S1-04-03,3,5370114
M2S1-04-10,3,5372329
M2S1-04-11,3,5408500
M2S1-04-14,4,5369757
HSU1-06-14,2,6043232
HSU1-06-14,2,6043233
HSU1-06-13,3,5843170
M2S1-05-10,4,5370929
HSU1-06-14,3,6043234
M2S1-06-18,3,5369208
HSU1-06-15,2,6043235
M2S1-09-12,5,6037732
M2S1-09-11,3,5371952
M2S1-10-04,2,5409930
M2S1-10-13,4,5372391
M2S1-05-07,3,5372275
HSU1-06-15,2,6043236
HSU1-06-15,2,6043237
M2S1-09-11,3,5372548
M2S1-10-13,4,5370652
HSTA-01-01,3,5178868
HSTA-01-01,3,5167055
HSTA-01-01,4,5176632
HSTA-01-01,3,5183363
HSTA-01-01,3,5183480
HSTA-01-01,3,5184053
HSTA-01-01,4,5167203
HSTA-01-01,3,5188389
HSTA-01-02,3,5175411
HSTA-01-02,3,5183472
HSTA-01-02,3,5188398
HSTA-01-02,3,5173117
HSTA-01-03,3,5188117
HSTA-01-03,3,5187879
EXEP-01-01,0,5369128
HSTA-01-03,3,5188695
HSTA-01-03,3,5178280
HSU1-06-15,3,6043238
HSU1-06-15,3,6043240
HSTA-01-04,3,5167656
HSTA-01-04,3,5188021
HSTA-01-04,3,5182942
HSTA-01-04,3,5175409
HSTA-01-04,3,5183470
HSTA-01-05,3,5176638
HSTA-01-05,4,5167706
HSU1-03-21,3,5162720
HSTA-01-05,3,5171861
HSTA-01-05,4,5166602
M1S1-07-18,3,5531919
HSTA-01-06,5,5177567
HSTA-01-06,4,5183852
HSTA-01-07,3,5183475
HSTA-01-07,4,5160558
HSTA-01-07,3,5165338
HSTA-01-08,3,5172799
HSTA-01-08,3,5167856
HSTA-01-08,4,5178139
HSTA-01-09,3,5186815
HSTA-01-09,3,5183964
HSTA-01-09,3,5186956
HSTA-01-09,3,5184520
HSTA-01-09,3,5178282
HSTA-01-10,4,5184908
HSTA-01-10,3,5167057
HSTA-01-10,3,5161714
HSTA-01-10,3,5188113
HSU1-06-15,3,6043241
HSTA-01-11,4,5175404
HSTA-01-11,4,5172268
HSTA-01-11,4,5183571
M1S1-03-06,3,5585999
HSTA-01-11,4,5173194
HSTA-01-11,4,5172443
HSTA-02-01,3,5187029
HSTA-02-01,3,5176943
HSTA-02-01,5,5177802
HSTA-02-01,3,5162327
HSTA-02-01,3,5183024
HSU1-06-17,3,6043242
HSTA-02-02,4,5167341
HSTA-02-02,4,5182944
HSTA-02-02,4,5188470
HSTA-02-02,3,5175407
HSTA-02-03,4,5186820
HSTA-02-03,4,5167669
HSTA-02-03,3,5173023
HSTA-06-01,3,5827799
HSTA-02-03,3,5175935
HSTA-02-03,3,5188111
HSTA-02-04,3,5176268
HSTA-02-04,3,5186834
HSTA-02-04,3,5188375
HSTA-02-05,3,5188376
HSTA-02-05,3,5175397
HSTA-02-05,3,5186833
HSTA-02-05,4,5175938
HSTA-02-05,3,5183091
HSTA-02-05,4,5167154
HSTA-02-06,4,5183308
HSTA-02-06,4,5166042
HSTA-02-06,4,5188221
HSTA-02-06,4,5177692
HSTA-02-07,3,5185975
HSTA-02-07,3,5166048
HSTA-02-07,3,5186101
HSTA-02-07,3,5175119
HSTA-02-07,3,5167712
HSTA-02-07,3,5184863
HSTA-02-07,3,5183371
HSTA-02-08,3,5188569
HSTA-02-09,3,5185282
HSTA-02-09,3,5173955
HSTA-02-10,3,5188377
HSTA-02-10,3,5167870
HSTA-02-10,4,5166035
HSTA-02-10,3,5178218
HSTA-02-10,4,5183411
HSTA-03-01,3,5187387
HSU1-06-17,2,6043243
HSTA-03-02,3,5175788
HSTA-03-02,3,5187618
HSTA-03-02,3,5162335
HSTA-03-03,3,5174751
HSTA-03-03,5,5186832
HSTA-03-03,3,5178233
HSTA-03-04,3,5178822
HSTA-03-04,4,5174754
HSU1-06-17,3,6043244
HSTA-03-04,4,5167160
HSTA-03-06,3,5187039
HSTA-03-07,4,5178241
HSU1-06-17,4,6043245
HSU1-01-05,2,4385504
HSTA-03-07,4,5187131
HSTA-03-08,4,5162003
HSTA-03-08,4,5172804
HSTA-03-08,3,5166027
H1S2-02-02,2,4385505
HSTA-03-10,3,5183186
HSTA-03-10,3,5178814
HSTA-03-10,3,5176184
HSTA-03-11,3,5167606
HSTA-03-11,3,5187625
HSTA-03-11,5,5178821
HSTA-03-11,3,5166542
HCAL-01-16,2,4385506
H1S2-04-16,3,4385507
HSTA-03-12,3,5182939
HSTA-03-12,4,5184066
HSTA-03-12,3,5166425
HSTA-03-11,3,4385508
HSU2-01-02,3,4385509
H1S2-03-16,3,4385510
HSU2-08-01,3,4385511
HSTA-02-05,3,4385512
H1S2-06-07,3,4385513
HSU1-11-05,3,4385514
HSTA-04-02,3,4385515
HSU1-08-03,3,4385516
HCAL-07-12,4,4385517
HSTA-03-12,3,5183805
HSTA-03-12,3,5173394
HSTA-03-13,3,5172671
HSTA-03-13,3,5187617
HSTA-03-13,3,5175622
HSU1-07-15,3,6038675
HSTA-03-14,4,5188399
HSTA-03-14,3,5186830
HSTA-03-14,3,5176387
HSTA-03-14,3,5183095
HSTA-03-14,4,5177680
HSTA-03-15,3,5160335
HSTA-03-15,4,5166615
HSTA-03-15,4,5183104
HSTA-03-15,3,5184468
HSTA-03-15,3,5184473
HSTA-03-15,5,5178817
M2S1-02-13,3,5594024
HSTA-04-01,3,5178611
M2S1-02-17,3,3213145
HSTA-04-01,3,5176388
HSTA-04-02,3,5188418
HSTA-04-02,3,5182963
HSTA-04-02,3,5165823
HSTA-04-02,3,5188566
HSTA-04-02,3,5162581
HSTA-04-02,3,5187002
HSTA-04-02,4,5183339
M2S1-07-07,3,3295498
HSTA-04-03,3,5174841
HSTA-04-03,4,5187896
HSTA-04-03,3,5161989
HSU1-04-08,3,5827553
HSTA-04-04,3,5187171
HSTA-04-04,3,5183062
HSTA-04-04,3,5183107
HSTA-04-04,3,5165402
HSU1-02-18,4,5309523
HSTA-04-05,3,5175834
HSTA-04-05,3,5188473
HSTA-04-05,3,5187172
HSTA-04-05,3,5173581
HSTA-04-05,3,5176195
HSTA-04-06,3,5184027
M1S1-02-07,4,5413338
M1S1-05-17,3,5414084
HSTA-04-06,3,5166029
HSTA-04-06,3,5165850
EXEP-01-01,4,267270
HSTA-04-06,4,5183348
HSTA-04-07,4,5167028
M1S1-04-21,4,5414438
M1S1-05-13,3,5413414
HSTA-04-07,4,5175740
HSTA-04-07,4,5167116
HSTA-04-07,4,5165835
HSTA-04-07,3,5178003
HSTA-04-08,3,5167744
HSTA-04-08,3,5178616
M1S1-02-06,4,5413089
HSTA-04-08,3,5176975
HSTA-04-09,4,5178544
HSU1-03-01,1,5573319
HSTA-04-09,3,5176193
HSTA-04-09,3,5187173
HSTA-04-10,3,5167026
HSTA-04-10,3,5184816
M1S1-04-09,5,5414633
HSTA-04-11,3,5188590
HSTA-04-11,3,5187012
HSTA-04-11,3,5172941
HSTA-04-11,3,5178389
HSTA-04-11,3,5162607
HSTA-05-01,3,5183270
HSTA-05-01,3,5166303
HSTA-05-01,4,5176329
HSTA-05-01,3,5185561
M1S1-03-01,2,5529625
HSU1-06-17,2,6043246
HSTA-05-02,3,5167251
HSTA-05-02,3,5188335
M1S1-06-17,3,5532917
HSTA-05-03,3,5173585
HSTA-05-03,3,5188151
HSTA-05-03,3,5162592
HSTA-05-03,3,5162363
HSTA-05-04,3,5176887
HSTA-05-04,3,5183268
EXEP-01-01,3,5529471
HSU1-07-05,4,5576080
HSTA-05-04,4,5175463
HSTA-05-05,3,5183987
HSTA-07-03,3,5582000
HSTA-05-06,3,5177888
HSTA-05-06,3,5165404
M1S1-05-14,3,3168477
HSTA-05-07,3,5178005
HSTA-05-07,3,5177301
HSTA-05-07,3,5187186
HSTA-05-07,3,5165830
HSTA-05-08,4,5183273
HSTA-05-08,3,5188416
HSTA-05-08,3,5186366
HSTA-05-08,3,5185571
HSTA-05-09,3,5183343
HSU2-06-01,4,4385518
HSTA-05-09,3,5161344
HSTA-05-09,3,5185174
HSU1-10-16,3,6038798
H1S2-07-25,4,4385519
HSTA-05-10,3,5187006
EXEP-01-01,4,4385520
HSTA-05-11,3,5188441
HSTA-05-11,3,5188437
HSTA-05-11,3,5178095
HSTA-05-11,3,5173590
HSTA-05-11,3,5176206
HSTA-05-12,3,5185819
HSU2-02-03,4,4385521
HSTA-05-12,3,5176395
HSU1-10-14,3,6038799
HSTA-06-01,4,5177299
HSU1-10-14,3,6038801
HSU1-10-14,3,6038802
HSTA-06-02,5,5176334
HSTA-06-02,3,5176398
HSTA-06-02,3,5166168
HSTA-06-02,3,5174846
HSTA-06-02,3,5187920
HSTA-06-02,3,5178098
HSTA-06-03,3,5188355
HSTA-06-03,3,5166548
HSTA-06-03,4,5178009
HSTA-06-03,3,5185400
HSTA-06-03,3,5173847
HSTA-06-04,3,5178931
HSTA-06-04,4,5178555
HSTA-06-05,3,5188054
HSTA-06-05,3,5186369
HSTA-06-05,3,5177155
HSTA-06-06,3,5176338
HSTA-06-06,3,5175982
HSTA-06-06,3,5177339
HSTA-06-07,3,5167754
HSTA-06-07,3,5178346
HSTA-06-08,3,5174045
HSTA-06-08,3,5182973
HSTA-06-09,3,5177163
HSTA-06-09,3,5162010
HSTA-06-09,3,5188413
HSTA-06-09,3,5173588
HCAL-02-16,4,4385522
HSTA-04-11,4,4385523
HSTA-06-10,3,5160023
HSTA-06-10,3,5184618
HSTA-06-10,3,5187926
HSTA-06-11,3,5187182
HCAL-09-10,5,4385527
H1S2-07-15,2,4385528
HSTA-06-11,3,5187439
HSU2-03-11,2,4385529
HSTA-06-11,3,5174050
HSTA-06-12,4,5178939
HSTA-06-12,3,5173512
HSTA-06-12,3,5177753
H1S2-05-15,3,4385530
HSTA-06-13,3,5184998
HSU1-02-01,3,4385531
HSTA-06-13,3,5160938
HSU1-09-11,4,4385532
HSTA-05-10,4,4385533
HSTA-06-13,3,5176879
HSU2-09-11,4,4385534
HSU1-10-08,4,4385535
H1S2-04-15,5,4385536
EXEP-01-01,2,4385469
HCAL-03-04,2,4385470
EXEP-01-01,2,4385471
HSTA-03-11,3,4385472
HSTA-06-13,3,5171160
M2S1-10-13,3,5597125
HSTA-06-14,3,5173603
HSTA-06-14,3,5178553
M2S1-02-13,3,5593213
HSU1-10-15,3,6038805
HSTA-07-01,3,5173495
HSTA-07-01,3,5178530
HSTA-07-01,3,5176379
HSTA-07-01,3,5178464
HSTA-07-02,3,5176380
HSTA-07-02,3,5160007
HSTA-07-02,3,5187770
HSTA-07-02,4,5188349
HSTA-07-03,3,5178104
HSTA-07-03,3,5187927
HSTA-07-03,3,5162597
HSTA-07-04,3,5167812
HSTA-07-04,3,5187435
HSTA-07-04,3,5178631
HSTA-07-04,3,5178561
HSTA-07-04,3,5165827
EXEP-01-01,5,267271
HSTA-07-04,3,5174845
HSTA-07-05,3,5166549
HSTA-07-05,3,5162369
HSTA-07-06,3,5160909
HSTA-07-07,3,5178105
HSTA-07-07,3,5178460
HSTA-07-08,3,5173513
HSTA-07-08,3,5161362
HSTA-07-09,3,5185664
HSTA-07-09,3,5184612
HSTA-07-10,3,5167762
HSTA-07-10,3,5172948
HSTA-07-10,3,5178461
HSTA-07-10,3,5187529
HSTA-07-11,3,5182977
HSTA-07-11,3,5175260
HSTA-07-11,3,5173600
HSTA-07-11,3,5188447
HSTA-07-11,3,5182979
HSTA-07-12,4,5161378
HSTA-07-13,3,5187773
HSTA-07-13,3,5178557
HSTA-07-13,3,5186373
HSTA-07-14,3,5178106
EXEP-01-01,2,267272
HSTA-07-14,3,5171727
HSTA-01-02,3,5187723
HSTA-01-02,3,5172262
HSTA-01-03,4,5184907
HSTA-01-03,3,5178166
HSTA-01-05,4,5183471
HSTA-01-05,4,5167559
HSTA-01-05,3,5188016
HSU1-05-02,2,5575731
HSU1-04-01,1,5573422
HSTA-01-06,4,5166603
HSU1-10-14,3,5842985
HSTA-01-06,4,5186850
M2S1-03-08,4,5740477
EXEP-01-01,2,267273
HSTA-01-06,3,5188218
HSTA-01-08,3,5188126
HSTA-01-08,3,5161673
HSTA-01-09,3,5186407
HSTA-01-09,4,5185078
HSU1-10-15,3,6038806
HSTA-01-10,4,5187795
HSTA-02-01,4,5183029
HSTA-02-02,3,5166606
HSTA-02-03,3,5186330
HSTA-02-03,4,5176276
HSTA-02-04,4,5178875
HSTA-02-04,3,5184530
HSTA-02-04,4,5188665
HSU1-02-10,4,5827271
HSTA-02-04,3,5165354
HSTA-02-04,4,5183368
HSTA-02-05,3,5172453
HSTA-02-06,4,5175873
HSTA-02-06,4,5178174
HSTA-02-06,4,5167713
HSTA-02-07,3,5183841
HSTA-02-09,4,5160572
HSTA-02-09,3,5167867
HSTA-03-04,4,5187756
HSTA-03-05,3,5178867
HSTA-03-07,3,5183056
HSTA-03-07,3,5184985
HSTA-03-07,3,5177677
HSTA-03-07,4,5188669
HSTA-03-07,4,5177586
HSTA-03-11,3,5176385
M1S1-07-07,3,6065757
HSTA-03-13,3,5187733
HSTA-03-15,3,5187894
HSTA-04-01,3,5188515
HSTA-04-01,3,5172322
HSTA-04-01,3,5167022
HSTA-04-01,3,5175835
M1S1-02-10,4,5525649
HSTA-04-05,3,5175459
HSTA-04-05,3,5185648
HSTA-04-05,3,5188574
M1S1-05-07,3,6106446
HSTA-04-06,3,5165812
HSTA-06-14,3,6106325
HSTA-04-08,3,5165828
HSTA-04-09,3,5176325
HSTA-04-09,3,5184814
HSTA-04-09,3,5185871
HSTA-04-09,4,5183263
HSTA-04-10,3,5188596
HSTA-04-10,3,5185811
EXEP-01-01,3,4385473
HSTA-04-11,3,5160917
HSTA-04-11,3,5176488
HSTA-04-11,3,5187737
HSTA-04-11,3,5182914
HSTA-05-01,3,5185175
HSTA-05-02,3,5175802
HSTA-05-02,3,5174036
HSTA-05-02,3,5188045
HSTA-05-03,3,5187007
HSTA-05-03,3,5187247
HSTA-05-04,3,5175245
HSTA-05-04,3,5187098
HCAL-05-12,3,4385474
HSU1-03-03,3,4385475
HSTA-05-05,4,5176200
HSTA-05-06,3,5178390
HSTA-02-05,3,4385476
HSTA-05-06,3,5185645
HSTA-05-07,3,5187103
HSTA-05-07,3,5187147
HSTA-05-07,3,5177331
HSTA-05-08,3,5177106
HSTA-05-09,4,5176089
HSTA-05-10,3,5167809
HSTA-05-10,3,5176389
HSTA-05-10,3,5184828
HSTA-05-10,3,5188347
HCAL-10-06,3,4385477
HSTA-05-11,3,5172952
HSTA-05-11,3,5177886
HSTA-05-11,3,5160912
HSTA-05-11,3,5185500
HSTA-05-11,3,5183338
HSTA-05-12,3,5175750
HSTA-06-01,3,5176473
HCAL-07-13,3,4385478
HCAL-05-10,3,4385484
EXEP-01-01,3,4385485
HSTA-07-02,3,4385486
HSTA-06-03,3,5187104
HSTA-06-04,4,5176982
HSTA-06-05,3,5175991
HSU1-06-16,4,4385487
HSTA-04-11,4,4385488
EXEP-01-01,4,4385489
HSTA-07-07,4,4385490
HSTA-06-12,4,5176199
HSTA-06-12,3,5177887
HSTA-06-12,3,5173505
HSTA-06-12,3,5177258
HSTA-06-12,4,5177884
HSU1-10-16,2,6038812
HSTA-06-14,3,5176401
HSTA-07-01,3,5177746
HSTA-07-01,3,5187769
H1S2-07-26,4,4385491
EXEP-01-01,4,4385492
HCAL-06-10,4,4385493
HCAL-09-03,5,4385494
H1S2-07-15,2,4385495
HSU1-04-11,2,4385496
HSTA-05-10,3,4385497
HSTA-07-01,3,5160906
HSTA-07-02,3,5171163
HSTA-07-03,3,5167760
HSTA-07-03,3,5165412
HSU1-08-09,4,6064730
HSU1-11-08,5,6038648
HSU1-07-17,1,6038649
M2S1-01-01,2,5575747
HSTA-07-05,4,5185512
HSTA-07-08,3,5167033
HSTA-07-08,3,5185192
HSTA-07-08,3,5171725
HSTA-07-08,3,5176383
HSTA-07-08,3,5160011
HSTA-07-10,3,5176344
HSTA-07-10,3,5187428
HSTA-07-10,3,5184823
HSTA-07-11,3,5173865
HSTA-07-11,3,5177902
HSU1-11-08,3,6038650
HSTA-07-14,3,5188528
HSTA-01-01,4,5165448
HSTA-01-01,3,5166604
HSTA-01-02,3,5188216
HSU1-04-01,2,5573429
HSTA-01-03,3,5188659
HSTA-01-03,3,5172748
HSTA-01-03,3,5186950
HSTA-01-04,3,5177668
HSTA-01-07,4,5184057
HSTA-01-09,3,5187951
HSTA-01-09,3,5183896
HSU1-06-10,4,5160191
HSTA-01-10,3,5186952
HSTA-01-11,4,5188699
HSU1-07-17,1,6038651
HSTA-01-11,4,5167388
HSTA-02-01,3,5188220
HSTA-02-01,3,5172797
HSTA-02-01,3,5183303
HSTA-02-02,3,5172680
HSTA-02-02,3,5184741
HSTA-02-02,4,5165346
HSTA-02-03,4,5177673
HSTA-02-03,4,5176646
HSTA-02-05,3,5167370
HSU1-06-06,3,5843130
HSTA-02-09,3,5186090
HSTA-02-09,3,5173003
HSTA-02-10,4,5186827
HSTA-02-10,3,5174742
HSTA-03-01,3,5167350
M2S1-10-15,3,5741229
HSTA-03-02,3,5167202
HSTA-03-03,5,5166423
HSTA-03-04,4,5188571
HSU1-07-17,1,6038653
HSTA-03-06,3,5186234
HSTA-03-08,4,5166034
HSTA-03-09,3,5166543
HSTA-03-10,3,5167561
HSTA-03-10,3,5187730
HSTA-03-11,3,5175830
HSTA-03-11,5,5188572
HSTA-03-12,3,5183210
HSTA-03-13,3,5182987
HSTA-03-13,3,5183093
HSTA-03-13,3,5167549
HSTA-03-14,3,5166304
HSTA-03-14,4,5160578
HSTA-03-14,3,5187960
HSTA-03-14,3,5174840
M2S1-10-15,4,5372576
HSTA-03-15,5,5178136
HSTA-04-01,3,5187499
HSTA-04-01,3,5178731
HSTA-04-02,3,5176970
HSTA-04-02,3,5185167
HSTA-04-02,3,5182911
HSTA-04-03,3,5183061
HSTA-04-03,3,5188339
HSTA-04-03,3,5166430
HSTA-04-04,3,5188411
HSTA-04-04,3,5184617
HSTA-04-04,3,5187621
HSTA-04-06,3,5183267
EXEP-01-01,1,5529895
HSTA-04-07,4,5188050
HSTA-04-08,3,5184604
HSTA-04-08,3,5188344
HSTA-04-09,3,5188589
HSTA-04-10,3,5176391
HSTA-04-10,3,5185650
HSTA-04-10,3,5184621
HSTA-04-11,3,5186414
HSTA-05-01,3,5175452
HSU1-11-08,3,6038654
HSTA-05-05,3,5188593
HSTA-05-06,3,5160014
HSTA-05-06,3,5187918
HSU1-07-17,2,6038655
HSTA-05-09,4,5187286
HSTA-05-09,3,5182991
HSTA-05-10,3,5166153
HSTA-05-12,3,5177329
HSTA-06-02,3,5185182
HSTA-06-02,3,5185567
HSTA-06-03,4,5177302
HSTA-06-03,3,5160000
HSTA-06-03,3,5185660
HSTA-06-05,3,5177898
HSTA-05-01,3,5581853
HSTA-06-06,3,5171721
HSTA-06-06,3,5161342
HSTA-06-07,3,5178454
HSTA-06-08,3,5176396
HSTA-06-09,3,5184995
HSTA-06-09,3,5166158
HSU1-10-09,3,5309960
HSTA-06-11,3,5187765
HSTA-06-11,3,5177113
HSTA-06-12,4,5167818
HSU1-01-03,3,6038656
HSTA-07-01,3,5171724
HSTA-07-01,3,5188525
HSTA-07-01,3,5188168
HSTA-07-02,3,5175460
HSTA-07-03,3,5178325
HSTA-07-03,3,5185504
HSTA-07-04,3,5176342
HSTA-07-04,3,5162600
HSTA-07-05,3,5185663
HSTA-07-05,4,5178339
HCAL-09-06,3,4385498
HSTA-07-07,3,5177899
HSTA-07-09,3,5178467
HSTA-07-10,3,5175254
HSTA-07-10,3,5165411
HSTA-07-10,3,5188414
HSTA-07-11,3,5172190
HSTA-07-11,3,5177109
HSTA-07-11,3,5185194
HSTA-07-13,3,5187151
HSTA-07-14,3,5173602
HSTA-01-02,3,5167658
HSTA-01-04,3,5184515
HCAL-05-04,4,4385499
HSTA-02-09,3,5187845
HSU1-07-16,1,6038657
HSTA-03-02,3,5184484
HSTA-03-03,5,5187040
HSU1-01-03,3,6038658
HSTA-03-08,4,5177585
HSTA-03-10,3,5167349
HSTA-03-11,3,5160001
HSTA-03-12,3,5166298
HSTA-03-13,3,5175831
HSTA-03-13,3,5167557
HSTA-03-13,3,5167659
HSTA-04-03,3,5167299
HSTA-04-03,3,5166308
HSTA-04-03,3,5167115
EXEP-01-01,4,4385500
HSTA-04-08,3,5177107
HSTA-02-03,4,4385501
EXEP-01-01,4,4385502
HCAL-07-06,5,4385503
HSU1-01-05,2,4384724
H1S2-02-02,2,4384725
HSU2-01-06,2,4384726
HSU1-02-03,3,4384727
H1S2-04-10,3,4384728
H1S2-03-22,3,4384729
H1S2-03-16,3,4384730
HSU2-01-02,3,4384731
HCAL-01-14,3,4384732
M2S1-10-12,3,3305871
HSTA-05-01,3,5185814
HSTA-05-08,3,5167752
HSTA-05-12,3,5178094
HSTA-06-05,3,5178402
HSTA-06-06,3,5187683
HSTA-06-08,3,5178527
HSTA-06-09,3,5171164
HSTA-06-09,3,5174848
M2S1-02-17,3,3213144
HSTA-07-05,4,5184622
HSU1-07-17,2,6038659
HSTA-02-09,3,5182946
HSTA-02-10,4,5161702
HSTA-03-03,5,5175874
HSU1-01-03,5,6038660
HSTA-03-08,4,5187230
HSTA-05-12,3,5176487
HSTA-06-05,3,5182929
HSU1-02-15,3,5306123
HSTA-06-08,3,5184817
HSTA-07-02,3,5178630
HSTA-03-08,4,5172758
HSTA-06-05,3,5175462
HSTA-07-02,3,5177345
EXEP-01-01,3,6065707
M1S1-01-08,3,5526935
M1S1-01-08,3,5528982
M1S1-01-08,3,5585852
M1S1-01-08,3,5528983
M1S1-01-09,5,5527320
M1S1-01-09,3,5533104
M1S1-01-09,4,5528980
M1S1-02-03,2,5527137
M1S1-02-10,3,5529172
M1S1-02-10,4,5525200
M1S1-02-10,3,5527222
M1S1-03-04,3,5529466
M1S1-03-04,3,5529465
M1S1-03-04,3,5586126
M1S1-03-06,3,5529472
M1S1-04-01,2,5529750
M1S1-04-03,1,5529996
M1S1-04-03,1,5586162
M1S1-04-03,1,5586164
M1S1-04-03,1,5529995
M1S1-04-03,1,5529994
M1S1-04-03,1,5586165
M1S1-04-04,3,5530111
M1S1-04-05,2,5529950
M1S1-04-05,2,5530154
M1S1-04-05,2,5529907
M1S1-04-06,3,5525475
M1S1-04-06,3,5586248
M1S1-04-07,3,5530620
M1S1-04-09,3,5586281
M1S1-04-09,3,5586251
M1S1-04-09,2,5586198
M1S1-04-09,2,5586204
M1S1-04-09,2,5586305
M1S1-04-14,2,5530426
M1S1-04-15,1,5530395
M1S1-04-15,1,5530397
M1S1-04-15,1,5586225
M1S1-04-15,2,5586219
M1S1-04-15,1,5586226
M1S1-04-16,2,5586241
M1S1-04-16,2,5586240
M1S1-04-16,4,5529770
M1S1-04-16,4,5586258
M1S1-04-16,3,5586283
M1S1-04-18,3,5586229
M1S1-04-18,3,5586238
M1S1-04-18,3,5586284
M1S1-04-18,4,5710816
M1S1-05-03,2,5587519
M1S1-05-03,3,5529914
M1S1-05-04,3,5529917
M1S1-05-09,2,5532026
M1S1-05-09,2,5529878
M1S1-05-09,2,5531558
M1S1-05-09,3,5587476
M1S1-05-09,2,5531492
M1S1-05-09,2,5531491
M1S1-05-09,3,5529928
M1S1-05-14,3,5533285
M1S1-05-14,4,5586668
M1S1-05-14,3,5531434
M1S1-05-15,3,5525516
M1S1-05-15,4,5529882
M1S1-05-15,3,5532894
M1S1-05-15,3,5525520
M1S1-05-15,4,5529945
M1S1-05-15,3,5531582
M1S1-05-16,4,5529946
M1S1-05-18,3,5531581
M1S1-05-18,3,5532897
M1S1-06-01,2,5531725
M1S1-06-01,3,5531724
M1S1-06-07,3,5530125
M1S1-06-07,2,5587192
M1S1-06-07,3,5531937
M1S1-06-07,3,5531765
M1S1-06-09,2,5530129
M1S1-06-09,3,5587496
M1S1-06-10,2,5531836
M1S1-06-10,2,5531808
M1S1-06-10,2,5530131
M1S1-06-11,3,5531840
M1S1-06-11,3,5531841
M1S1-06-13,3,5531834
M1S1-06-13,3,5530133
M1S1-06-17,3,5531940
M1S1-07-01,3,5530309
M1S1-07-01,3,5530158
M1S1-07-01,3,5587380
M1S1-07-01,3,5587378
M1S1-07-01,4,5530310
M1S1-07-02,3,5532954
M1S1-07-02,4,5530312
M1S1-07-02,3,5530311
M1S1-07-02,3,5531878
M1S1-07-03,3,5530160
M1S1-07-03,3,5530313
M1S1-07-03,3,5531854
M1S1-07-03,4,5530190
M1S1-07-03,3,5532078
M1S1-07-03,3,5587232
M1S1-07-05,3,5530323
M1S1-07-05,3,5530315
M1S1-07-05,3,5530316
M1S1-07-05,3,5530319
EXEP-01-01,2,5372878
HSU1-09-12,3,5304619
M1S1-08-06,2,5532326
HSTA-03-04,2,6106319
HSTA-03-02,3,5824921
EXEP-01-01,3,6106328
HSU2-02-05,3,4384733
HSU2-03-14,3,4384734
H1S2-05-15,3,4384735
HCAL-02-04,3,4384736
HSU1-09-04,4,4384737
HSU1-02-04,4,4384738
HSU1-10-12,4,4384739
HSU1-01-13,4,4384740
HSU1-10-08,4,4384741
HSU2-03-08,4,4384742
HCAL-02-09,4,4384743
HCAL-02-01,5,4384744
HCAL-01-04,2,4384750
H1S2-01-08,2,4384751
H1S2-04-18,3,4384752
HSU1-09-01,3,4384753
HSU2-03-05,4,4384754
HSU1-01-09,4,4384755
HSU1-10-02,4,4384756
HSU2-01-06,4,4384757
HSU2-02-03,5,4384760
HSU1-01-05,2,4384694
H1S2-02-01,2,4384695
HSU1-09-01,2,4384696
H1S2-04-10,3,4384697
HSU2-01-02,3,4384698
HSU1-10-09,3,4384699
HSU2-03-08,3,4384700
H1S2-05-19,3,4384701
HSU2-01-11,3,4384702
HSU2-03-01,3,4384703
HCAL-02-04,3,4384704
H1S2-04-19,3,4384705
HSU2-03-06,3,4384706
HSU2-09-12,4,4384707
HSU1-10-02,4,4384708
HSU2-01-12,4,4384709
HSU1-10-10,4,4384710
HCAL-10-01,4,4384711
HCAL-01-18,4,4384712
HCAL-02-16,4,4384713
M1S1-07-05,3,5530314
M1S1-02-13,5,5414391
M1S1-07-06,3,5530318
M1S1-07-06,3,5532092
M1S1-07-07,3,5530193
M1S1-07-07,3,5530322
M1S1-07-08,4,5530321
M1S1-07-08,3,5530194
M1S1-03-10,4,5413317
M1S1-04-11,3,5393199
M1S1-07-11,4,5525540
EXEP-01-01,3,267274
M1S1-07-11,3,5530326
M1S1-08-02,3,5414904
M1S1-07-13,3,5530333
M1S1-06-04,3,5414372
M1S1-04-15,3,5410562
M1S1-07-14,3,5531914
M1S1-01-03,3,5393184
M2S1-06-01,3,5369659
M1S1-07-15,3,5530331
M2S1-10-03,3,5741190
M1S1-07-15,3,5525541
M1S1-07-15,3,5530220
H1S1-07-14,3,5560093
M1S1-07-17,3,5587237
M1S1-07-18,3,5587220
EXEP-01-01,3,267275
M1S1-07-18,3,5530339
M1S1-07-18,3,5531969
HCAL-09-01,3,5395363
M1S1-07-18,3,5530222
M1S1-07-20,3,5532957
HSU1-06-22,4,5395364
M1S1-07-20,3,5532001
M1S1-08-02,2,5532414
M1S1-08-02,2,5530579
HCAL-09-03,4,5395365
M1S1-08-06,3,5531401
M1S1-08-06,3,5533030
HSTA-02-03,4,5395366
HCAL-04-13,4,5395367
HCAL-07-09,5,5395368
M1S1-08-06,5,5530583
M1S1-08-06,3,5532452
M1S1-08-06,4,5530590
HSU1-01-05,2,5395195
HCAL-01-04,2,5395196
M1S1-09-01,3,5587738
M1S1-09-01,3,5532109
M1S1-09-01,3,5532266
M1S1-09-01,3,5587581
M1S1-09-01,2,5587579
M1S1-09-01,3,5587604
M1S1-09-05,3,5530633
M1S1-09-06,5,5530892
M1S1-09-06,3,5525586
M1S1-09-07,2,5587553
M1S1-09-07,3,5532231
M1S1-09-07,3,5532141
HSU1-09-04,2,5395197
M1S1-09-07,3,5532138
M1S1-09-07,2,5587740
M1S1-09-07,3,5532468
M2S1-02-02,1,5534541
M2S1-01-01,3,5538048
H1S2-02-09,3,5395198
HSU1-05-01,2,5834369
HSU1-01-10,3,5843491
H1S1-08-01,3,4985346
HSU1-03-21,3,5828315
M2S1-01-03,2,5590327
HSU1-02-01,3,5395199
H1S2-04-09,3,5395201
M2S1-10-14,3,5741226
H1S2-02-15,3,5395202
HSU1-02-04,3,5395204
M2S1-01-15,3,5575926
M2S1-01-15,3,5575931
M2S1-01-15,3,5534084
M2S1-09-10,3,5372879
M2S1-02-01,2,5592825
M2S1-02-01,2,5593203
EXEP-01-01,0,5368453
M2S1-02-01,1,5592745
M1S1-04-09,1,5530275
H1S2-05-17,3,5395206
HSU1-10-08,3,5395208
M1S1-07-07,3,5732219
H1S2-04-12,3,5395209
HSTA-05-02,3,5827788
M2S1-02-07,3,5594022
M2S1-02-07,3,5592835
M2S1-02-08,3,5592833
M2S1-02-08,2,5534575
M2S1-02-08,2,3213046
M1S1-09-06,4,3172935
HCAL-01-17,3,5395210
HCAL-09-12,5,4384714
HSU1-02-03,2,4384715
H1S2-01-03,2,4384716
M2S1-02-12,3,5592907
HSU2-07-05,3,4384717
H1S2-03-16,3,4384718
HSU1-09-04,4,4384719
M2S1-02-13,3,5593956
HSU1-01-02,3,5395211
HCAL-01-18,4,5395212
H1S2-06-15,4,5395214
HSU1-11-11,4,5395216
H1S2-03-25,4,5395217
HCAL-02-16,4,5395218
H1S1-06-04,4,5395220
HSU1-10-08,4,5395221
HCAL-02-08,5,5395223
HSU1-02-01,2,5395224
HSU1-10-09,2,5395225
HSU1-01-09,3,5395226
H1S2-02-12,3,5395227
HSU2-01-06,4,4384720
HSU2-08-04,4,4384721
H1S2-06-15,4,4384722
HSU2-06-03,5,4384723
H1S1-04-02,2,4384014
H1S1-03-01,2,4384015
M2S1-03-01,2,5593390
H1S1-01-01,2,4384016
H1S1-09-01,3,4384017
H1S1-02-01,3,4384018
M2S1-03-02,3,5593391
H1S1-05-05,3,4384019
H1S1-12-06,3,4384020
H1S1-05-08,3,4384021
H1S1-12-05,3,4384022
M2S1-03-03,3,5593393
M2S1-03-03,3,5593281
M2S1-03-03,3,5594030
M2S1-03-03,3,5534690
HCAL-01-18,4,5395228
M2S1-03-03,3,5593392
H1S2-03-06,4,5395229
M2S1-03-04,3,5538060
H1S1-08-08,3,4384023
H1S1-04-02,3,4384024
H1S1-06-04,3,4384025
H1S1-07-13,3,4384026
H1S1-06-03,4,4384027
H1S1-12-05,4,4384028
H1S1-10-02,4,4384029
H1S1-02-06,4,4384030
H1S2-04-12,4,5395230
M2S1-03-08,3,3295254
H1S2-01-06,4,5395231
HSU1-10-03,5,5395234
HCAL-03-04,2,5395027
HSU1-05-08,2,5395029
HCAL-05-01,2,5395030
HCAL-09-01,3,5395031
HSU1-06-05,3,5395033
M2S1-03-12,4,3295274
M2S1-03-12,3,3295188
M2S1-03-12,3,3295562
M2S1-03-12,3,5594031
M2S1-03-12,3,3295189
H1S1-08-20,4,4384032
M2S1-03-13,3,5534675
H1S1-11-17,4,4384033
HCAL-07-06,3,5395034
H1S1-06-04,4,4384034
H1S1-11-02,5,4384035
HCAL-08-08,3,5395035
M2S1-03-14,3,5534673
H1S1-01-02,2,4384036
M2S1-03-14,3,5593781
H1S1-02-11,2,4384037
HCAL-04-15,3,5395037
M2S1-03-14,2,5593586
H1S1-12-04,3,4384038
HCAL-06-08,3,5395038
HSTA-02-09,3,5395039
M2S1-03-15,3,5534709
M2S1-03-15,4,3295292
M2S1-03-15,3,5594050
HSU1-07-10,2,6038713
M1S1-05-16,3,5415880
M2S1-03-15,4,3295294
M2S1-04-01,2,5534824
M2S1-04-01,3,5534932
M2S1-04-01,3,3295773
M2S1-04-01,2,5594874
M2S1-04-01,3,5538152
M1S1-05-13,3,5410416
M2S1-04-03,3,5594878
M2S1-02-01,1,5534540
M1S1-06-08,3,5413147
HSU1-01-10,2,5840817
M2S1-04-08,3,5596611
M2S1-04-08,3,5596594
M2S1-10-15,3,3305876
M2S1-04-08,3,3295818
M2S1-04-09,3,5596789
HSU1-03-19,3,5828316
M2S1-05-01,3,3305290
M2S1-05-01,3,3305255
M1S1-07-10,3,5411417
M2S1-05-01,2,5596635
M2S1-05-01,3,3305333
M2S1-05-02,2,5534975
M2S1-05-02,3,3305297
M2S1-05-02,3,3305254
M1S1-06-15,3,5415157
M1S1-05-19,4,3168484
M1S1-04-15,3,5411138
H1S2-02-02,2,4727634
M2S1-05-04,2,5596636
M2S1-05-04,3,5534928
M2S1-05-05,3,3305293
M2S1-05-07,3,3305302
M2S1-05-12,3,5534980
M2S1-05-12,3,3305305
M2S1-05-13,3,3305306
M2S1-05-13,3,3305256
M2S1-06-04,2,5594254
M2S1-06-04,3,5594322
M2S1-06-04,3,5534729
M2S1-06-05,3,5594295
M2S1-06-08,3,5534739
HSU1-10-13,3,5848180
HSU1-06-05,2,5575952
M2S1-06-08,3,5534772
M2S1-06-10,3,5701340
M2S1-06-10,4,5594647
M2S1-06-11,3,5534775
M2S1-06-11,3,5594473
M2S1-06-11,3,5594786
M2S1-06-13,3,3295436
M2S1-06-13,3,3295410
M2S1-06-13,3,5534737
M2S1-06-13,3,5594648
M2S1-06-13,3,3295549
M2S1-06-17,3,5594789
M2S1-06-17,3,5594643
M2S1-06-17,2,5594506
M2S1-06-17,3,5534776
M2S1-06-18,3,3295424
M2S1-06-18,3,5594795
M2S1-06-18,3,5701343
M2S1-07-01,3,5534795
M2S1-07-01,3,5534794
M2S1-07-01,3,3295456
M2S1-07-01,3,5594790
M2S1-07-03,5,3295577
M2S1-07-05,3,5534802
M2S1-07-06,3,5534804
M2S1-07-06,3,5534803
M2S1-07-07,3,5594839
M2S1-07-07,3,5534805
M2S1-07-08,3,5534807
M2S1-07-10,4,5534809
M2S1-07-13,3,3295503
M2S1-07-13,3,5594513
M2S1-07-13,3,3295447
M2S1-07-14,3,5534811
M2S1-07-17,3,5534815
M2S1-07-18,3,5534814
M2S1-07-19,3,3295517
M2S1-07-19,3,5534818
M2S1-07-21,3,5594611
M2S1-08-04,3,3305921
M2S1-08-05,3,5535247
M2S1-08-06,2,3305619
M2S1-09-03,4,5535254
M2S1-09-03,3,5535251
M2S1-09-03,3,3305898
M2S1-09-03,3,5596895
M2S1-09-03,3,5701676
M2S1-09-09,2,5537903
M2S1-09-13,4,3305914
HSU1-02-05,3,5827257
M2S1-10-02,4,5538000
M2S1-10-02,3,5537878
M2S1-10-02,3,3305806
M2S1-10-03,3,3305847
M2S1-10-03,3,3305820
M2S1-10-03,3,3305830
M2S1-10-05,3,3305840
M2S1-10-05,4,5597108
M2S1-10-05,3,3305872
M2S1-10-05,3,5537988
M2S1-10-05,3,3305925
M2S1-10-05,3,3305810
M2S1-10-06,3,5537982
M2S1-10-07,3,5597009
M2S1-10-07,3,5538001
M2S1-10-07,2,3305955
M2S1-10-08,3,5597068
M2S1-10-08,2,5597010
M2S1-10-08,3,5597023
M2S1-10-08,2,5596954
M2S1-10-09,3,3305844
M2S1-10-10,5,5597076
M2S1-10-10,3,5701696
M2S1-10-14,3,5701697
M2S1-10-14,3,5597024
M2S1-10-14,4,3305930
M2S1-09-11,3,5370724
HSU1-01-03,3,6038662
HSU1-01-03,3,6038664
HSU1-01-03,3,6038666
M1S1-04-09,1,5530271
HSU1-01-06,1,6038668
HSU1-01-06,2,6038670
HSU1-01-06,3,6038672
HSU1-07-16,1,6038673
HSU1-01-09,2,6038674
M1S1-07-15,3,5587233
M1S1-07-20,3,5530330
M1S1-07-20,3,3168693
H1S1-06-06,3,4384039
H1S1-08-06,4,4384040
H1S1-12-04,4,4384041
H1S1-06-03,4,4384042
H1S1-11-11,4,4384043
H1S1-10-11,5,4384044
HSU1-01-05,2,4134615
HCAL-01-04,2,4134616
HSTA-05-10,2,4134617
H1S2-02-02,3,4134618
H1S2-03-16,3,4134619
HSTA-04-08,3,4134620
HSU2-01-02,3,4134621
HSU2-03-08,3,4134622
H1S2-06-11,3,4134623
HSTA-04-02,3,4134624
HSU2-07-06,3,4134625
HSU1-10-11,3,4134626
HSU1-11-05,3,4134627
HSU2-09-11,4,4134628
HSTA-02-03,4,4134635
H1S2-04-15,4,4134636
HSU2-08-01,4,4134637
HSTA-05-05,4,4134638
HCAL-02-16,4,4134639
HCAL-09-04,4,4134640
HSU2-08-06,5,4134641
HSU1-02-03,2,4134642
HSU2-03-11,2,4134643
HSTA-02-05,3,4134644
HSU1-08-15,3,4134645
HSTA-02-03,4,4134646
HSU2-03-07,4,4134647
HSTA-06-09,4,4134648
H1S2-07-18,4,4134649
HSU2-02-03,5,4134650
EXEP-01-01,2,4134561
HCAL-03-04,2,4134562
EXEP-01-01,2,4134563
HSTA-04-08,3,4134564
HCAL-03-10,3,4134565
HSTA-01-01,3,4134566
HCAL-05-09,3,4134567
M1S1-09-09,3,5415722
M2S1-03-10,3,5534714
HSU1-01-09,3,6038676
H1S1-08-19,3,5998323
HSU1-01-09,3,6038678
M2S1-01-01,1,3209944
HSU1-01-09,2,6038680
EXEP-01-01,4,267276
HSU1-01-09,5,6038682
HSU1-07-14,3,6038683
HSU1-02-07,3,6038684
EXEP-01-01,,5413525
HSU1-02-07,3,6038686
HSU1-07-14,3,6038687
HSU1-06-03,4,5161613
HSU1-07-14,3,6038689
HSU1-02-07,3,6038690
HSU1-07-14,3,6038691
HSU1-02-07,4,6038692
HSU1-07-14,3,6038693
HSU1-02-07,3,6038694
HSU1-07-14,3,6038695
HSU1-02-07,3,6038696
HSU1-07-14,3,6038697
HSU1-05-07,4,5628651
HSU1-07-14,3,6038699
M1S1-06-08,3,5413146
HSU1-07-13,3,6038701
HSU1-02-03,4,5570301
HSU1-07-13,2,6038703
HSU1-02-09,1,6038704
HSU1-07-13,1,6038705
EXEP-01-01,,5371145
HSU1-07-13,1,6038707
HSU1-02-09,1,6038708
HSU1-07-10,3,6038709
HSU1-02-09,3,6038710
M1S1-07-10,3,5411418
M1S1-02-10,4,5415511
M1S1-07-13,4,5587385
HSU1-02-09,3,6038714
EXEP-01-01,4,267277
HSU1-02-09,1,6038716
HSU1-07-09,3,6038717
HSU1-07-09,2,6038718
HSU1-07-10,3,6038719
M3S1-01-02,1,6037882
M1S1-07-15,3,5412337
HSTA-03-05,4,6065564
M3S1-01-02,3,6037885
M3S1-01-07,4,6037886
M1S1-01-07,1,6106469
M3S1-01-07,5,6037888
M1S1-06-13,3,3173023
M3S1-01-07,5,6037890
EXEP-01-01,4,267278
M1S1-01-02,3,5391088
M1S1-01-02,3,5410477
M1S1-01-02,3,5413531
M1S1-01-02,3,5413691
M1S1-01-02,3,5413772
M1S1-01-02,3,5413774
M1S1-01-03,3,5413178
M1S1-01-03,3,5413529
M1S1-01-03,3,5413690
M1S1-01-03,3,5413770
M1S1-01-04,3,5391089
M1S1-01-04,3,5413180
M1S1-01-04,3,5413692
M1S1-01-04,3,5413694
M1S1-01-04,3,5413775
M1S1-01-05,3,5410478
M1S1-01-05,3,5413181
M1S1-01-05,3,5413251
M1S1-01-05,4,5413696
M1S1-01-05,4,5413788
M1S1-01-05,3,5413870
M1S1-02-01,3,5393185
M1S1-02-01,3,5413698
M1S1-02-02,3,5410556
M1S1-02-02,3,5413695
M1S1-02-02,3,5413860
M1S1-02-03,3,5413697
M1S1-02-04,3,5393186
M1S1-02-04,5,5410558
M1S1-02-04,3,5413530
M1S1-02-04,5,5413705
M1S1-02-07,4,5413534
M1S1-02-09,3,5413872
M1S1-02-09,4,5414555
M1S1-02-11,3,5391095
M1S1-02-11,4,5393188
M1S1-02-12,5,5413533
M1S1-02-12,5,5413790
M1S1-02-13,4,5391145
M1S1-03-02,3,5410559
M1S1-03-02,3,5413193
M1S1-03-02,3,5413699
M1S1-03-02,3,5414142
M1S1-03-03,3,5391149
M1S1-03-05,3,5413254
M1S1-03-05,3,5413539
M1S1-03-05,4,5414147
M1S1-03-05,4,5414556
M1S1-03-07,3,5391152
M1S1-03-08,3,5410560
M1S1-03-08,3,5413865
M1S1-03-08,3,5414144
M1S1-03-08,3,5414357
M1S1-03-09,3,5391101
M1S1-03-09,3,5413257
M1S1-03-10,3,5391106
M1S1-03-10,3,5391150
M1S1-04-02,3,5413255
M1S1-04-03,3,5413779
M1S1-04-07,3,5391105
M1S1-04-08,3,5413549
M1S1-04-09,3,5413541
M1S1-04-09,4,5413700
M1S1-04-13,2,5393193
M1S1-04-14,3,5391107
M1S1-04-14,3,5413702
M1S1-04-17,3,5391156
M1S1-04-17,4,5410563
M1S1-04-17,3,5413256
M1S1-04-17,3,5413704
M1S1-04-17,3,5413780
M1S1-04-17,3,5413799
M1S1-04-20,3,5393195
M1S1-04-20,3,5413707
M1S1-04-20,4,5413878
M1S1-05-01,3,5391110
M1S1-05-01,3,5413782
M1S1-05-02,3,5414364
M1S1-05-03,3,5413552
M1S1-05-05,3,5413877
M1S1-05-06,3,5391130
M1S1-05-06,3,5413868
M1S1-05-07,5,5410566
M1S1-05-08,3,5393047
M1S1-05-08,3,5413786
M1S1-05-10,3,5393048
M1S1-05-10,3,5413798
M1S1-05-11,3,5391113
M1S1-05-13,3,5393050
M1S1-05-13,3,5413797
M1S1-05-16,3,5410571
M1S1-05-18,3,5393049
M1S1-06-02,3,5410755
M1S1-06-03,3,5410232
M1S1-06-03,3,5410756
M1S1-06-04,3,5410838
M1S1-06-05,4,5410757
M1S1-06-05,3,5410840
M1S1-06-08,4,5410839
M1S1-06-08,3,5410841
M1S1-06-08,3,5410876
M1S1-06-09,3,5410842
M1S1-06-09,3,5410869
M1S1-06-11,3,5410867
M1S1-06-12,3,5410760
M1S1-06-14,3,5410843
M1S1-06-14,3,5410868
M1S1-06-14,4,5411107
M1S1-06-15,4,5410845
M1S1-06-15,5,5410875
M1S1-06-16,4,5410759
M1S1-06-16,4,5411108
M1S1-07-01,3,5410872
M1S1-05-02,3,5413983
HSU1-06-21,3,4134568
HCAL-09-01,3,4134569
HSTA-04-02,3,4134570
H1S2-07-26,3,4134571
HCAL-05-10,3,4134572
HCAL-10-07,3,4134573
HSU1-07-10,2,6038715
M3S1-02-05,2,6037891
EXEP-01-01,4,267279
M3S1-02-05,3,6037894
EXEP-01-01,5,267280
M3S1-06-03,4,6037898
M3S1-07-02,2,6037900
M3S1-07-02,2,6037902
M3S1-07-10,3,6037903
M3S1-07-10,3,6037905
M3S1-07-10,2,6037906
M3S1-07-10,2,6037908
M3S1-07-12,2,6037909
M2S1-01-01,1,3209940
M3S1-07-12,2,6037912
M3S1-07-12,2,6037914
M3S1-07-12,3,6037915
M3S1-07-12,3,6037917
M3S1-07-12,3,6037918
M3S1-07-12,5,6037919
M3S1-07-12,5,6037921
HSU1-03-19,3,5573420
M3S1-01-07,3,5532064
M3S1-01-07,3,5582380
M3S1-02-01,3,5582210
M3S1-02-02,3,5535660
HSU1-10-13,3,5848094
M3S1-02-02,3,5553097
M3S1-02-02,3,5519771
M3S1-02-03,3,5535687
M3S1-02-03,3,5582184
M3S1-02-03,3,5535883
HSU1-06-03,3,5843246
HSU1-09-10,5,6065376
HSU1-01-13,3,5827228
M2S1-07-02,3,5372604
M3S1-03-01,3,5553108
M3S1-03-01,3,5531804
M3S1-03-01,3,5531820
M3S1-03-03,3,5531855
M3S1-03-04,3,5531998
M1S1-04-09,1,5530272
M3S1-03-05,3,5582814
M3S1-03-05,3,5531957
M3S1-03-05,3,5557899
M1S1-05-04,5,5531647
M3S1-03-05,2,5553159
M3S1-03-05,3,5557827
M3S1-03-05,3,5532087
M3S1-03-05,3,5583198
M3S1-03-05,3,5531956
M3S1-07-12,5,6037922
M3S1-08-11,3,6037924
M3S1-08-11,3,6037926
M3S1-08-11,3,6037927
M1S1-05-03,3,5529915
M1S1-07-21,4,5732246
M1S1-05-12,3,5531511
HSU1-11-12,3,5310375
M3S1-04-02,3,5531889
HCAL-05-12,4,4134574
HSU1-04-06,4,4134575
HSTA-06-09,4,4134576
EXEP-01-01,4,4134577
HCAL-07-10,4,4134579
HCAL-09-08,4,4134580
M3S1-04-03,3,5551801
M3S1-04-03,3,5557898
HCAL-04-13,5,4134586
M3S1-04-03,3,5557812
M3S1-04-03,3,5532084
H1S2-07-25,2,4134587
HSU1-03-17,2,4134588
EXEP-01-01,3,4134589
HCAL-04-03,3,4134590
M3S1-04-04,3,5558033
M3S1-04-04,2,5547792
M3S1-04-04,3,5547875
M3S1-04-04,2,5547793
M3S1-04-04,3,5559046
HSTA-02-03,4,4134591
HSU2-04-12,4,4134592
M3S1-08-11,3,6037930
M3S1-10-02,3,6037931
M3S1-10-02,3,6037933
M3S1-10-02,3,6037934
M3S1-10-02,3,6037936
M3S1-10-07,4,6037938
M3S1-04-06,3,5583700
EXEP-01-01,4,4134593
M3S1-04-06,5,5547905
M3S1-04-06,3,5547827
M3S1-04-06,3,5559032
EXEP-01-01,4,4134594
HCAL-09-11,5,4134595
HSU1-01-05,2,3979470
M2S1-03-10,3,6038063
M2S1-03-10,1,6038064
M2S1-04-01,1,6038065
M2S1-04-15,5,6038066
M2S1-04-15,3,6038067
M2S1-04-15,5,6038068
M2S1-04-15,3,6038069
M2S1-04-15,3,6038070
HSU2-01-08,2,3979471
H1S2-01-03,2,3979472
H1S2-04-10,3,3979473
M3S1-05-01,3,5548413
M3S1-05-01,3,5562551
M3S1-05-01,3,5583756
M3S1-05-01,3,5548414
M3S1-05-01,3,5548581
M3S1-05-01,3,5548582
H1S2-03-07,3,3979474
HSU2-05-06,3,3979475
HSU1-10-04,3,3979479
H1S2-06-07,3,3979480
M3S1-05-03,3,5548556
M3S1-05-03,3,5559116
M3S1-05-04,3,5583954
H1S2-05-15,3,3979481
M3S1-05-11,3,5559139
M3S1-05-11,3,5583896
M3S1-06-02,3,5548557
M3S1-06-03,3,5559174
HSU2-01-02,3,3979482
HCAL-02-11,3,3979483
M3S1-06-04,3,5583990
M3S1-06-04,3,5548570
HSTA-03-11,3,3979484
M3S1-06-04,3,5548522
M3S1-06-04,3,5584167
HSU1-02-03,3,3979485
HSTA-04-02,4,3979486
HSU1-10-02,4,3979487
HSU2-06-10,4,3979488
M3S1-06-05,3,5562533
M3S1-06-05,3,5548569
M3S1-06-05,3,5548630
HSU2-03-19,4,3979489
HCAL-02-16,4,3979490
HSTA-03-02,4,3979491
M3S1-07-03,2,5551866
M3S1-07-03,3,5559241
M3S1-07-03,3,5548912
HSTA-02-03,4,3979494
M3S1-08-03,3,5549270
HSU2-06-03,5,3979508
H1S2-07-15,2,3979503
M3S1-08-03,3,5551884
M3S1-08-03,3,5584330
M3S1-08-03,3,5562210
M3S1-08-03,3,5553281
M3S1-08-06,3,5584511
M3S1-08-06,3,5562245
HSU2-03-11,2,3979502
M3S1-08-06,3,5549272
HSU1-08-03,3,3979501
H1S2-07-25,3,3979500
HSTA-02-07,4,3979499
M3S1-08-07,3,5562305
M3S1-08-07,3,5551888
M3S1-08-07,3,5562301
M3S1-08-07,3,5584499
H1S2-02-15,4,3979498
M3S1-08-09,3,5562302
HSU2-02-09,4,3979497
M3S1-08-09,3,5584507
M3S1-08-09,3,5549242
M3S1-08-09,3,5562285
M2S1-04-15,3,6038071
HSU2-02-05,4,3979496
M2S1-04-15,2,6038073
M2S1-04-15,2,6038074
M3S1-08-10,3,5553289
M3S1-08-10,3,5549229
M3S1-08-10,2,5549279
HSU2-02-12,5,3979495
M3S1-08-11,3,5562311
H1S2-07-15,2,3979434
M1S1-07-10,4,5412092
M1S1-09-08,4,5413132
M1S1-05-10,2,5586592
HSU1-11-01,3,5824479
M3S1-09-02,3,5562585
M3S1-09-03,3,5549284
M3S1-09-07,3,5549281
M2S1-01-10,3,3212508
M3S1-09-07,3,5584414
M3S1-09-07,3,5584424
M2S1-02-01,1,5592744
HSU1-03-18,3,5846881
HSU1-06-01,4,5164434
M3S1-09-10,3,5584580
HSU1-06-04,3,5843135
M3S1-09-10,2,5559038
M2S1-10-12,3,3305856
M3S1-09-10,3,5584426
M3S1-09-10,3,5562293
HSU1-01-11,4,5843497
M3S1-09-10,3,5551903
M3S1-10-02,3,5553294
M3S1-10-12,3,5551434
M3S1-10-12,3,5551141
M3S1-10-12,2,5551908
HSU1-02-07,3,6038688
M3S1-11-01,3,5552156
M3S1-11-05,3,5551918
M3S1-11-05,3,5562442
M3S1-11-06,3,5551185
M3S1-11-06,4,5551175
M1S1-03-04,4,5530826
M3S1-11-08,3,5551447
M3S1-12-02,3,5551227
HSTA-05-05,3,5581881
M3S1-12-02,3,5551228
M3S1-12-02,3,5552165
M3S1-12-02,3,5551361
HSTA-05-04,3,5161351
M3S1-12-04,3,5562488
M3S1-12-04,3,5562487
M3S1-12-04,3,5584994
M3S1-12-04,3,5551927
M3S1-12-04,3,5551926
HCAL-03-04,2,3979435
HCAL-03-09,2,3979436
M2S1-04-15,2,6038075
M2S1-05-01,2,6038076
M2S1-05-01,2,6038077
HSTA-03-11,3,3979437
M3S1-12-08,4,5562472
EXEP-01-01,3,3979438
M3S1-12-08,3,5562495
HCAL-05-02,3,3979439
M2S1-05-01,3,6038078
M2S1-05-02,2,6038079
HSU1-03-16,3,3979441
M2S1-05-02,2,6038080
M2S1-05-02,3,6038081
M3S1-10-09,2,4988303
M3S1-08-08,2,4982517
M2S1-05-03,2,6038082
M3S1-08-05,3,4983538
M3S1-07-09,3,4982991
M3S1-07-09,3,4978161
M3S1-04-12,3,4987447
M3S1-04-06,3,4977580
M2S1-05-03,2,6038083
M3S1-03-01,3,4981125
M2S1-05-03,2,6038084
EXEP-01-01,,4981104
EXEP-01-01,,4976237
M3S1-03-01,3,5531828
HSU2-09-01,3,3979442
M3S1-03-01,3,5531865
M3S1-03-01,3,5531825
HCAL-05-10,3,3979443
M3S1-04-06,3,5557885
HSTA-03-07,3,3979444
M3S1-04-06,3,5582809
HCAL-08-04,3,3979445
M3S1-04-06,4,5557884
HCAL-10-15,3,3979446
M3S1-04-06,3,5583744
M3S1-04-06,3,5583743
M3S1-04-06,3,5583745
EXEP-01-01,3,3979469
M3S1-04-06,3,5559034
M3S1-04-06,4,5547882
M3S1-04-06,3,5557810
M2S1-05-03,3,6038086
M2S1-05-03,3,6038087
M2S1-05-05,2,6038088
HSU1-04-11,4,3979468
M2S1-05-05,3,6038089
HSU2-07-10,4,3979467
M3S1-08-08,4,5549193
HCAL-04-13,4,3979466
M2S1-05-11,3,6038090
HCAL-04-04,4,3979462
HSTA-03-02,4,3979461
M3S1-12-06,3,5562470
M3S1-12-06,3,5562493
EXEP-01-01,4,3979460
M3S1-12-09,3,5551348
M3S1-01-01,3,4985662
M3S1-01-01,3,4978183
M2S1-05-11,2,6038091
M3S1-01-05,4,4978457
M2S1-05-11,2,6038092
M3S1-01-03,3,4982694
M2S1-05-11,3,6038093
M3S1-01-10,3,4978330
M3S1-02-07,5,4977428
M3S1-01-03,3,4978442
M3S1-04-10,5,5557831
M3S1-04-10,3,5532005
M3S1-04-10,3,5557904
M3S1-04-10,3,5557814
M3S1-04-10,4,4976373
M3S1-04-10,3,4985920
M3S1-04-10,3,4983494
M3S1-04-10,4,4987560
M3S1-04-10,4,4985505
M3S1-04-10,3,4987448
H1S1-01-01,3,5639033
H1S1-01-01,3,5639032
H1S1-01-01,2,5639031
H1S1-01-01,2,5639030
H1S1-01-01,1,5615932
H1S1-01-01,1,5615931
H1S1-01-01,1,5614667
H1S1-01-01,2,5593016
H1S1-01-01,2,5593015
H1S1-01-01,2,5593014
H1S1-01-01,2,5593013
H1S1-01-01,2,5593012
H1S1-01-01,2,5593011
H1S1-01-01,2,5593010
H1S1-01-01,1,5560547
H1S1-01-01,3,5554411
H1S1-01-01,3,5554410
H1S1-01-01,1,5554395
H1S1-01-01,1,5554394
H1S1-01-01,1,5554344
H1S1-01-01,1,5554343
H1S1-01-01,1,5554340
H1S1-01-01,1,5554335
H1S1-01-01,1,5554334
H1S1-01-02,5,5639119
H1S1-01-02,3,5639118
H1S1-01-02,3,5639117
H1S1-01-02,3,5639116
H1S1-01-02,3,5639115
H1S1-01-02,3,5639088
H1S1-01-02,4,5639087
H1S1-01-02,3,5639035
H1S1-01-02,3,5615989
H1S1-01-02,3,5615978
H1S1-01-02,3,5615977
H1S1-01-02,4,5615940
H1S1-01-02,3,5615939
H1S1-01-02,3,5615938
H1S1-01-02,3,5615937
H1S1-01-02,2,5615935
H1S1-01-02,2,5615934
H1S1-01-02,2,5614668
H1S1-01-02,3,5593059
H1S1-01-02,3,5593051
H1S1-01-02,3,5593036
H1S1-01-02,3,5593035
H1S1-01-02,2,5593034
H1S1-01-02,2,5593033
H1S1-01-02,2,5593032
H1S1-01-02,2,5593031
H1S1-01-02,2,5593030
H1S1-01-02,2,5593029
H1S1-01-02,3,5593028
H1S1-01-02,2,5593027
H1S1-01-02,2,5554407
H1S1-01-02,2,5554406
HSTA-02-10,4,3979459
HCAL-07-06,5,3979458
EXEP-01-01,2,3979457
HCAL-04-02,2,3979456
H1S2-07-25,3,3979453
H1S1-01-02,2,5554405
H1S1-01-02,2,5554404
H1S1-01-02,1,5554403
H1S1-01-02,1,5554402
H1S1-01-02,1,5554401
H1S1-01-02,3,5554398
H1S1-01-02,2,5554384
H1S1-01-02,2,5554383
H1S1-01-02,2,5554382
H1S1-01-02,2,5554381
H1S1-01-02,2,5554367
H1S1-01-02,2,5554366
H1S1-01-02,2,5554365
H1S1-01-02,2,5554364
H1S1-01-02,1,5554356
H1S1-01-02,1,5554355
H1S1-01-02,1,5554354
H1S1-01-02,1,5554353
H1S1-01-02,1,5554352
H1S1-01-03,3,5614669
H1S1-01-03,3,5593082
H1S1-01-03,3,5593042
H1S1-01-03,3,5593040
H1S1-01-03,3,5593038
H1S1-01-03,3,5593037
M1S1-07-19,3,5412690
M2S1-09-09,2,5596957
H1S1-01-03,2,5554368
H1S1-01-04,3,5639120
H1S1-01-04,4,5615997
H1S1-01-04,3,5615991
H1S1-01-04,3,5615990
H1S1-01-04,3,5615956
H1S1-01-04,3,5615946
H1S1-01-04,3,5615944
H1S1-01-04,3,5615943
H1S1-01-04,3,5615942
H1S1-01-04,3,5615941
H1S1-01-04,3,5615936
H1S1-01-04,3,5614672
H1S1-01-04,3,5614671
H1S1-01-04,3,5614670
H1S1-01-04,3,5593091
H1S1-01-04,4,5593090
H1S1-01-04,3,5593074
H1S1-01-04,3,5593073
H1S1-01-04,3,5593072
H1S1-01-04,3,5593068
H1S1-01-04,3,5593067
H1S1-01-04,3,5593064
H1S1-01-04,3,5593063
H1S1-01-04,3,5593061
H1S1-01-04,3,5593060
H1S1-01-04,3,5593058
H1S1-01-04,3,5593057
H1S1-01-04,3,5593054
H1S1-01-04,3,5593052
H1S1-01-05,3,5639124
H1S1-01-05,3,5615992
H1S1-01-05,3,5615958
H1S1-01-05,3,5615945
H1S1-01-05,3,5593066
H1S1-01-05,3,5593065
H1S1-01-05,3,5593062
H1S1-01-05,3,5593055
H1S1-01-05,3,5593004
H1S1-01-06,3,5639126
H1S1-01-06,4,5639123
H1S1-01-06,4,5639122
H1S1-01-06,3,5639121
H1S1-01-06,3,5616030
H1S1-01-06,3,5615995
H1S1-01-06,3,5615993
H1S1-01-06,3,5615967
H1S1-01-06,3,5615962
H1S1-01-06,3,5615960
H1S1-01-06,3,5593094
H1S1-01-06,3,5593092
H1S1-01-06,3,5593075
H1S1-01-06,3,5593071
H1S1-01-06,3,5593070
H1S1-01-06,3,5593069
H1S1-01-06,3,5593005
H1S1-01-06,3,5554388
H1S1-01-06,3,5554387
H1S1-01-06,3,5554374
H1S1-01-06,3,5554373
H1S1-01-06,3,5554372
H1S1-01-06,3,5554371
H1S1-01-07,3,5614673
H1S1-01-07,3,5593097
H1S1-01-07,3,5593096
H1S1-01-07,4,5593095
H1S1-01-07,3,5593093
H1S1-01-07,3,5593077
H1S1-01-07,3,5593076
H1S1-01-07,3,5554417
H1S1-01-07,3,5554416
H1S1-01-07,3,5554408
H1S1-01-08,3,5639129
H1S1-01-08,3,5639128
H1S1-01-08,3,5639127
H1S1-01-08,3,5615996
H1S1-01-08,3,5615994
H1S1-01-08,2,5615975
H1S1-01-08,2,5615973
H1S1-01-08,3,5615971
H1S1-01-08,2,5615969
H1S1-01-08,2,5614674
H1S1-01-08,2,5593765
H1S1-01-08,2,5593025
H1S1-01-08,2,5593024
H1S1-01-08,2,5554400
H1S1-01-08,2,5554399
H1S1-01-08,3,5554392
H1S1-01-08,3,5554391
H1S1-01-08,2,5554390
H1S1-01-08,2,5554389
H1S1-01-08,3,5554378
H1S1-01-08,3,5554377
H1S1-01-08,2,5554376
H1S1-01-08,2,5554375
H1S1-01-08,3,5554360
H1S1-01-08,3,5554359
H1S1-01-08,2,5554358
H1S1-01-08,2,5554357
H1S1-01-09,4,5639132
H1S1-01-09,3,5639131
HSU1-01-10,2,5840815
H1S1-01-09,2,5593772
H1S1-01-09,2,5593764
M1S1-02-08,4,5414008
H1S1-01-09,2,5593741
H1S1-02-01,3,5639136
H1S1-02-01,3,5639134
H1S1-02-01,2,5639133
H1S1-02-01,3,5616112
H1S1-02-01,3,5616111
H1S1-02-01,3,5616110
H1S1-02-01,2,5616108
H1S1-02-01,2,5616036
H1S1-02-01,4,5593774
H1S1-02-01,3,5593762
H1S1-02-01,4,5593666
H1S1-02-01,3,5593665
H1S1-02-01,3,5593664
H1S1-02-01,3,5593663
H1S1-02-01,2,5593659
H1S1-02-01,2,5593658
H1S1-02-01,2,5593646
H1S1-02-02,5,5639140
H1S1-02-02,3,5639139
H1S1-02-02,3,5639138
H1S1-02-02,3,5639137
H1S1-02-02,5,5616124
H1S1-02-02,4,5616113
H1S1-02-02,3,5616041
H1S1-02-02,3,5616040
H1S1-02-02,2,5616039
H1S1-02-02,2,5614676
H1S1-02-02,2,5614675
H1S1-02-02,2,5593657
H1S1-02-02,3,5593655
H1S1-02-02,3,5593654
H1S1-02-02,2,5593653
H1S1-02-02,2,5593652
H1S1-02-03,3,5639135
H1S1-02-03,3,5616114
H1S1-02-03,3,5616063
H1S1-02-03,3,5616043
H1S1-02-03,3,5616034
H1S1-02-03,3,5614677
H1S1-02-03,3,5593766
H1S1-02-03,3,5593761
H1S1-02-03,3,5593760
H1S1-02-03,3,5593651
H1S1-02-03,3,5593650
H1S1-02-03,3,5593649
H1S1-02-03,3,5593648
M2S1-02-02,1,5592747
H1S1-02-04,3,5593661
H1S1-02-04,2,5593660
H1S1-02-04,4,5593083
H1S1-02-05,4,5593708
HSU1-03-18,3,5828282
H1S1-02-05,3,5593706
H1S1-02-05,3,5593705
H1S1-02-05,4,5593683
H1S1-02-05,3,5593674
H1S1-02-05,3,5593673
H1S1-02-05,3,5593671
H1S1-02-05,3,5593670
H1S1-02-05,3,5593669
H1S1-02-05,3,5593668
H1S1-02-05,2,5593667
H1S1-02-05,3,5593656
H1S1-02-06,3,5639143
H1S1-02-06,3,5639142
H1S1-02-06,2,5639141
H1S1-02-06,4,5616120
H1S1-02-06,3,5616116
H1S1-02-06,3,5616115
H1S1-02-06,3,5616109
H1S1-02-06,3,5616085
H1S1-02-06,3,5616081
H1S1-02-06,3,5616072
H1S1-02-06,3,5616068
H1S1-02-06,2,5616066
H1S1-02-06,1,5614678
H1S1-02-06,3,5593690
H1S1-02-06,3,5593689
H1S1-02-06,2,5593688
H1S1-02-06,2,5593687
H1S1-02-06,2,5593685
H1S1-02-06,2,5593684
H1S1-02-06,2,5593637
H1S1-02-06,3,5556657
H1S1-02-06,1,5556655
H1S1-02-06,1,5556654
H1S1-02-06,2,5556616
H1S1-02-06,1,5556615
H1S1-02-06,1,5556612
H1S1-02-06,1,5556611
H1S1-02-06,1,5556576
H1S1-02-06,1,5556575
H1S1-02-06,1,5556574
H1S1-02-06,1,5556573
H1S1-02-06,1,5556572
H1S1-02-06,1,5556571
H1S1-02-07,3,5639148
H1S1-02-07,3,5639146
H1S1-02-07,3,5639145
H1S1-02-07,3,5639144
H1S1-02-07,3,5616119
H1S1-02-07,4,5616118
H1S1-02-07,4,5616075
H1S1-02-07,3,5616073
H1S1-02-07,3,5614679
H1S1-02-07,3,5593763
H1S1-02-07,3,5593714
H1S1-02-07,3,5593710
H1S1-02-07,3,5593709
H1S1-02-07,3,5593694
H1S1-02-07,3,5593693
H1S1-02-07,3,5593692
H1S1-02-07,3,5593691
H1S1-02-07,3,5556656
H1S1-02-07,3,5556614
H1S1-02-07,3,5556613
H1S1-02-08,3,5639147
H1S1-02-08,4,5616080
H1S1-02-08,4,5593699
H1S1-02-08,3,5593698
H1S1-02-08,4,5593697
H1S1-02-08,3,5593696
H1S1-02-08,3,5593695
H1S1-02-09,3,5616094
H1S1-02-09,3,5616093
H1S1-02-09,3,5614681
H1S1-02-09,3,5593707
H1S1-02-09,4,5593703
H1S1-02-09,3,5593701
H1S1-02-09,3,5593700
H1S1-02-10,3,5639151
H1S1-02-10,3,5639150
H1S1-02-10,3,5639149
H1S1-02-10,3,5616091
H1S1-02-10,4,5593719
H1S1-02-10,4,5593718
H1S1-02-10,4,5593717
H1S1-02-10,4,5593716
H1S1-02-10,3,5593715
H1S1-02-11,3,5639155
H1S1-02-11,3,5639154
H1S1-02-11,3,5639153
H1S1-02-11,2,5639152
H1S1-02-11,3,5616101
H1S1-02-11,3,5616098
H1S1-02-11,3,5616097
H1S1-02-11,2,5616096
H1S1-02-11,1,5614682
H1S1-02-11,3,5593740
H1S1-02-11,3,5593738
H1S1-02-11,3,5593737
H1S1-02-11,3,5593727
H1S1-02-11,2,5593725
H1S1-02-11,2,5593724
H1S1-02-11,2,5593722
H1S1-02-11,2,5593721
M2S1-02-16,1,5534607
H1S1-02-11,2,5593642
H1S1-02-11,3,5556659
H1S1-02-11,2,5556658
H1S1-02-11,3,5556618
H1S1-02-11,2,5556617
H1S1-02-12,5,5616125
H1S1-02-12,3,5616103
H1S1-02-12,3,5616102
H1S1-02-12,3,5614683
H1S1-02-12,4,5593769
H1S1-02-12,3,5593733
H1S1-02-12,3,5593731
H1S1-02-12,3,5593730
H1S1-02-12,3,5593728
H1S1-02-13,5,5593775
H1S1-02-13,4,5593771
H1S1-02-13,4,5593770
H1S1-02-13,5,5593767
H1S1-02-13,4,5593754
H1S1-02-14,4,5616122
H1S1-02-14,3,5616107
H1S1-02-14,3,5616106
H1S1-02-14,3,5616104
H1S1-02-14,2,5614684
H1S1-02-14,4,5593753
H1S1-02-14,2,5556661
H1S1-02-14,1,5556660
H1S1-02-14,2,5556622
H1S1-02-14,2,5556621
HSU1-03-17,4,5573415
H1S1-02-14,1,5556619
H1S1-02-14,3,5556578
H1S1-02-14,3,5556577
H1S1-03-01,3,5639226
H1S1-03-01,3,5616159
H1S1-03-01,3,5616154
H1S1-03-01,3,5616153
H1S1-03-01,3,5616128
H1S1-03-01,3,5616126
H1S1-03-01,3,5594140
H1S1-03-01,2,5594137
H1S1-03-01,4,5594136
H1S1-03-01,3,5594135
H1S1-03-01,3,5594132
H1S1-03-01,4,5594131
H1S1-03-01,3,5594129
H1S1-03-01,3,5594120
H1S1-03-01,3,5594118
H1S1-03-01,3,5594117
H1S1-03-01,3,5594116
H1S1-03-01,3,5594115
H1S1-03-01,2,5558028
H1S1-03-01,2,5558026
H1S1-03-01,2,5557651
H1S1-03-01,2,5557650
H1S1-03-01,2,5557649
H1S1-03-01,2,5557648
HSU1-10-13,3,5827410
H1S1-03-01,1,5557646
H1S1-03-01,1,5557645
HSU1-06-01,3,5843111
H1S1-03-01,2,5557597
H1S1-03-01,2,5557593
H1S1-03-01,2,5557591
H1S1-03-01,2,5557587
H1S1-03-01,2,5557583
H1S1-03-01,1,5557574
H1S1-03-01,1,5557572
H1S1-03-01,1,5557571
H1S1-03-01,1,5557570
H1S1-03-01,1,5557545
H1S1-03-01,1,5557544
H1S1-03-01,1,5557543
H1S1-03-01,1,5557542
H1S1-03-01,1,5557541
H1S1-03-01,1,5557540
EXEP-01-01,3,5367972
EXEP-01-01,,5371002
M1S1-03-02,3,5414648
H1S1-03-01,1,5557539
H1S1-03-01,1,5557538
H1S1-03-01,1,5557537
H1S1-03-02,3,5639230
H1S1-03-02,3,5639229
H1S1-03-02,3,5639228
H1S1-03-02,5,5616184
H1S1-03-02,3,5616157
H1S1-03-02,3,5616139
H1S1-03-02,3,5616138
H1S1-03-02,3,5614689
H1S1-03-02,2,5614685
H1S1-03-02,4,5594214
H1S1-03-02,4,5594213
H1S1-03-02,4,5594153
H1S1-03-02,3,5594152
H1S1-03-02,3,5594151
H1S1-03-02,3,5594149
H1S1-03-02,3,5594148
H1S1-03-02,3,5594147
H1S1-03-02,3,5594141
H1S1-03-02,3,5594139
H1S1-03-02,3,5594138
H1S1-03-02,5,5558098
H1S1-03-02,3,5558047
H1S1-03-02,2,5558029
H1S1-03-02,2,5557989
H1S1-03-02,2,5557988
H1S1-03-02,2,5557945
H1S1-03-02,2,5557944
H1S1-03-02,2,5557943
H1S1-03-02,2,5557923
H1S1-03-02,2,5557922
H1S1-03-03,4,5616156
H1S1-03-03,3,5594161
H1S1-03-03,3,5594160
H1S1-03-03,3,5594159
H1S1-03-03,3,5594158
H1S1-03-03,3,5594157
H1S1-03-03,3,5594156
H1S1-03-03,3,5594155
H1S1-03-03,3,5594154
HSU1-04-13,3,5847660
H1S1-03-03,2,5557991
H1S1-03-03,2,5557990
H1S1-03-03,2,5557947
H1S1-03-03,2,5557946
H1S1-03-04,3,5639234
H1S1-03-04,3,5639233
H1S1-03-04,3,5616155
H1S1-03-04,3,5616133
H1S1-03-04,3,5616131
H1S1-03-04,3,5614686
H1S1-03-04,4,5594171
H1S1-03-04,4,5594170
H1S1-03-04,3,5594169
H1S1-03-04,3,5594168
H1S1-03-04,3,5594167
H1S1-03-04,3,5594166
H1S1-03-04,3,5594165
H1S1-03-04,3,5594134
H1S1-03-04,3,5594133
H1S1-03-04,5,5558095
H1S1-03-04,2,5558036
H1S1-03-04,2,5558035
H1S1-03-04,2,5557995
H1S1-03-04,2,5557993
H1S1-03-04,2,5557948
H1S1-03-04,2,5557924
H1S1-03-05,3,5616134
H1S1-03-05,3,5614687
H1S1-03-05,4,5594240
H1S1-03-05,3,5594174
M2S1-01-10,4,3295308
M2S1-02-02,1,5592760
HSU1-03-16,3,5573408
H1S1-03-06,3,5616161
H1S1-03-06,3,5616160
H1S1-03-06,3,5616145
H1S1-03-06,2,5616142
H1S1-03-06,2,5616140
H1S1-03-06,1,5614690
H1S1-03-06,3,5594177
H1S1-03-06,3,5594176
H1S1-03-06,3,5594175
H1S1-03-06,2,5594114
H1S1-03-06,2,5594113
H1S1-03-06,2,5594112
H1S1-03-06,3,5558050
H1S1-03-06,2,5558043
H1S1-03-06,2,5558042
H1S1-03-06,2,5557997
H1S1-03-06,2,5557996
H1S1-03-06,2,5557951
H1S1-03-06,2,5557950
H1S1-03-06,2,5557926
H1S1-03-06,2,5557925
H1S1-03-07,4,5616137
HSU1-05-06,3,5160668
H1S1-03-07,4,5614688
HSU1-06-01,3,5843125
H1S1-03-07,3,5594163
H1S1-03-07,3,5594162
H1S1-03-07,3,5594145
H1S1-03-08,4,5594235
H1S1-03-08,4,5594217
M2S1-09-16,3,5741228
H1S1-03-08,4,5594215
H1S1-03-08,3,5594192
H1S1-03-08,3,5594189
H1S1-03-08,3,5594181
H1S1-03-08,4,5594180
H1S1-03-08,3,5594179
H1S1-03-08,3,5594178
H1S1-03-09,3,5639239
H1S1-03-09,3,5639238
H1S1-03-09,3,5616132
H1S1-03-09,3,5594230
H1S1-03-09,3,5594229
H1S1-03-09,3,5594228
H1S1-03-09,3,5594227
H1S1-03-09,3,5594226
H1S1-03-09,3,5594224
H1S1-03-09,3,5594223
H1S1-03-09,5,5558096
H1S1-03-10,4,5594212
H1S1-03-10,3,5594211
H1S1-03-10,3,5594210
H1S1-03-10,3,5594209
H1S1-03-10,3,5594207
H1S1-03-10,4,5594206
H1S1-03-10,3,5594205
H1S1-03-10,3,5594204
H1S1-03-10,3,5594203
H1S1-03-10,3,5594202
H1S1-03-10,4,5594201
H1S1-03-10,3,5594199
H1S1-03-10,4,5594198
H1S1-03-10,3,5594197
H1S1-03-10,3,5594196
H1S1-03-10,3,5594195
H1S1-03-10,3,5594194
H1S1-03-10,3,5594193
H1S1-03-11,2,5639237
H1S1-03-11,3,5616130
H1S1-03-11,4,5594233
H1S1-03-11,3,5594221
H1S1-03-11,3,5594220
H1S1-03-11,3,5594219
H1S1-03-11,3,5594218
H1S1-03-11,3,5558049
H1S1-03-11,3,5558048
H1S1-03-11,3,5558031
H1S1-04-01,1,5625809
H1S1-04-01,2,5592362
H1S1-04-01,2,5592269
H1S1-04-01,2,5592268
H1S1-04-01,2,5592266
H1S1-04-01,1,5592184
H1S1-04-01,1,5592183
M2S1-09-08,3,5367186
H1S1-04-02,3,5625858
H1S1-04-02,4,5625834
H1S1-04-02,3,5625832
H1S1-04-02,2,5625831
H1S1-04-02,3,5625826
H1S1-04-02,3,5625825
H1S1-04-02,3,5625824
H1S1-04-02,3,5625823
H1S1-04-02,2,5615918
H1S1-04-02,2,5615887
H1S1-04-02,2,5615886
H1S1-04-02,3,5592364
H1S1-04-02,3,5592327
H1S1-04-02,3,5592316
H1S1-04-02,3,5592315
H1S1-04-02,2,5592314
H1S1-04-02,2,5592313
H1S1-04-02,3,5592287
H1S1-04-02,3,5592286
H1S1-04-02,3,5592285
HSU1-06-09,3,6065255
M1S1-07-11,3,5732285
M1S1-03-06,3,5529822
H1S1-04-02,3,5592279
H1S1-04-02,3,5592277
H1S1-04-02,3,5592276
H1S1-04-02,2,5592267
H1S1-04-02,1,5592222
H1S1-04-02,1,5592219
H1S1-04-02,1,5592218
H1S1-04-02,1,5592217
H1S1-04-02,1,5592205
H1S1-04-02,1,5592204
H1S1-04-02,1,5592203
H1S1-04-02,1,5592202
H1S1-04-02,1,5592200
H1S1-04-02,1,5592199
H1S1-04-02,1,5592198
H1S1-04-02,1,5592197
H1S1-04-02,1,5592195
H1S1-04-02,1,5592194
H1S1-04-02,1,5592192
H1S1-04-02,1,5592191
H1S1-04-02,3,5554318
H1S1-04-02,2,5554312
H1S1-04-02,3,5554305
H1S1-04-02,3,5554304
H1S1-04-04,3,5625856
H1S1-04-04,3,5625812
H1S1-04-04,3,5625811
H1S1-04-04,3,5625810
H1S1-04-04,4,5615899
H1S1-04-04,3,5615885
H1S1-04-04,3,5615884
H1S1-04-04,2,5614658
H1S1-04-04,3,5592282
H1S1-04-04,3,5592281
H1S1-04-04,3,5592280
H1S1-04-04,3,5592273
H1S1-04-04,3,5592272
H1S1-04-04,3,5592271
H1S1-04-04,2,5592270
H1S1-04-04,3,5554320
H1S1-04-04,3,5554285
H1S1-04-03,4,5625816
H1S1-04-03,3,5625814
H1S1-04-03,2,5625813
H1S1-04-03,4,5615926
H1S1-04-03,3,5615902
H1S1-04-03,3,5615901
H1S1-04-03,2,5614662
H1S1-04-03,3,5592369
H1S1-04-03,3,5592367
H1S1-04-03,3,5592298
H1S1-04-03,3,5592296
H1S1-04-03,3,5592295
H1S1-04-03,3,5592294
H1S1-04-03,3,5592293
H1S1-04-03,3,5592275
H1S1-04-03,1,5592190
H1S1-04-03,1,5592189
H1S1-04-03,1,5592186
H1S1-04-03,1,5592185
H1S1-04-03,3,5554311
H1S1-04-03,2,5554310
H1S1-04-03,2,5554284
H1S1-04-03,2,5554269
H1S1-04-03,2,5554268
HSU1-04-13,3,5847598
H1S1-04-03,2,5554250
H1S1-04-05,3,5625857
H1S1-04-05,3,5625822
H1S1-04-05,3,5625821
H1S1-04-05,3,5625820
H1S1-04-05,3,5625819
H1S1-04-05,2,5625818
H1S1-04-05,3,5625817
H1S1-04-05,3,5615920
H1S1-04-05,3,5615905
H1S1-04-05,3,5615903
H1S1-04-05,3,5614663
H1S1-04-05,4,5592375
H1S1-04-05,3,5592373
H1S1-04-05,3,5592371
H1S1-04-05,3,5592370
H1S1-04-05,3,5592328
H1S1-04-05,3,5592312
H1S1-04-05,3,5592311
H1S1-04-05,3,5592310
H1S1-04-05,3,5592309
H1S1-04-05,3,5592308
H1S1-04-05,4,5592305
H1S1-04-05,4,5592304
H1S1-04-05,4,5592303
H1S1-04-05,3,5592301
H1S1-04-05,3,5592300
H1S1-04-05,1,5592232
H1S1-04-05,1,5592231
H1S1-04-05,3,5554324
H1S1-04-05,3,5554323
H1S1-04-05,3,5554315
H1S1-04-05,3,5554290
H1S1-04-05,3,5554289
H1S1-04-06,5,5615929
H1S1-04-06,3,5615921
H1S1-04-06,3,5615909
H1S1-04-06,3,5615907
H1S1-04-06,3,5614664
H1S1-04-06,3,5592334
H1S1-04-06,3,5592333
H1S1-04-06,3,5592332
H1S1-04-06,3,5592307
H1S1-04-06,3,5592306
H1S1-04-06,3,5592299
H1S1-04-06,3,5554322
H1S1-04-06,3,5554321
H1S1-04-06,3,5554314
H1S1-04-07,3,5625861
H1S1-04-07,3,5615888
H1S1-04-07,3,5614660
H1S1-04-07,2,5592342
H1S1-04-07,4,5592341
H1S1-04-07,3,5592340
H1S1-04-07,3,5592338
H1S1-04-07,3,5592337
H1S1-04-07,3,5554325
H1S1-04-07,3,5554317
H1S1-04-07,3,5554292
H1S1-04-07,3,5554281
H1S1-04-07,3,5554280
H1S1-04-08,4,5625863
H1S1-04-08,3,5615924
H1S1-04-08,4,5615923
H1S1-04-08,3,5615919
H1S1-04-08,4,5615900
H1S1-04-08,4,5615898
H1S1-04-08,3,5615890
H1S1-04-08,3,5615889
H1S1-04-08,3,5614661
M2S1-02-02,1,5592759
H1S1-04-08,3,5592376
H1S1-04-08,3,5592350
H1S1-04-08,4,5592349
H1S1-04-08,3,5592348
H1S1-04-08,3,5592347
H1S1-04-08,3,5592346
H1S1-04-08,4,5592345
H1S1-04-08,4,5592344
H1S1-04-08,3,5592343
H1S1-04-08,3,5592339
H1S1-04-08,3,5554291
H1S1-04-08,3,5554279
H1S1-04-09,3,5625866
H1S1-04-09,2,5625865
H1S1-04-09,3,5625838
H1S1-04-09,3,5625837
H1S1-04-09,3,5625836
H1S1-04-09,3,5625835
H1S1-04-09,4,5615928
H1S1-04-09,2,5615927
H1S1-04-09,2,5615915
H1S1-04-09,2,5615914
H1S1-04-09,2,5615913
H1S1-04-09,2,5614666
H1S1-04-09,3,5592363
H1S1-04-09,3,5592361
H1S1-04-09,3,5592360
H1S1-04-09,3,5592359
H1S1-04-09,2,5592358
H1S1-04-09,2,5592357
H1S1-04-09,2,5592356
H1S1-04-09,3,5592355
H1S1-04-09,2,5592354
H1S1-04-09,2,5592353
H1S1-04-09,2,5592352
H1S1-04-09,2,5592351
H1S1-04-09,3,5592278
H1S1-04-09,3,5554306
H1S1-04-09,3,5554301
H1S1-04-09,3,5554300
H1S1-04-09,2,5554283
H1S1-04-09,2,5554282
H1S1-04-09,2,5554272
H1S1-04-09,1,5554267
H1S1-04-09,1,5554266
HSU1-03-16,1,5573406
HSU1-10-12,3,5847986
H1S1-04-09,1,5554265
H1S1-05-01,3,5656854
H1S1-05-01,3,5656853
H1S1-05-01,3,5604794
H1S1-05-01,3,5604793
H1S1-05-01,3,5604792
H1S1-05-01,3,5604791
H1S1-05-01,3,5604790
H1S1-05-01,3,5604789
H1S1-05-01,3,5604777
H1S1-05-01,3,5604776
H1S1-05-01,3,5604775
H1S1-05-01,3,5604773
H1S1-05-01,3,5604771
H1S1-05-01,2,5604769
H1S1-05-01,1,5604768
M2S1-05-11,3,5596651
H1S1-05-01,1,5559129
H1S1-05-01,1,5559127
M2S1-10-07,2,5537893
M2S1-02-03,1,5592768
HSU1-03-16,3,5824762
H1S1-05-01,1,5559075
HSU1-10-12,3,5576103
H1S1-05-01,1,5558960
H1S1-05-01,1,5558957
HSU1-05-09,3,5843162
HSU1-07-16,1,6038665
H1S1-05-02,3,5656873
H1S1-05-02,3,5656856
H1S1-05-02,3,5616264
HSU1-01-05,2,5570237
H1S1-05-02,4,5604783
H1S1-05-02,3,5604782
H1S1-05-02,3,5604781
H1S1-05-02,3,5604780
M2S1-05-09,3,5371232
H1S1-05-02,3,5559135
M1S1-04-02,2,5529909
H1S1-05-02,3,5559080
H1S1-05-02,3,5559079
H1S1-05-03,4,5657097
H1S1-05-03,3,5656855
H1S1-05-03,4,5616314
H1S1-05-03,4,5616310
H1S1-05-03,4,5616266
H1S1-05-03,4,5606377
H1S1-05-03,3,5604805
H1S1-05-03,3,5604804
H1S1-05-03,3,5604803
H1S1-05-03,3,5604802
H1S1-05-03,3,5604801
H1S1-05-03,3,5604800
H1S1-05-03,3,5604797
H1S1-05-03,3,5604796
H1S1-05-03,4,5559230
H1S1-05-03,4,5559228
H1S1-05-03,2,5559221
H1S1-05-03,3,5559136
H1S1-05-03,3,5559081
H1S1-05-04,3,5616312
H1S1-05-04,3,5616267
M1S1-06-08,3,5412084
HCAL-05-12,3,3979452
H1S1-05-04,3,5604819
H1S1-05-04,3,5604818
H1S1-05-04,3,5604817
H1S1-05-04,4,5604816
H1S1-05-04,3,5604815
HCAL-07-03,4,3979451
H1S1-05-04,3,5604813
H1S1-05-04,4,5559231
H1S1-05-04,4,5559225
HSTA-01-07,4,3979450
H1S1-05-05,4,5656862
H1S1-05-05,4,5656860
H1S1-05-05,3,5656859
H1S1-05-05,3,5656858
H1S1-05-05,3,5616315
H1S1-05-05,3,5616275
H1S1-05-05,3,5616273
H1S1-05-05,4,5616271
H1S1-05-05,3,5616270
H1S1-05-05,3,5616269
H1S1-05-05,3,5616268
H1S1-05-05,3,5614709
H1S1-05-05,3,5614708
H1S1-05-05,3,5606340
H1S1-05-05,3,5606339
H1S1-05-05,3,5606337
H1S1-05-05,3,5606336
H1S1-05-05,3,5606334
H1S1-05-05,4,5606332
H1S1-05-05,4,5606331
H1S1-05-05,4,5606325
H1S1-05-05,4,5606323
H1S1-05-05,3,5606321
H1S1-05-05,3,5606320
H1S1-05-05,3,5606318
H1S1-05-05,3,5606317
H1S1-05-05,3,5559656
H1S1-05-05,2,5559649
H1S1-05-05,2,5559648
H1S1-05-05,2,5559647
H1S1-05-05,2,5559588
H1S1-05-05,2,5559586
H1S1-05-05,2,5559584
H1S1-05-05,2,5559358
H1S1-05-05,2,5559357
H1S1-05-05,2,5559356
H1S1-05-05,2,5559287
H1S1-05-05,2,5559286
H1S1-05-05,2,5559284
H1S1-05-06,3,5616274
H1S1-05-06,3,5606314
H1S1-05-06,3,5606307
H1S1-05-07,3,5616272
H1S1-05-07,2,5606311
H1S1-05-07,2,5606310
H1S1-05-08,3,5657067
H1S1-05-08,3,5657064
H1S1-05-08,3,5657063
H1S1-05-08,3,5656870
H1S1-05-08,3,5656869
H1S1-05-08,3,5656865
H1S1-05-08,3,5656864
H1S1-05-08,3,5656863
H1S1-05-08,4,5616318
H1S1-05-08,4,5616316
H1S1-05-08,4,5616279
H1S1-05-08,3,5616278
H1S1-05-08,3,5616277
H1S1-05-08,3,5616276
H1S1-05-08,3,5614710
H1S1-05-08,3,5559662
H1S1-05-08,2,5559653
H1S1-05-08,2,5559652
H1S1-05-08,2,5559651
H1S1-05-08,2,5559650
H1S1-05-08,2,5559595
H1S1-05-08,3,5559591
H1S1-05-08,2,5559469
H1S1-05-08,3,5559464
H1S1-05-08,3,5559463
H1S1-05-08,3,5559462
H1S1-05-08,3,5559461
H1S1-05-08,2,5559365
H1S1-05-08,2,5559364
H1S1-05-08,2,5559363
H1S1-05-08,2,5559361
H1S1-05-08,3,5559137
H1S1-05-09,4,5657065
H1S1-05-09,3,5656868
H1S1-05-09,3,5656867
H1S1-05-09,3,5656866
H1S1-05-09,4,5616319
H1S1-05-09,4,5616288
H1S1-05-09,3,5616287
H1S1-05-09,3,5616286
H1S1-05-09,3,5616285
H1S1-05-09,3,5616283
H1S1-05-09,4,5616280
H1S1-05-09,3,5614712
H1S1-05-09,3,5614711
H1S1-05-09,3,5606398
H1S1-05-09,3,5606397
H1S1-05-09,3,5606396
H1S1-05-09,3,5606395
H1S1-05-09,3,5606394
H1S1-05-09,3,5606393
H1S1-05-09,3,5606392
H1S1-05-09,3,5606391
H1S1-05-09,4,5606380
H1S1-05-09,3,5606379
H1S1-05-09,3,5559655
H1S1-05-09,3,5559654
H1S1-05-09,3,5559593
H1S1-05-09,3,5559592
H1S1-05-09,3,5559466
HSTA-04-02,4,3979449
EXEP-01-01,4,3979448
HCAL-09-08,5,3979447
HSU1-01-05,2,3975216
H1S2-02-01,2,3975217
H1S1-05-09,3,5559465
H1S1-05-10,3,5657066
H1S1-05-10,3,5656872
H1S1-05-10,3,5656871
H1S1-05-10,4,5616322
H1S1-05-10,3,5616320
H1S1-05-10,3,5616292
H1S1-05-10,3,5616291
H1S1-05-10,3,5616290
H1S1-05-10,2,5616289
HSU1-02-04,2,5570307
H1S1-05-10,3,5616282
H1S1-05-10,3,5616281
H1S1-05-10,3,5614713
H1S1-05-10,3,5606406
H1S1-05-10,3,5606405
H1S1-05-10,3,5606404
H1S1-05-10,3,5606403
H1S1-05-10,3,5606402
H1S1-05-10,3,5606401
H1S1-05-10,3,5606400
H1S1-05-10,3,5606399
H1S1-05-10,4,5559663
H1S1-05-10,3,5559657
H1S1-05-10,3,5559468
H1S1-05-11,3,5616284
M2S1-02-03,1,5592767
H1S1-05-12,3,5616299
H1S1-05-12,3,5614716
H1S1-05-12,3,5606409
H1S1-05-12,3,5606407
H1S1-05-13,3,5656875
H1S1-05-13,3,5656874
H1S1-05-13,4,5616297
H1S1-05-13,3,5616296
H1S1-05-13,3,5616294
H1S1-05-13,3,5614715
H1S1-05-13,2,5604779
H1S1-05-13,2,5604774
H1S1-05-13,3,5559660
H1S1-05-13,3,5559658
H1S1-05-13,2,5559596
H1S1-05-13,2,5559470
H1S1-05-14,4,5656876
H1S1-05-14,4,5616317
H1S1-05-15,5,5616327
H1S1-07-01,3,5656924
H1S1-07-01,3,5656923
H1S1-07-01,3,5656921
H1S1-07-01,3,5616336
H1S1-07-01,3,5616335
H1S1-07-01,3,5616334
H1S1-07-01,2,5616333
H1S1-07-01,2,5614721
H1S1-07-01,3,5604841
H1S1-07-01,3,5604840
H1S1-07-01,3,5604839
H1S1-07-01,3,5604838
H1S1-07-01,3,5604827
H1S1-07-01,3,5604826
H1S1-07-01,3,5604825
H1S1-07-01,3,5604824
H1S1-07-01,3,5604823
H1S1-07-01,3,5559908
H1S1-07-01,3,5559737
H1S1-07-01,3,5559727
H1S1-07-01,3,5559726
H1S1-07-01,3,5559724
H1S1-07-01,2,5559721
H1S1-07-02,3,5657070
H1S1-07-02,3,5656927
H1S1-07-02,3,5656926
H1S1-07-02,4,5616337
H1S1-07-02,3,5604845
H1S1-07-02,3,5604844
H1S1-07-02,3,5604843
H1S1-07-02,3,5604842
HSU1-03-16,3,5827529
H1S1-07-02,3,5559821
M2S1-03-08,3,6065712
M2S1-09-16,3,6037739
H1S1-07-03,4,5604851
H1S1-07-03,3,5604849
H1S1-07-03,3,5604847
H1S1-07-03,3,5604846
EXEP-01-01,3,5367973
M2S1-08-12,2,5408553
M1S1-05-03,2,5586350
H1S1-07-04,3,5656930
H1S1-07-04,3,5656929
H1S1-07-04,3,5604873
H1S1-07-04,3,5604871
H1S1-07-04,3,5604855
H1S1-07-04,3,5604852
M1S1-05-04,3,5532864
H1S1-07-05,3,5656925
H1S1-07-05,3,5656922
H1S1-07-05,4,5604879
H1S1-07-05,3,5604877
H1S1-07-05,3,5604875
H1S1-07-05,3,5604830
H1S1-07-05,3,5604828
H1S1-07-06,4,5656933
M1S1-07-07,5,6065755
H1S1-07-06,3,5656931
H1S1-07-07,3,5657073
H1S1-07-07,3,5656936
H1S1-07-07,3,5656935
H1S1-07-07,3,5656934
H1S1-07-07,3,5616340
H1S1-07-07,3,5616339
H1S1-07-07,3,5616338
H1S1-07-07,3,5614722
H1S1-07-07,3,5606430
H1S1-07-07,3,5606428
H1S1-07-07,3,5606427
H1S1-07-07,3,5606424
H1S1-07-07,3,5606421
H1S1-07-07,3,5606420
H1S1-07-07,3,5559905
H1S1-07-08,4,5656939
H1S1-07-08,3,5616342
H1S1-07-08,3,5616341
H1S1-07-08,2,5614724
H1S1-07-08,3,5606434
H1S1-07-08,3,5606433
H1S1-07-08,3,5606431
H1S1-07-09,3,5656938
H1S1-07-09,3,5656937
H1S1-07-09,4,5616345
H1S1-07-09,3,5616344
H1S1-07-09,3,5616343
H1S1-07-09,3,5614725
H1S1-07-09,3,5606439
H1S1-07-09,3,5606438
H1S1-07-09,3,5606437
H1S1-07-09,3,5606436
H1S1-07-09,3,5606435
H1S1-07-09,3,5604832
H1S1-07-09,3,5604831
H1S1-07-09,3,5604829
H1S1-07-09,3,5559911
H1S1-07-09,3,5559815
H1S1-07-10,4,5657072
H1S1-07-10,3,5657071
H1S1-07-10,4,5656943
H1S1-07-10,3,5656942
H1S1-07-10,3,5656941
H1S1-07-10,3,5616351
H1S1-07-10,4,5616350
H1S1-07-10,3,5616348
H1S1-07-10,3,5616347
H1S1-07-10,3,5616346
H1S1-07-10,3,5614726
H1S1-07-10,4,5604967
H1S1-07-10,4,5604947
H1S1-07-10,3,5604935
H1S1-07-10,3,5604934
H1S1-07-10,3,5604933
H1S1-07-10,3,5604932
H1S1-07-10,4,5604931
H1S1-07-10,4,5604929
H1S1-07-10,3,5604884
H1S1-07-10,3,5604883
H1S1-07-10,3,5604882
H1S1-07-10,2,5604880
M1S1-07-21,4,5732251
HSTA-03-01,3,6065515
H1S1-07-11,3,5604836
H1S1-07-11,3,5604835
H1S1-07-11,3,5604834
H1S1-07-11,3,5604833
H1S1-07-11,3,5559912
H1S1-07-12,3,5656952
H1S1-07-12,3,5656951
H1S1-07-12,4,5616367
H1S1-07-12,3,5616365
H1S1-07-12,4,5614729
H1S1-07-12,3,5560374
H1S1-07-12,2,5560285
H1S1-07-12,2,5560127
HSTA-07-08,3,5173862
HSU1-08-03,2,3975218
HSU2-01-06,3,3975220
HCAL-01-12,3,3975221
H1S1-07-13,3,5656956
H1S1-07-13,3,5656955
H1S1-07-13,3,5656954
H1S1-07-13,3,5616369
H1S1-07-13,3,5560376
H1S1-07-13,3,5560375
H1S1-07-13,3,5560373
H1S1-07-13,3,5560291
H1S1-07-13,3,5560290
HSU2-01-02,2,1095892
HSU1-03-13,2,5573389
H1S1-07-13,3,5560134
H1S1-07-13,3,5560133
H1S1-07-13,3,5560132
H1S1-07-13,3,5560131
H1S1-07-13,3,5560094
H1S1-07-14,3,5657080
H1S1-07-14,3,5657079
H1S1-07-14,4,5656959
H1S1-07-14,3,5656957
M2S1-09-14,3,3305866
H1S2-02-02,2,1095895
H1S1-07-14,3,5560286
HSU1-03-14,3,5827528
HSU1-10-12,3,5847996
H1S1-07-15,3,5560378
H1S1-07-16,3,5657083
H1S1-07-16,3,5656953
H1S1-07-16,3,5560390
H1S1-07-17,3,5657082
H1S1-07-17,3,5656966
H1S1-07-17,3,5656965
H1S1-07-17,2,5656964
H1S1-07-17,3,5560292
H1S1-07-17,3,5560135
H1S1-07-18,3,5656961
H1S1-07-18,3,5656960
H1S1-07-18,3,5616356
H1S1-07-18,3,5616355
H1S1-07-18,3,5616354
H1S1-07-18,3,5616352
H1S1-07-18,3,5614727
H1S1-07-18,3,5607544
H1S1-07-18,4,5607542
H1S1-07-18,4,5607540
H1S1-07-18,3,5607538
H1S1-07-18,3,5607536
H1S1-07-18,3,5607534
H1S1-07-18,3,5560380
HSU1-07-17,3,5843207
H1S1-07-18,3,5560311
M2S1-09-16,3,5741247
HSU1-07-12,1,5843200
H1S1-07-19,3,5656963
H1S1-07-19,3,5656962
HSU1-02-10,3,5827261
M1S1-08-06,3,5525598
HSTA-03-01,3,6065511
M1S1-04-21,1,6106459
H1S1-08-01,2,5657084
H1S1-08-01,3,5657022
H1S1-08-01,3,5657020
H1S1-08-01,3,5657019
H1S1-08-01,2,5657018
H1S1-08-01,2,5560471
H1S1-08-01,2,5560469
H1S1-08-01,2,5560468
HSTA-03-01,1,6065509
H1S1-08-01,3,5560465
H1S1-08-01,2,5560464
H1S1-08-01,2,5560436
H1S1-08-01,2,5560434
H1S1-08-01,2,5560433
H1S1-08-01,2,5560432
H1S1-08-01,2,5560429
H1S1-08-01,2,5560428
H1S1-08-01,2,5560405
H1S1-08-01,2,5560404
H1S1-08-01,2,5560403
H1S1-08-01,2,5560401
H1S1-08-01,2,5560398
HSTA-05-05,3,5177330
H1S2-04-16,3,3975222
H1S1-08-08,3,5657027
H1S1-08-08,3,5657026
H1S1-08-08,3,5657025
H1S1-08-08,3,5657023
H1S1-08-08,2,5608159
H1S1-08-08,2,5608158
H1S1-08-08,2,5608157
H1S1-08-08,2,5608156
H1S1-08-08,2,5608155
H1S1-08-08,2,5608154
H1S1-08-08,3,5560518
H1S1-08-08,3,5560513
H1S1-08-08,3,5560466
H1S1-08-08,3,5560431
H1S1-08-08,3,5560430
H1S1-08-08,2,5560400
H1S1-08-08,2,5560399
H1S1-08-11,3,5657085
H1S1-08-11,3,5657043
H1S1-08-11,3,5657032
H1S1-08-12,3,5657086
H1S1-08-12,3,5657033
H1S1-08-12,3,5657031
H1S1-08-12,3,5657030
H1S1-08-12,3,5657029
H1S1-08-12,4,5560504
H1S1-08-12,3,5560474
H1S1-08-12,4,5560441
H1S2-06-10,3,3975224
H1S1-08-14,3,5657087
H1S1-08-14,3,5560473
H1S1-08-14,3,5560438
H1S1-08-16,3,5657050
H1S1-08-16,3,5657049
H1S1-08-16,4,5657039
H1S1-08-16,3,5657038
H1S1-08-16,3,5657037
H1S1-08-16,3,5560507
HSU1-10-09,3,3975225
H1S1-08-17,4,5657035
H1S1-08-20,3,5657040
H1S1-08-20,3,5560788
H1S1-08-20,3,5560787
H1S2-03-16,3,3975226
HSU2-01-11,3,3975227
HSU2-02-06,3,3975228
HCAL-02-01,3,3975229
H1S2-04-17,4,3975230
H1S1-08-21,4,5657041
H1S1-08-23,3,5657061
H1S1-08-23,4,5657059
H1S1-08-23,3,5606309
H1S1-08-23,2,5606306
H1S1-08-23,2,5606304
H1S1-08-23,1,5606303
H1S1-08-23,4,5606301
H1S1-08-23,2,5606300
H1S1-08-23,3,5606298
H1S2-04-10,4,3975231
H1S1-08-23,2,5606294
H1S1-08-23,2,5606292
H1S1-08-23,3,5560791
H1S1-08-24,3,5656880
H1S1-08-24,3,5656879
H1S1-08-24,3,5656878
H1S1-08-24,3,5656877
H1S1-08-24,3,5607517
H1S1-08-24,3,5607514
H1S1-08-24,3,5607512
H1S1-08-24,3,5607509
H1S1-08-24,3,5607508
H1S1-08-24,3,5607506
H1S1-08-24,3,5607504
H1S1-08-24,3,5607503
H1S1-08-24,3,5607502
H1S1-08-24,3,5607501
H1S1-09-01,3,5657126
H1S1-09-01,2,5657125
H1S1-09-02,3,5677976
H1S1-09-02,3,5657128
H1S1-09-02,2,5657127
H1S1-09-03,3,5657130
H1S1-09-03,3,5657129
H1S1-09-04,4,5657137
H1S1-09-04,3,5657134
H1S1-09-04,3,5657133
H1S1-09-05,4,5677981
H1S1-09-05,4,5657135
H1S1-09-05,4,5657132
H1S1-09-05,3,5657131
HSU2-01-16,4,3975232
H1S1-09-07,3,5677979
H1S1-09-07,2,5657138
H1S1-09-08,4,5677977
H1S1-09-08,3,5657139
H1S1-09-09,3,5677171
H1S1-09-09,3,5657142
H1S1-09-09,3,5657141
H1S2-03-25,4,3975233
HSU1-11-11,4,3975234
HSU1-10-05,4,3975235
H1S1-09-10,3,5657140
H1S1-09-11,3,5657145
H1S1-09-11,3,5657144
HSU1-02-04,2,5570308
H1S1-10-01,3,5677225
H1S1-10-01,2,5677208
H1S1-10-01,3,5677193
H1S1-10-01,3,5677175
H1S1-10-01,3,5677172
H1S1-10-02,3,5677222
H1S1-10-03,3,5677194
HSU1-03-13,2,5828280
H1S1-10-05,3,5677983
H1S1-10-05,3,5677228
H1S1-10-05,4,5677199
H1S1-10-05,3,5677195
H1S1-10-05,3,5677190
M2S1-02-03,1,5592766
H1S1-10-06,2,5677201
H1S1-10-06,2,5677200
H1S1-10-07,3,5677227
H1S1-10-07,3,5677226
H1S1-10-08,3,5677207
H1S1-10-08,2,5677205
H1S1-10-08,3,5677204
H1S1-10-09,3,5677209
H1S1-10-10,4,5677219
H1S1-10-10,4,5677218
H1S1-10-11,3,5677231
H1S1-10-11,2,5677230
H1S1-10-12,3,5677237
H1S1-10-12,3,5677232
H1S1-10-13,4,5677238
H1S1-10-13,3,5677236
H1S1-10-13,3,5677235
H1S1-10-14,3,5677994
H1S1-10-14,4,5677245
HSU1-03-09,3,5573369
H1S1-10-16,4,5677244
H1S1-11-01,4,5677921
H1S1-11-01,3,5677914
H1S1-11-01,3,5677913
H1S1-11-01,2,5677910
H1S1-11-02,4,5677997
H1S1-11-02,3,5677911
H1S1-11-03,2,5677915
H1S1-11-04,3,5677912
H1S1-11-05,3,5677998
H1S1-11-05,3,5677918
H1S1-11-05,3,5677917
H1S1-11-05,3,5677916
H1S1-11-06,3,5677920
H1S1-11-06,3,5677919
H1S1-11-08,4,5678000
H1S1-11-09,4,5678001
H1S1-11-09,2,5677929
H1S1-11-11,4,5677955
H1S1-11-11,3,5677945
HSU1-02-17,3,5304466
H1S1-11-11,2,5677931
H1S1-11-12,3,5678003
H1S1-11-12,3,5677957
H1S1-11-12,3,5677954
H1S1-11-13,3,5677952
H1S1-11-13,2,5677932
H1S1-11-10,3,5677965
H1S1-11-10,3,5677963
H1S1-11-10,3,5677961
H1S1-11-10,2,5677959
H1S1-11-16,2,5677968
H1S1-11-17,3,5678005
H1S1-11-17,3,5677970
H1S1-11-17,3,5677969
H1S1-11-18,4,5677974
H1S1-11-18,4,5677973
H1S1-11-18,3,5677972
H1S1-11-18,3,5677971
H1S1-11-19,3,5677923
H1S1-11-19,3,5677922
H1S1-03-05,3,5846631
H1S1-03-05,3,5846638
H1S1-03-07,3,5846640
H1S1-05-12,3,5847015
H1S1-07-04,3,5847073
H1S1-07-06,3,5847104
H1S1-07-06,3,5847107
H1S1-07-03,3,5847126
H1S1-07-04,3,5847152
H1S1-07-04,3,5847163
H1S1-07-17,3,5847246
H1S1-07-17,3,5847247
H1S1-07-17,3,5847267
H1S1-08-10,3,5847304
H1S1-08-10,3,5847349
H1S1-08-10,3,5847301
H1S1-08-10,3,5847302
H1S1-08-11,3,5847313
H1S1-08-11,3,5847314
H1S1-08-11,3,5847316
H1S1-08-11,3,5847340
H1S1-08-17,3,5847342
H1S1-08-17,3,5847317
M2S1-01-08,3,6106365
M2S1-10-06,3,5741240
H1S1-05-07,3,5838863
H1S1-05-06,3,5838890
H1S1-05-11,3,5838982
H1S1-08-02,3,5840952
H1S1-09-01,3,5846231
H1S1-09-04,3,5846247
H1S1-09-04,3,5846263
H1S1-09-06,3,5846268
H1S1-09-12,3,5846269
H1S1-09-12,3,5846270
H1S1-09-12,3,5846278
H1S1-09-12,3,5846279
H1S1-10-04,3,5846313
M1S1-01-08,3,5411161
M1S1-05-04,4,5531589
H1S1-10-06,3,5846316
H1S1-10-05,3,5846319
H1S1-10-05,3,5846320
H1S1-10-05,3,5846321
HSTA-07-14,3,5185406
HSTA-07-03,3,5581985
H1S1-10-16,3,5846355
H1S1-10-16,3,5846356
H1S1-10-16,3,5846357
H1S1-10-16,3,5846358
HSTA-03-01,2,6065510
H1S1-11-05,3,5846560
H1S1-11-05,3,5846561
H1S1-11-09,3,5846586
H1S1-11-09,3,5846585
H1S1-11-09,3,5846584
H1S1-11-09,3,5846583
H1S1-11-08,3,5846582
H1S1-11-08,3,5846581
HSTA-07-14,3,5175253
H1S1-11-05,3,5846652
H1S1-12-04,3,5846699
H1S1-12-09,3,5846723
H1S1-12-09,3,5846725
H1S1-12-09,3,5846727
HSU1-10-02,4,3975236
H1S1-12-09,3,5846756
H1S1-12-09,3,5846758
H1S1-06-05,3,5849493
H1S1-06-05,3,5849494
H1S1-06-05,3,5849495
H1S1-08-18,3,5849515
H1S1-08-18,3,5849514
H1S1-06-09,3,5849512
H1S1-06-07,3,5849511
H1S1-06-07,3,5849509
H1S1-06-07,3,5849510
H1S1-06-08,3,5849516
H1S1-08-18,3,5849517
H1S1-06-08,3,5849518
H1S1-06-08,3,5849519
H1S1-06-09,3,5849513
H1S1-08-18,3,5849573
H1S1-08-15,3,5849541
H1S1-10-04,3,5834074
HSU1-10-08,5,3975238
HCAL-01-04,2,3975239
HSU1-02-03,2,3975240
H1S1-09-01,3,5626615
HCAL-01-14,3,3975241
HCAL-02-04,3,3975242
HSU2-02-05,4,3975243
H1S2-02-15,4,3975244
H1S1-11-05,3,5626638
HSU1-02-01,4,3975245
HCAL-02-16,4,3975246
H1S1-10-03,3,5628327
H1S1-10-03,3,5628328
H1S1-10-04,3,5628329
H1S1-10-04,3,5628330
H1S1-10-06,3,5628331
H1S1-10-06,3,5628332
HSU2-02-03,5,3975247
HSU1-01-02,2,3975251
H1S2-02-02,2,3975252
H1S1-09-04,3,5628355
H1S1-11-08,3,5628378
H1S1-11-08,3,5628380
H1S1-11-09,3,5628381
H1S1-11-09,3,5628382
H1S1-11-07,3,5628410
H1S1-12-04,3,5628418
H1S1-06-09,3,5628569
H1S1-06-08,3,5628572
HSU1-01-01,1,5570203
HSU1-01-01,1,5570204
HSU1-01-01,2,5570205
HSU1-01-01,3,5570206
HSU1-01-01,2,5570209
HSU1-01-01,2,5570210
HSU1-01-01,1,5570211
HSU1-01-01,1,5570212
HSU1-01-01,1,5570213
HSU1-01-02,2,5570214
HSU1-01-02,2,5570215
HSU1-01-02,3,5570216
HSU1-01-02,4,5570218
M2S1-10-10,3,3305863
HSU1-01-02,3,5570220
HSU1-01-03,4,5570221
HSU1-01-03,3,5570222
HSU1-01-04,3,5570225
HSU1-01-04,3,5570226
HSU1-01-05,1,5570227
HSU1-01-05,2,5570228
HSU1-01-05,2,5570230
HSU1-01-05,4,5570233
HSU1-01-05,2,5570234
HSU1-01-05,3,5570235
HSU1-01-05,3,5570236
HSU1-01-05,2,5570238
HSU1-01-05,4,5570239
HSU1-01-05,3,5570248
HSU1-01-05,4,5570252
HSU1-01-07,3,5570243
HSU1-01-07,3,5570244
M2S1-05-11,3,6038094
HSU1-03-13,2,5828281
M2S1-05-11,3,6038096
M2S1-05-12,2,6038098
HSU1-01-07,2,5823994
HSU1-01-10,3,5570245
HSU1-01-11,2,5570257
HSU1-01-11,3,5570258
HSU1-01-11,4,5570263
HSU1-01-12,3,5570260
HSU1-01-12,3,5570261
HSU1-01-12,4,5570262
HSU1-01-12,5,5570267
HSU1-01-13,3,5570246
HSU1-01-13,4,5570247
HSU1-02-01,1,5570268
HSU1-02-01,1,5570269
HSU1-02-01,1,5570270
HSU1-02-01,1,5570273
HSU1-02-01,2,5570274
HSU1-03-06,4,5573355
HSU1-02-01,2,5570277
HSU1-02-01,4,5570281
HSU1-02-02,2,5570278
HSU1-02-02,3,5570279
HSU1-02-02,3,5570282
HSU1-10-09,3,5842909
HSU1-02-03,1,5570284
HSU1-02-03,2,5570285
HSU1-02-03,2,5570286
HSU1-02-03,1,5570287
HSU1-02-03,3,5570288
HSU1-02-03,3,5570289
HSU1-02-03,3,5570290
HSU1-02-03,3,5570291
HSU1-02-03,3,5570292
HSU1-02-03,3,5570293
HSU1-02-03,3,5570299
HSU1-02-03,4,5570302
M2S1-09-15,3,5741250
HSU1-02-04,3,5570310
HSU1-02-04,4,5570312
HSU1-02-05,1,5570325
HSU1-02-05,2,5570326
HSU1-02-05,1,5570327
HSU1-02-05,2,5570328
HSU1-02-05,3,5570329
HSU1-02-06,3,5570303
HSU1-02-06,4,5570305
HSU1-02-06,4,5570313
HSU1-02-06,4,5570314
M2S1-05-12,2,6038100
HSU1-02-08,4,5570316
HSU1-02-08,3,5570317
HSU1-02-10,3,5570337
HSU1-02-10,2,5570354
HSU1-02-10,2,5570355
HSU1-02-10,2,5570356
HSU1-02-11,4,5570318
HSU1-02-11,3,5570319
HSU1-02-11,3,5570322
HSU1-02-11,4,5570323
HSU1-02-12,1,5570332
HSU1-02-12,1,5570333
HSU1-02-12,2,5570335
HSU1-02-12,2,5570361
HSU1-02-13,5,5570375
HSU1-07-12,2,5843202
HSU1-02-10,3,5570371
M1S1-05-03,2,5525711
HSU1-10-16,3,6038810
HSU1-02-17,3,5570338
HSU1-02-17,4,5570345
HSU1-02-17,4,5570346
HSU1-02-17,4,5570347
HSU1-03-01,2,5573322
HSU1-03-01,3,5573331
HSU1-03-01,4,5573332
HSU1-03-02,3,5573336
HSU1-03-03,4,5573338
HSU1-03-03,3,5573343
HSU1-03-03,2,5573344
HSU1-03-03,4,5573345
HSU1-03-03,3,5573346
HSU1-03-03,3,5573347
HSU1-03-03,3,5573348
HSU1-03-03,4,5573349
HSU1-03-03,3,5573350
HSU1-03-04,3,5573340
HSU1-03-06,4,5573356
HSU1-03-06,3,5573359
HSU1-03-07,3,5573363
HSU1-03-08,3,5573365
HSU1-03-08,3,5573366
HSU1-03-09,3,5573368
M2S1-05-13,2,6038101
HSTA-01-04,3,5188018
HSU1-03-10,3,5573371
HSU1-03-11,1,5573378
HSU1-03-11,2,5573379
HSU1-03-11,2,5573380
HSU1-03-11,1,5573381
HSU1-03-11,3,5573382
HSU1-03-11,2,5573384
HSU1-03-12,3,5573392
HSU1-03-12,3,5573393
HSU1-03-12,4,5573394
HSU1-03-12,4,5573395
M2S1-05-13,3,6038103
M2S1-06-10,2,6038104
M2S1-06-10,2,6038105
M2S1-06-10,3,6038106
HSU1-11-10,3,5310374
M1S1-08-06,2,5525843
HCAL-01-04,2,3975253
HSU1-10-04,3,3975254
H1S2-04-10,3,3975255
HSU2-01-02,3,3975256
H1S2-05-15,3,3975257
H1S2-03-16,3,3975258
H1S2-02-01,3,3975259
H1S2-06-07,3,3975260
H1S2-02-15,3,3975261
HSU2-01-04,3,3975262
H1S2-04-22,3,3975263
HSU1-02-12,4,3975264
HSU1-10-09,4,3975265
H1S2-03-25,4,3975266
HSU1-11-11,4,3975267
HCAL-01-18,4,3975268
HCAL-02-16,4,3975269
H1S2-04-02,4,3975270
HCAL-01-17,5,3975271
HSU2-01-02,2,3975273
HSU1-08-03,2,3975274
HCAL-02-04,3,3975275
HSU1-11-05,3,3975276
H1S1-10-07,4,3975277
HSU2-02-06,4,3975278
HSU1-03-12,4,5573396
HSU1-03-12,4,5573397
HSU1-03-13,3,5573385
HSU1-03-13,2,5573391
HSU1-03-16,1,5573405
HSU1-03-17,3,5573410
HSU1-03-17,3,5573412
HSU1-03-17,3,5573413
HSU1-03-17,3,5573414
HSU1-03-18,3,5573416
HSU1-03-18,3,5573417
HSU1-04-01,3,5573430
HSU1-04-01,3,5573431
HSU1-04-03,2,5573441
HSU1-04-03,3,5573443
HSU1-04-03,3,5573445
HSU1-04-03,3,5573447
HSU1-04-03,3,5573449
HSU1-04-03,4,5573450
HSU1-04-06,3,5573433
HSU1-04-06,4,5573436
HSU1-04-06,5,5573437
HSU1-04-06,5,5573438
HSU1-04-06,5,5573439
HSU1-04-07,3,5573451
HSU1-04-07,3,5573452
HSU1-04-07,2,5573453
HSU1-04-07,3,5573454
HSU1-04-07,4,5573456
HSU1-04-07,2,5573457
HSU1-04-07,4,5573460
HSU1-04-09,4,5573455
HSU1-04-09,4,5573458
M2S1-02-03,1,5592754
HSU1-04-09,4,5573466
HSU1-04-10,4,5573459
HSU1-04-05,2,5573468
HSU1-03-05,3,5837898
HSU1-05-05,4,5163173
HSU1-04-05,4,5573471
HSU1-04-11,3,5573472
HSU1-04-11,2,5573473
HSU1-04-11,2,5573474
HSU1-04-11,3,5573477
HSU1-04-12,3,5573475
HSU1-04-12,4,5573476
HSU1-07-17,2,5849836
HSU1-09-06,3,6065352
HSU1-04-12,4,5573480
M2S1-06-10,3,6038107
M2S1-06-10,3,6038108
M2S1-06-19,4,6038109
HSU1-01-01,1,5575986
HSU1-01-01,1,5575987
HSU1-01-02,2,5575971
HSU1-01-02,3,5575988
HSU1-01-04,2,5575991
HSU1-01-05,1,5575994
HSU1-01-05,1,5575995
HSU1-01-05,1,5575996
M2S1-06-19,3,6038110
HSU1-01-07,2,5575999
HSU1-01-07,4,5576000
HSU1-01-07,3,5576001
HSU1-01-07,3,5576002
M2S1-06-19,3,6038111
HSU1-01-08,1,5576003
HSU1-01-11,2,5576005
HSU1-01-11,4,5575972
HSU1-01-12,3,5576004
M2S1-06-19,5,6038112
HSU1-02-01,2,5576355
HSU1-02-02,3,5576017
HSU1-02-03,3,5576018
EXEP-01-01,2,5367970
HSU1-02-05,3,5576359
HSU1-02-05,3,5576360
HSU1-02-06,3,5576361
HSU1-02-08,3,5576357
HSU1-02-12,2,5576362
HSU1-02-12,2,5576363
HSU1-02-14,4,5576021
HSU1-02-14,4,5576374
HSU1-02-15,3,5576375
HSU1-02-17,3,5576376
HSU1-02-17,3,5576377
HSU1-03-01,3,5576606
HSU1-03-01,3,5577188
HSU1-03-03,3,5576607
HSU1-03-03,4,5577190
HSU1-03-03,3,5577191
HSU1-03-03,2,5577192
HSU1-02-10,3,5576369
HSU1-03-07,2,5577194
HSU1-03-07,3,5577195
HSU1-03-08,3,5577196
HSU1-03-09,3,5576608
HSU1-03-10,3,5577197
HSU1-03-11,1,5577198
HSU1-03-12,3,5577199
HSU1-03-12,5,5577200
HSU1-03-16,2,5577202
HSU1-03-17,3,5576610
HSU1-03-17,4,5577203
HSU1-03-17,3,5577204
HSU1-03-21,3,5577206
HSU1-04-01,3,5576611
HSU1-04-02,2,5577207
HSU1-04-03,3,5576612
HSU1-04-03,3,5577212
HSU1-04-05,2,5577209
HSU1-04-06,3,5577208
HSU1-04-06,4,5577213
HSU1-04-07,4,5576613
HSU1-04-07,2,5577214
HSU1-04-09,4,5577215
HSU1-04-10,3,5577216
HSU1-04-11,3,5577217
HSU1-04-11,3,5577218
HSU1-04-13,4,5577220
HSU1-04-15,2,5576615
M2S1-06-19,2,6038113
HSU1-04-17,3,5577226
HSU1-08-02,2,5576438
HSU1-08-03,2,5576067
HSU1-08-03,2,5576439
HSU1-08-03,3,5576441
HSU1-08-03,2,5576443
HSU1-08-03,3,5576444
HSU1-08-03,3,5576445
HSU1-08-04,3,5576446
HSU1-08-05,3,5576442
HSU1-08-07,3,5576447
HSU1-08-07,3,5576448
HSU1-08-07,3,5576450
HSU1-08-09,2,5576069
HSU1-08-09,3,5576452
HSU1-08-09,3,5576454
HSU1-08-10,3,5576458
HSU1-08-11,3,5576456
HSU1-08-12,3,5576453
HSU1-08-15,3,5576073
HSU1-08-15,3,5576473
HSU1-09-01,2,5576070
HSU1-09-01,3,5576463
M2S1-06-19,2,6038114
HSU1-09-03,3,5576466
HSU1-09-03,3,5576468
HSU1-09-04,2,5576071
HSU1-09-05,3,5576467
HSU1-09-09,3,5576469
HSU1-09-09,4,5576471
HSU1-09-11,3,5576474
HSU1-09-12,3,5576074
HSU1-09-12,3,5576475
HSU1-09-12,5,5576476
HSU1-10-01,2,5576480
M2S1-06-19,2,6038116
HSU1-10-04,1,5576075
HSU1-10-04,1,5576076
M2S1-07-03,2,6038117
M1S1-05-04,2,5525708
M1S1-03-01,2,5585990
HSU1-09-05,3,5843773
HSTA-07-12,3,6065539
M1S1-08-07,3,6037768
M1S1-06-03,3,5411290
HSU1-10-03,4,3975279
HSU1-02-03,4,3975280
HSU2-01-16,5,3975281
H1S1-04-02,2,3975115
H1S1-01-02,2,3975116
H1S1-08-10,2,3975117
H1S1-02-02,3,3975118
H1S1-01-09,3,3975119
H1S1-02-01,3,3975120
H1S1-08-08,3,3975121
H1S1-07-05,3,3975122
H1S1-06-02,3,3975123
H1S1-07-12,3,3975124
HSU1-10-04,1,5576477
HSU1-10-04,2,5576478
HSU1-10-04,2,5576479
HSU1-10-08,3,5576077
M2S1-07-03,2,6038118
HSU1-10-05,3,5576481
HSU1-10-05,3,5576482
HSU1-02-03,2,1095897
HSU1-10-05,3,5576484
M2S1-07-03,3,6038119
M2S1-07-03,3,6038120
M2S1-07-06,3,6038121
HSU1-10-05,4,5576488
HSU1-10-05,4,5576489
HSU1-10-06,3,5576490
HSU1-10-10,3,5576496
HSU1-10-11,3,5576492
HSU1-10-11,3,5576493
HSU1-10-11,5,5576494
HSU1-10-11,4,5576498
HSU2-01-08,3,1095901
HSU1-10-12,3,5576495
M2S1-07-07,2,6038122
HSU2-03-11,3,1095903
M2S1-02-03,1,5592753
HSU1-03-05,3,5837912
HSU1-10-08,2,5843796
HSU1-11-04,3,5576513
H1S2-04-10,3,1095910
HSU1-11-05,4,5576516
HSU1-11-11,3,5576107
HSU1-11-11,3,5576505
HSU1-10-16,3,5827437
HSU2-01-02,3,1095911
M2S1-09-15,3,6037737
M2S1-07-05,3,5367975
HSU1-05-03,3,5575824
HSU1-05-03,2,5575826
HSU1-05-06,1,5575735
HSU1-05-06,3,5575829
HSU1-05-06,3,5575830
HSU1-05-06,3,5575831
HSU1-05-06,4,5575832
HSU1-05-06,2,5576773
HSU1-05-06,4,5576776
HSU1-05-07,3,5576775
HSU1-05-08,3,5575749
HSU1-05-08,2,5575873
HSU1-05-08,3,5575874
HSU1-05-08,3,5575879
HSU1-05-09,3,5575883
HSU1-05-09,3,5575890
HSU1-05-09,3,5576779
HSU1-02-10,3,5576368
HSU1-05-10,3,5575913
HSU1-05-10,4,5576781
HSU1-05-11,3,5575909
HSU1-05-12,3,5575892
HSU1-05-12,3,5576778
HSU1-05-13,3,5575908
HSU1-05-13,3,5576780
HSU1-06-03,3,5576042
HSU1-06-04,3,5576033
HSU1-06-04,3,5576036
HSU2-07-05,3,1095913
HSU1-06-05,3,5576037
HSU1-06-05,3,5576040
HSU1-06-05,3,5576972
HSU1-06-05,3,5576973
HSU1-06-05,3,5576985
HSU1-06-06,3,5576041
HSU1-06-06,3,5576992
HSU1-06-06,3,5577005
HSU1-06-07,3,5576044
HSU1-06-07,3,5576986
HSU1-06-07,3,5576988
HSU1-06-08,4,5577006
HSU1-06-10,2,5575761
HSU1-06-10,3,5575918
HSU1-06-10,3,5575920
HSU1-06-10,3,5575933
HSU1-06-10,3,5576782
HSU1-06-10,3,5576783
HSU1-06-11,3,5575938
HSU1-06-16,3,5576045
HSU1-06-16,3,5576997
HSU1-06-18,2,5576051
HSU1-06-18,2,5576052
HSU1-06-19,4,5576053
HSU1-06-19,3,5577002
HSU1-06-23,2,5576054
HSU1-06-24,3,5576055
HSU1-06-24,3,5576056
HSU1-06-24,3,5577003
HSU1-06-25,3,5576057
HSU1-06-25,3,5577004
M1S1-07-05,3,5587221
HSU1-09-08,4,5576470
HSU1-07-01,3,5576087
HSU1-07-01,2,5577094
HSU1-07-02,3,5576088
HSU1-07-02,4,5576089
HSU1-07-04,3,5576090
M1S1-03-04,4,5586144
HSU1-07-06,3,5576095
M3S1-10-13,3,4984150
HSU1-07-06,4,5576106
HSU1-07-07,2,5577099
HSU1-07-07,4,5576096
HSU1-07-07,4,5576097
HSU1-07-07,4,5576098
HSU1-07-08,3,5576099
HSU1-07-08,3,5577101
HSU1-07-09,3,5576102
HSU1-07-09,3,5577098
HSU1-07-11,2,5576065
HSU1-07-11,3,5576111
HSU1-07-11,4,5576113
HSU1-07-13,3,5576108
HSU1-05-02,3,5628684
M1S1-09-01,2,5532097
HSU1-05-03,2,5628645
HSU1-05-04,3,5626695
HSU1-05-06,2,5626696
HSU1-05-06,3,5628647
HSU1-05-06,4,5628650
HSU1-05-06,1,5628687
HSU1-05-06,4,5628702
HSU1-05-07,3,5628649
HSU1-05-08,2,5628652
HSU1-05-08,4,5628653
HSU1-05-08,3,5626698
HSU1-05-08,5,5628704
HSU1-05-10,3,5628690
HSU1-05-10,2,5628667
HSTA-06-12,4,5187184
HSU1-05-11,3,5628688
HSU1-05-11,3,5628689
HSU1-05-11,3,5628660
HSU1-05-11,1,5626699
HSU1-05-11,2,5628658
HSU1-05-11,2,5628663
HSU1-05-11,3,5628664
HSU1-05-11,3,5628668
HSU1-05-11,4,5628670
HSU1-05-11,3,5628699
HSU1-05-12,2,5628665
HSU1-05-13,3,5628693
HSU1-05-13,4,5628695
HSU1-06-01,3,5628707
HSU1-06-05,2,5628710
HSU1-06-05,3,5628711
HSU1-06-05,4,5628731
HSU1-06-05,3,5626703
HSU1-06-05,2,5628727
HSU1-06-07,3,5628712
HSU1-06-07,3,5628728
HSU1-06-07,2,5628730
HSU1-06-10,3,5628698
HSU1-06-10,3,5626700
HSU1-06-10,3,5626701
HSU1-06-10,3,5628675
HSU1-06-10,3,5628677
HSU1-06-10,3,5628678
H1S1-07-12,3,3975125
H1S1-07-01,3,3975126
H1S1-04-06,3,3975127
H1S1-03-10,4,3975128
H1S1-03-11,4,3975129
H1S1-06-08,4,3975130
EXEP-01-01,4,3975131
H1S1-06-02,4,3975132
H1S1-07-16,4,3975133
H1S1-07-11,4,3975134
H1S1-01-02,5,3975135
H1S1-03-10,2,3975136
HSU1-06-10,5,5628705
HSU1-06-11,3,5628682
HSU1-06-11,3,5628681
HSU1-06-15,3,5628738
HSU1-06-16,3,5628734
H1S2-05-15,3,1095914
M2S1-03-10,3,5593399
H1S2-06-10,3,1095916
HSU1-06-19,4,5628715
HSU1-03-07,1,5573362
HSU1-06-19,3,5628717
HSU1-06-21,4,5628714
M2S1-09-14,3,5597120
HSU1-01-09,3,1095918
HSU1-06-23,4,5628718
HSU1-06-23,3,5628719
HSU1-06-23,4,5628721
HSU1-06-23,3,5628722
HSU1-06-23,3,5628723
HSU1-06-23,4,5628736
HSU1-11-05,3,1095928
M2S1-02-03,1,5592755
HSU1-06-25,3,5628724
HSU1-06-25,3,5628735
HSU1-07-01,2,5628740
HSU1-07-01,3,5628744
HSU1-07-01,1,5626709
HSU1-07-01,2,5628745
HSU1-07-01,2,5628759
HSU1-07-02,2,5626716
HSU1-07-02,2,5628742
HSU1-07-02,3,5628760
HSU1-07-02,3,5628761
HSU1-07-03,3,5628758
HSU1-07-06,1,5626713
HSU1-07-07,2,5628749
HSU1-07-07,3,5628766
HSU1-07-07,4,5628769
HSU1-07-07,5,5628771
HSU1-07-09,3,5628750
HSU1-07-11,3,5628752
HSU1-07-11,3,5628753
HSU1-07-11,3,5628755
HSU1-03-02,1,5573334
HSU1-07-11,3,5628768
HSU1-05-07,3,5843169
HSU1-05-07,3,5843160
HSU1-07-12,3,5843245
M2S1-09-15,3,5741110
HSU1-06-14,3,5843131
HSU1-06-18,2,5843137
HSU1-06-18,3,5843149
HSU1-06-18,3,5843154
HSU1-06-18,3,5843155
HSU1-06-19,3,5843156
HSU1-07-02,1,5843188
HSU1-07-01,3,5843190
HSU1-07-02,3,5843191
HSU1-05-10,2,5164553
HSU1-07-10,2,5843228
M1S1-05-04,2,5586363
HSU1-07-12,2,5843203
HSU1-07-12,1,5843205
M1S1-07-08,3,5530320
HSU1-07-12,3,5843216
HSU1-06-13,4,5843231
HSU1-06-01,3,5843234
HSU1-06-18,4,5843235
HSU1-07-01,3,5843237
HSU1-02-04,3,5824046
M1S1-09-07,2,5415941
HSU1-08-09,3,5824298
HSU1-08-09,3,5824301
HSU1-09-08,3,5824324
EXEP-01-01,3,5531382
HSU1-01-07,3,5827226
HSU1-01-10,3,5827234
HSU1-01-13,4,5827240
HSU1-01-07,4,5827244
HSU1-01-14,3,5827246
HSU1-03-01,3,5827252
HSU1-02-05,3,5827258
HSU1-02-05,3,5827263
HSU1-02-05,3,5827266
HSU1-02-10,4,5827270
HSU1-02-04,3,5827272
HSU1-02-10,3,5827276
HSU1-02-04,3,5827283
HSU1-04-10,3,5827285
M1S1-06-03,3,5410865
HSU1-02-10,4,5827288
HSU1-08-09,3,5827360
HSU1-09-09,3,5827367
HSU1-08-15,3,5827369
HSU1-08-10,3,5827377
HSU1-09-09,3,5827383
HSU1-09-02,3,5827384
HSU1-09-08,3,5827386
HSU1-09-11,3,5827387
H1S1-05-08,2,3975137
H1S1-08-20,3,3975138
H1S1-05-02,3,3975139
H1S1-02-12,4,3975140
H1S1-06-05,4,3975141
H1S1-07-16,4,3975142
H1S1-02-03,4,3975143
H1S1-03-06,5,3975144
H1S2-02-01,2,3722491
HSU1-01-05,2,3722482
H1S2-07-15,2,3722483
HSU1-10-04,3,3722484
H1S2-04-16,3,3722485
H1S2-07-25,3,3722486
H1S2-06-07,3,3722487
H1S2-01-10,3,3722488
H1S2-05-15,3,3722489
HSU2-01-02,3,3722490
HSU1-11-05,3,3722492
HSU1-02-02,3,3722493
HSU2-02-05,3,3722494
HCAL-01-14,4,3722495
H1S2-03-06,4,3722496
HCAL-01-18,4,3722497
HSU2-01-13,4,3722498
HCAL-02-16,4,3722499
HSU1-02-05,4,3722500
HSU1-10-08,4,3722501
HSTA-02-03,5,3722502
HCAL-01-02,2,3722503
HCAL-02-01,2,3722504
HSU1-09-04,3,3722505
HSTA-02-05,3,3722506
H1S2-04-13,4,3722507
HSU1-01-09,4,3722508
HSU1-10-02,4,3722509
HSTA-02-09,4,3722510
HSU2-02-03,5,3722513
HCAL-03-04,2,3722432
HSU1-05-06,2,3722433
EXEP-01-01,2,3722434
HSU1-03-07,3,3722438
HCAL-09-02,3,3722439
HCAL-07-02,3,3722440
H1S2-07-25,3,3722441
HCAL-05-10,3,3722442
HSU1-06-23,3,3722443
HSTA-02-05,3,3722444
HCAL-05-04,3,3722445
EXEP-01-01,3,3722446
HCAL-08-09,3,3722447
HSU1-04-06,4,3722448
HCAL-10-04,4,3722449
HCAL-06-06,4,3722450
HCAL-03-07,4,3722451
EXEP-01-01,4,3722452
H1S2-07-17,4,3722453
HCAL-04-13,4,3722454
HCAL-08-06,5,3722458
HSU1-04-11,2,3722459
HSU2-03-13,2,3722460
HSU1-06-05,3,3722461
HCAL-05-01,3,3722462
HSTA-02-01,4,3722463
HCAL-09-12,4,3722464
EXEP-01-01,4,3722465
H1S2-07-21,4,3722466
HCAL-07-06,5,3722467
H1S2-01-05,2,3451444
HSU1-01-02,2,3451445
HCAL-01-01,2,3451446
HSU1-09-04,3,3451447
H1S2-04-10,3,3451448
H1S2-02-02,3,3451449
H1S2-05-15,3,3451450
HCAL-01-02,3,3451451
HSU1-10-01,3,3451452
HSU1-08-05,3,5827389
HSU1-08-08,3,5827391
M1S1-01-04,3,5415637
HSU1-08-12,3,5827393
M2S1-10-10,3,3305848
HSU1-09-08,3,5827396
HSU1-08-15,3,5827398
M1S1-05-15,3,5413013
M1S1-05-04,3,5415280
HSU1-10-08,3,5827404
M1S1-06-09,3,5412582
HSU1-10-12,3,5827407
M1S1-05-15,3,5414922
HSU1-10-10,3,5827413
HSU1-10-07,3,5827414
M1S1-07-06,4,5410873
HSU1-10-16,3,5827425
HSU1-10-14,3,5827426
HSU1-10-03,3,5827427
M1S1-07-06,3,5412257
M1S1-07-06,3,5415871
HSU1-10-12,3,5827432
HSU1-11-08,3,5827434
M1S1-07-07,3,5415205
HSU1-11-01,3,5827439
HSU1-11-02,3,5827440
HSU1-03-08,2,5573364
HSU1-11-10,3,5827444
HSU1-11-01,3,5827446
HSU1-11-02,3,5827448
HSU1-11-04,3,5827450
M2S1-09-14,3,3305864
M2S1-03-07,2,5534623
HSU1-11-04,3,5827464
M1S1-07-09,3,5413054
M1S1-07-11,3,5410850
M1S1-07-11,4,5412361
HSU1-03-04,3,5827533
HSU1-03-14,3,5827534
HSU1-03-14,3,5827536
HSU1-03-18,3,5827539
HSU1-03-02,1,5573333
HSU1-03-14,3,5827545
HSU1-09-06,3,5843761
M1S1-07-11,3,5415206
HSU1-01-13,3,5827555
M1S1-07-12,3,5412258
M1S1-07-12,3,5412358
M1S1-07-13,3,5415874
HSU1-04-17,3,5827571
HSU1-04-01,4,5827574
M1S1-07-15,3,5410761
HSU1-01-13,3,5306283
HSU1-01-13,4,5576007
M1S1-07-16,3,5412735
HSU1-11-01,2,5843020
M1S1-07-19,4,5411109
HSU1-02-18,4,5307628
HSU1-02-18,4,5307809
HSU1-02-18,3,5310009
M1S1-01-02,3,5525015
M1S1-01-02,3,5525013
M1S1-01-02,2,5525014
M1S1-01-03,2,5525022
M1S1-01-03,3,5525029
M1S1-01-03,2,5525023
M1S1-01-04,2,5526926
M1S1-01-05,3,5525152
M1S1-01-05,3,5525900
M1S1-01-06,2,5526927
M1S1-01-06,3,5526928
M1S1-01-07,3,5526933
M1S1-01-08,3,5528981
M1S1-01-08,3,5526931
M1S1-01-08,3,5527269
M1S1-02-01,2,5526976
M1S1-02-01,2,5526974
M1S1-02-01,2,5526975
M1S1-02-01,2,5526952
M1S1-02-02,2,5526969
M1S1-02-02,2,5526968
M1S1-02-03,2,5527139
M1S1-02-03,2,5527136
M1S1-02-04,3,5527146
M1S1-02-04,3,5527145
M1S1-02-06,3,5527215
M1S1-02-07,3,5527217
M1S1-02-08,3,5527219
M1S1-02-09,3,5527224
M1S1-02-09,3,5527226
M1S1-02-13,3,5526977
M1S1-02-14,2,5527149
M1S1-02-14,2,5527148
M1S1-02-14,3,5527151
M1S1-03-01,2,5585937
M1S1-03-01,2,5529624
M1S1-03-01,2,5586292
M1S1-03-01,2,5529622
M1S1-03-01,2,5585938
M1S1-03-01,2,5530817
M1S1-03-01,2,5586137
M1S1-03-01,2,5529626
M1S1-03-01,2,5529790
M1S1-03-01,2,5585933
M1S1-03-01,2,5529459
M1S1-03-01,2,5585936
M1S1-03-01,2,5585989
M1S1-03-01,2,5585939
M1S1-03-01,2,5585991
M1S1-03-02,2,5529670
M1S1-03-02,2,5529671
M1S1-03-03,2,5529699
M1S1-03-03,2,5529697
M1S1-03-03,2,5529698
M1S1-03-05,3,5529703
M1S1-03-06,3,5586128
M1S1-03-06,3,5529821
M1S1-03-07,2,5529701
M1S1-03-08,2,5529784
M1S1-03-08,2,5529778
M1S1-03-08,2,5529777
M1S1-03-08,3,5529782
M1S1-03-08,2,5529779
M1S1-03-08,2,5529785
M1S1-04-01,1,5586158
M1S1-04-01,1,5529892
M1S1-04-01,2,5586184
M1S1-04-01,1,5586161
M1S1-04-01,2,5586183
M1S1-04-01,1,5529891
M1S1-04-01,1,5586159
M1S1-04-01,1,5586160
M1S1-04-01,2,5586271
M1S1-04-01,2,5530593
M1S1-04-01,2,5529486
M1S1-04-02,2,5529903
M1S1-04-03,1,5529894
M1S1-04-03,1,5586163
M1S1-04-03,2,5586188
M1S1-04-03,1,5529997
M1S1-04-03,2,5586274
M1S1-04-04,2,5529949
M1S1-04-04,2,5529948
M1S1-04-04,5,5530153
M1S1-04-04,2,5529910
M1S1-04-04,4,5530112
M1S1-04-05,3,5530155
M1S1-04-07,3,5529468
M1S1-04-07,3,5530888
M1S1-04-07,2,5586275
M1S1-04-07,2,5586247
M1S1-04-08,3,5530156
M1S1-04-08,3,5530157
M1S1-04-09,1,5530274
M1S1-04-09,3,5586280
M1S1-04-09,3,5529759
M1S1-04-09,1,5530269
M1S1-04-09,3,5586202
M1S1-04-09,3,5586306
M1S1-04-09,1,5530270
M1S1-04-12,2,5530348
M1S1-04-12,3,5530346
M1S1-04-12,2,5530349
M1S1-04-13,3,5530547
M1S1-04-13,1,5530549
M1S1-04-13,3,5530548
M1S1-04-14,2,5530427
HSU1-11-10,3,5843001
M1S1-07-17,5,5532003
M2S1-07-19,3,6037697
M1S1-07-05,1,5587219
M3S1-10-14,3,4987259
HSTA-05-10,3,5824978
M1S1-05-12,3,5412343
HSU1-02-12,3,3451453
M1S1-04-14,3,5530429
M1S1-04-15,1,5530396
M1S1-04-15,3,5586237
M1S1-04-15,3,5586236
M1S1-04-15,1,5530392
M1S1-04-15,1,5586223
M1S1-04-15,2,5530430
M1S1-04-15,3,5586308
M1S1-04-15,2,5586233
M1S1-04-15,1,5530394
M1S1-04-15,3,5530431
M1S1-04-15,1,5586222
M1S1-04-15,2,5530432
M1S1-04-15,2,5529760
M1S1-04-15,1,5530393
M1S1-04-15,2,5586239
M1S1-04-15,1,5586224
M1S1-04-15,1,5586227
M1S1-04-16,2,5529421
M1S1-04-16,4,5586286
M1S1-04-17,2,5530527
M1S1-04-17,2,5530526
M1S1-04-17,3,5530545
M1S1-04-17,3,5530544
M1S1-04-19,3,5530883
M1S1-07-19,3,5410220
M1S1-04-19,3,5586304
M1S1-04-20,3,5530353
M1S1-04-20,2,5530352
M1S1-04-20,2,5530350
H1S1-09-12,3,5998107
M1S1-05-01,3,5531381
M1S1-05-01,3,5531380
M1S1-05-02,2,5531379
M1S1-05-05,3,5531377
M1S1-05-05,3,5531378
M1S1-05-06,2,5531457
M1S1-05-06,3,5531460
M1S1-05-06,2,5531459
M1S1-05-06,3,5531458
M1S1-05-07,3,5531461
M1S1-05-07,3,5531462
M1S1-05-07,3,5531463
M1S1-05-08,3,5531485
M1S1-05-08,2,5531488
M1S1-05-08,3,5531487
M1S1-05-08,2,5531483
M1S1-05-08,2,5531486
M1S1-05-09,2,5586517
M1S1-05-09,2,5587525
M1S1-05-10,2,5586530
M1S1-05-10,1,5531513
M1S1-05-10,2,5586532
M1S1-05-10,3,5531527
M1S1-05-10,3,5531526
M1S1-05-10,2,5586541
M1S1-05-10,1,5531515
M1S1-05-10,2,5586591
M1S1-05-10,2,5586529
M1S1-05-10,3,5529930
M1S1-05-10,2,5586590
M1S1-05-10,2,5586593
M1S1-05-10,2,5586531
M1S1-05-10,2,5586595
M1S1-05-10,2,5531572
M1S1-05-10,1,5531512
M1S1-05-10,3,5529931
M1S1-05-10,2,5586539
M1S1-05-10,1,5531514
M1S1-05-10,3,5587526
M1S1-05-11,2,5531508
M1S1-05-11,2,5531506
M1S1-05-11,3,5531507
M1S1-05-11,3,5531510
M1S1-05-11,2,5531505
M1S1-05-12,3,5531529
M1S1-06-11,3,5412583
M1S1-05-12,3,5531530
M1S1-05-15,3,5529944
M1S1-05-17,3,5531531
M1S1-06-01,2,5531721
M1S1-06-02,3,5531726
M1S1-06-03,2,5531720
M1S1-06-03,2,5531722
M1S1-06-03,2,5531509
M1S1-06-04,3,5531723
M1S1-06-05,2,5531741
M1S1-06-05,3,5531743
M1S1-06-05,4,5531745
M1S1-06-06,2,5531750
M1S1-06-06,2,5531749
M1S1-06-06,2,5531747
M1S1-06-06,3,5531748
M1S1-06-07,2,5587189
M1S1-06-07,2,5587191
M1S1-06-07,2,5531935
M1S1-06-07,2,5530124
M1S1-06-07,2,5531755
M1S1-06-07,2,5530061
M1S1-06-07,3,5531764
M1S1-06-07,2,5587190
M1S1-06-07,2,5531754
M1S1-06-08,2,5531769
M1S1-06-08,3,5531767
M1S1-06-08,2,5531771
M1S1-06-08,2,5531768
M1S1-06-08,2,5531766
M1S1-06-08,3,5531770
M1S1-06-08,2,5531772
M1S1-06-09,3,5587198
M1S1-06-09,2,5530128
M1S1-06-09,2,5587177
M1S1-03-09,3,5413441
M1S1-06-09,2,5531830
M1S1-06-09,3,5531952
M1S1-06-09,2,5531803
M1S1-06-09,2,5531805
M1S1-06-10,2,5531809
M1S1-06-10,2,5587201
M1S1-06-10,2,5587178
M1S1-06-10,2,5587537
M1S1-06-10,2,5587200
M1S1-06-10,2,5531811
M1S1-06-10,2,5587173
M1S1-06-12,3,5530136
M1S1-06-12,2,5587376
M1S1-06-12,3,5532077
M1S1-06-12,4,5530132
M1S1-06-12,3,5530134
M1S1-06-12,3,5531953
M1S1-06-12,3,5530065
M1S1-06-14,3,5531839
M1S1-06-14,3,5531774
M1S1-06-14,2,5531727
M1S1-06-14,3,5531831
M1S1-06-15,3,5531835
M1S1-07-02,3,5531975
M1S1-07-04,4,5531972
M1S1-07-04,3,5530161
M1S1-07-04,2,5531872
M1S1-07-04,3,5530191
M1S1-07-04,5,5531991
M1S1-07-04,3,5587236
M1S1-07-04,4,5530317
M1S1-07-04,3,5532095
M1S1-07-04,3,5587222
M1S1-07-06,3,5530162
M1S1-07-06,3,5587231
M1S1-07-06,3,5587494
M1S1-07-06,3,5530192
M1S1-07-06,3,5531853
M1S1-07-09,4,5530324
M1S1-07-10,3,5587547
M1S1-07-10,3,5532080
M1S1-07-10,3,5587546
M1S1-07-10,3,5530325
M1S1-07-10,4,5530327
M1S1-07-10,3,5531877
M1S1-07-12,3,5531912
M1S1-07-12,3,5587542
M1S1-07-12,3,5530219
M1S1-07-12,3,5530213
M1S1-07-12,4,5532096
M1S1-07-12,3,5587234
M1S1-07-12,3,5587224
M1S1-07-13,3,5530334
M1S1-07-13,3,5531955
M1S1-07-13,3,5531913
M1S1-07-16,3,5530335
M1S1-07-17,3,5531917
M1S1-07-17,3,5530336
M1S1-07-17,3,5530218
M1S1-07-17,3,5530337
M1S1-07-17,3,5531915
M1S1-07-17,4,5532091
M1S1-07-17,3,5530216
M1S1-07-17,4,5587381
M1S1-07-17,3,5530221
M1S1-07-17,3,5531901
M1S1-07-17,3,5530338
M1S1-07-18,3,5531918
M1S1-07-18,3,5587238
M1S1-07-19,3,5531970
M1S1-07-19,4,5530329
EXEP-01-01,3,5414802
M1S1-07-19,3,5532093
M1S1-07-19,3,5530328
M1S1-07-19,3,5587239
M1S1-07-19,3,5531873
M1S1-08-02,2,5587644
M1S1-08-02,2,5532284
M1S1-08-02,3,5532516
M1S1-08-02,2,5532283
M1S1-08-02,4,5530580
M1S1-08-06,2,5532317
M1S1-08-06,2,5525841
M1S1-08-06,3,5525585
M1S1-08-06,3,5533395
M1S1-08-06,3,5530474
M1S1-08-06,2,5525842
M1S1-08-06,3,5525580
M1S1-08-06,3,5525591
M1S1-09-01,3,5532230
M1S1-09-01,3,5587580
M1S1-09-01,3,5532110
M1S1-09-01,3,5532265
M1S1-09-01,2,5587736
M1S1-09-01,3,5532115
M1S1-09-05,3,5530874
M1S1-09-05,3,5587752
M1S1-09-07,3,5532232
M1S1-09-07,2,5587562
M1S1-09-07,2,5587798
M1S1-09-07,3,5587608
M1S1-09-07,3,5532139
M1S1-09-07,3,5587611
M2S1-01-03,2,5590326
M2S1-01-03,1,5590394
M2S1-01-03,1,5590395
M2S1-01-03,2,5575924
M2S1-01-03,2,5575823
M2S1-01-03,1,5575814
M2S1-01-15,3,5590324
M2S1-01-15,3,5590397
M2S1-01-15,3,5590396
M2S1-02-01,1,5592757
M2S1-02-01,1,5534543
M2S1-02-01,2,5593207
M2S1-02-01,2,5594020
M2S1-02-01,1,5592758
M2S1-02-02,3,5593211
M2S1-02-02,2,5592826
M2S1-02-03,2,5593205
M2S1-02-03,2,5594021
M2S1-02-03,2,5592827
M2S1-02-03,1,5534542
M2S1-02-03,2,5592828
M2S1-02-04,3,5593951
M2S1-02-04,1,5592750
M2S1-02-04,3,5592831
M2S1-02-04,2,5593204
M2S1-02-04,5,5594046
M2S1-02-04,2,5593206
M2S1-02-04,3,3213032
M2S1-02-04,3,5534580
M2S1-02-04,1,5534548
M2S1-02-04,3,5534581
M2S1-02-04,1,5592763
M2S1-02-04,1,5592751
M2S1-02-04,1,5534547
M2S1-02-04,3,3213029
M2S1-02-04,1,5592764
M2S1-02-04,1,5592749
M2S1-02-04,1,5534549
M2S1-02-05,3,5534552
M2S1-02-05,3,5534551
M2S1-02-05,2,5592823
M2S1-02-05,1,5592752
M2S1-02-08,3,5701161
M2S1-02-12,2,5592873
M2S1-02-12,3,5593955
M2S1-02-12,3,5592906
M2S1-02-12,2,5592888
M2S1-02-12,2,5592889
M2S1-02-12,2,5592891
M2S1-02-12,2,5534556
M2S1-02-12,1,5592765
M2S1-02-12,3,5592908
M2S1-03-15,4,3295585
M2S1-02-13,3,5592914
M2S1-02-13,2,5534558
M2S1-02-13,2,5534559
M2S1-02-13,2,5592877
M2S1-02-13,4,5534600
M2S1-02-13,2,5534576
M2S1-02-13,2,5534578
M2S1-02-13,2,5592894
M2S1-02-13,3,5534599
M2S1-02-13,2,5592892
M2S1-02-13,2,5592878
M2S1-02-13,2,5592875
M2S1-02-13,1,5592830
M2S1-02-14,3,5534563
M2S1-02-14,3,5534562
M2S1-02-15,3,5534564
M2S1-02-15,3,5534565
M2S1-02-15,3,5534566
M2S1-02-15,3,3213076
M2S1-02-15,3,3213128
M2S1-02-15,3,3213072
M2S1-02-17,3,5594035
M2S1-02-17,3,5592917
M2S1-02-17,3,3213131
M2S1-02-17,3,3213138
M2S1-02-17,3,5593221
M2S1-02-17,3,5534609
M2S1-02-17,3,5592916
M2S1-03-01,2,5593287
M2S1-03-01,2,5593278
M2S1-03-02,3,5534684
M2S1-03-02,2,5593289
M2S1-03-03,3,5593967
M2S1-03-03,3,5534627
M2S1-03-07,3,5534685
M2S1-03-07,2,5593327
M2S1-03-07,2,5593337
M2S1-03-07,2,5534624
M2S1-03-12,3,3295187
M2S1-03-12,3,3295233
M2S1-02-16,3,3213154
M2S1-03-12,3,5593960
M2S1-03-12,3,5701175
M2S1-03-12,3,5593975
M2S1-03-12,3,5593589
M2S1-03-13,4,5593780
M2S1-03-13,4,5534705
M2S1-03-14,3,5593970
M2S1-03-14,3,5593783
M2S1-03-14,3,5593591
M2S1-03-14,3,5593785
M2S1-03-14,3,5534706
M2S1-03-14,2,5593529
M2S1-03-14,3,5593971
M2S1-04-03,3,5534937
M2S1-04-03,3,5534839
M2S1-04-03,3,5596640
M2S1-04-03,3,5594879
M2S1-04-08,2,3295710
M2S1-04-08,3,5534958
M2S1-04-08,3,5538154
M2S1-04-08,2,5594880
M2S1-04-08,2,3295704
M2S1-04-08,2,3295712
M2S1-04-08,2,3295714
M2S1-04-08,3,5534923
M2S1-04-08,2,3295716
M2S1-04-09,2,5534847
M2S1-05-04,3,5534976
M2S1-05-04,3,5596824
M2S1-05-07,3,3305259
M2S1-05-08,3,5596593
M2S1-06-04,3,5594291
M2S1-06-04,3,5594778
M2S1-06-04,2,5594608
M2S1-06-04,3,5594292
M2S1-06-05,3,5594293
HSU1-01-06,2,5843486
HSU1-03-01,3,5828961
HSU1-08-01,3,5306314
EXEP-01-01,3,6065713
M2S1-08-10,2,6106425
HSU1-10-13,3,5843788
M1S1-05-04,2,5586405
M1S1-07-11,3,5587541
M2S1-02-07,3,5740400
M1S1-09-07,3,5532125
HSTA-07-12,3,5827863
M1S1-05-08,2,5531489
M1S1-06-03,3,5414085
HCAL-02-11,3,3451454
HSU1-02-04,3,3451455
H1S2-03-06,3,3451456
H1S1-05-08,4,3451457
H1S2-03-16,4,3451458
H1S2-06-07,4,3451459
H1S2-06-14,4,3451460
HCAL-01-04,4,3451461
HCAL-02-16,4,3451462
M2S1-06-05,3,5594833
M2S1-06-05,3,5534725
M2S1-06-05,3,5594840
M2S1-06-11,3,5594832
M2S1-06-13,3,5594503
M2S1-06-13,3,3295437
M2S1-06-13,3,5534766
M1S1-07-17,4,5412070
M2S1-06-18,2,5594480
M2S1-07-01,3,3295450
M2S1-07-05,3,5534800
M2S1-07-08,3,5534806
M1S1-02-05,3,5415427
M2S1-07-21,3,5594843
M2S1-08-06,2,3305553
M2S1-08-06,2,3305551
M2S1-08-06,3,3305625
M2S1-08-06,3,3305643
M2S1-08-06,3,3305937
M2S1-08-06,3,3305642
M2S1-09-08,3,5537892
M2S1-09-08,2,5597006
M2S1-10-07,3,5538171
M2S1-10-08,3,5537899
M2S1-10-09,3,3305950
M2S1-10-12,3,3305857
M2S1-10-12,3,3305890
M2S1-10-12,3,3305908
M2S1-10-12,3,3305938
M2S1-10-12,4,3305862
M2S1-10-13,4,5535309
M2S1-10-13,3,3305860
M3S1-01-04,3,5519826
M3S1-01-04,2,5534966
M3S1-01-04,3,5519827
M3S1-01-04,3,5532059
M3S1-01-04,3,5519668
M3S1-01-04,3,5519678
M3S1-01-04,4,5583287
M3S1-01-04,3,5582423
M3S1-01-04,3,5519825
HSU1-10-08,3,5842877
M3S1-02-01,3,5535880
M3S1-02-01,3,5519766
M3S1-02-01,3,5582179
M3S1-02-01,3,5582211
M3S1-02-01,3,5519881
M3S1-02-01,3,5535875
M3S1-02-01,3,5582178
M3S1-02-01,3,5583160
M3S1-02-01,3,5519763
M3S1-02-01,3,5519768
M3S1-02-01,3,5532066
M3S1-02-01,3,5535650
M3S1-02-03,3,5582453
M3S1-02-04,3,5534956
M3S1-02-04,4,5519913
M3S1-02-04,4,5519915
M3S1-03-01,3,5553466
M3S1-03-01,2,5551794
M3S1-03-02,3,5531821
M3S1-03-03,3,5531862
M3S1-03-03,2,5531845
M3S1-03-03,2,5531842
M3S1-03-03,2,5531844
M3S1-03-03,3,5531974
M3S1-03-03,3,5531856
M3S1-03-03,3,5531859
M3S1-03-03,2,5531846
M3S1-03-03,4,5532081
M3S1-03-03,2,5531843
M3S1-03-03,3,5531864
M3S1-03-03,3,5531863
M3S1-03-03,2,5531847
M3S1-03-03,3,5531857
M3S1-03-05,3,5531959
M3S1-03-05,3,5557750
M3S1-03-05,3,5532088
M3S1-03-05,3,5532004
M3S1-03-05,3,5557911
M3S1-03-05,3,5531961
M3S1-03-01,3,5557881
M3S1-03-01,3,5531977
M3S1-03-01,2,5531850
M3S1-03-01,3,5531971
M3S1-03-01,3,5532079
M3S1-04-01,3,5531890
M3S1-04-01,4,5535713
M3S1-04-01,2,5531883
M3S1-04-01,2,5531885
M3S1-04-01,2,5531869
M3S1-04-01,2,5531876
M3S1-04-01,5,5532024
M3S1-04-01,2,5531871
M3S1-04-01,2,5531868
M3S1-04-01,4,5535775
M3S1-04-01,3,5531984
M3S1-04-01,5,5532021
M3S1-04-01,2,5531882
M3S1-04-01,3,5531891
M3S1-04-01,4,5583157
M3S1-04-01,3,5557822
M3S1-04-01,3,5531887
M3S1-04-01,2,5531867
M3S1-04-01,3,5531886
M3S1-04-01,2,5531866
M3S1-04-01,3,5582808
M3S1-04-01,3,5531888
M3S1-04-01,3,5531892
M3S1-04-01,3,5532083
M3S1-04-04,2,5583617
M3S1-04-04,2,5547791
M3S1-04-05,3,5558040
M3S1-04-05,3,5583664
M3S1-04-06,3,5531927
M3S1-04-06,3,5583629
M3S1-04-06,3,5532085
M3S1-04-06,3,5531994
M3S1-04-06,3,5531929
M3S1-04-06,3,5558046
M3S1-04-06,3,5583673
M3S1-04-07,3,5547839
M3S1-04-07,3,5547843
M3S1-04-07,3,5547852
M3S1-04-07,3,5547842
M3S1-04-07,4,5547909
M3S1-04-07,3,5547853
M3S1-04-07,3,5559033
M3S1-04-10,3,5532033
M3S1-04-10,3,5583201
M3S1-04-10,3,5532034
M3S1-04-10,3,5582748
M3S1-04-08,3,5557823
M3S1-04-08,2,5531920
M3S1-04-08,3,5531992
M3S1-04-08,3,5557824
M3S1-04-08,2,5531907
M3S1-04-08,3,5532027
M3S1-04-08,2,5531925
M3S1-04-08,3,5582813
M3S1-04-08,3,5583192
M3S1-04-08,2,5531910
M3S1-04-08,2,5531909
M3S1-04-08,3,5532086
M3S1-04-08,2,5531989
M3S1-04-11,3,5583431
M3S1-04-11,3,5532029
M3S1-04-11,3,5557896
M2S1-10-05,4,3305895
M3S1-05-01,3,5553221
M3S1-05-01,3,5553483
M3S1-06-02,3,5558172
M3S1-06-02,4,5559177
M3S1-06-02,3,5584203
M3S1-06-02,4,5584130
M3S1-06-02,3,5584067
M3S1-06-02,3,5548521
M3S1-06-02,3,5584169
M3S1-06-02,3,5548568
M3S1-06-02,3,5548567
M3S1-06-02,3,5548447
M3S1-06-02,3,5559175
M3S1-06-02,4,5559178
M3S1-06-02,3,5548516
M3S1-06-02,3,5548518
M3S1-06-02,3,5548513
M3S1-06-02,3,5548517
M3S1-06-02,3,5548515
M3S1-06-02,3,5548446
M3S1-06-02,3,5583900
M3S1-06-02,3,5559176
M3S1-06-02,4,5584065
M3S1-06-02,3,5548631
M3S1-06-04,3,5559172
M3S1-06-04,3,5558171
M3S1-06-04,3,5559171
M3S1-06-04,3,5584204
M3S1-06-04,3,5548523
M3S1-06-04,4,5559208
M3S1-06-04,3,5584168
M3S1-06-04,3,5548497
M3S1-06-04,3,5559170
M3S1-06-04,3,5548524
HSU1-02-15,3,5570365
HSU1-09-10,3,5843765
M3S1-06-04,3,5548499
M3S1-06-09,3,5559202
M3S1-08-01,3,5549210
M3S1-08-01,3,5549152
M3S1-08-01,3,5549269
M3S1-08-01,3,5549153
M3S1-08-01,3,5549149
M3S1-08-01,2,5562193
M3S1-08-01,3,5549148
M3S1-08-01,3,5549150
M3S1-08-01,3,5549209
M3S1-08-01,3,5549211
M3S1-08-01,3,5549151
M3S1-08-01,3,5549139
M3S1-08-01,3,5549208
M3S1-08-01,3,5584380
M3S1-08-01,3,5584509
M3S1-08-05,3,5548871
M3S1-08-05,3,5548873
M3S1-08-05,3,5549172
M3S1-08-05,3,5548872
M3S1-08-06,3,5549217
M3S1-08-06,3,5584464
M3S1-08-06,3,5562220
M3S1-08-06,3,5549171
M3S1-08-06,3,5584387
M2S1-03-15,3,3295279
M2S1-10-02,3,3305784
M3S1-08-07,3,5584557
M3S1-08-07,3,5584571
M3S1-08-09,3,5549243
M3S1-08-08,3,5549184
M3S1-08-08,4,5549191
M3S1-08-08,3,5549280
M3S1-08-08,3,5559516
M3S1-08-08,3,5562289
M3S1-08-08,3,5549189
M3S1-08-08,3,5549185
M3S1-08-08,3,5549190
M3S1-08-08,3,5584587
M3S1-08-08,3,5549188
M3S1-09-03,3,5584584
M3S1-09-03,3,5584423
M3S1-09-03,3,5584422
M3S1-09-03,3,5549251
M3S1-09-03,3,5549194
M3S1-09-03,3,5549250
M3S1-09-03,3,5584412
M3S1-09-03,3,5584411
M3S1-09-03,3,5584473
M3S1-10-12,2,5551915
M3S1-10-12,3,5562386
M3S1-11-01,3,5553516
M3S1-11-05,3,5551121
M3S1-11-05,3,5562391
M3S1-11-05,3,5551120
M3S1-11-08,3,5551919
M3S1-11-08,3,5551122
M3S1-11-08,3,5553325
M3S1-12-04,3,5584961
M3S1-12-06,3,5551253
M3S1-12-06,3,5551252
M3S1-12-06,4,5562505
M3S1-12-06,3,5562492
M3S1-12-06,3,5584959
M3S1-12-06,3,5551371
M3S1-12-06,3,5551369
M3S1-12-08,3,5585022
M3S1-12-08,3,5584989
M3S1-12-08,3,5562482
M3S1-12-09,3,5584998
M3S1-12-10,3,5551350
HSU1-03-01,3,5828097
HSU1-03-05,2,5828102
HSU1-03-01,2,5828146
HSU1-03-05,3,5828148
HSU1-03-04,2,5828149
M2S1-03-10,3,5534708
HSU1-03-13,2,5828229
M1S1-07-17,3,5413119
M1S1-05-13,3,5413442
EXEP-01-01,3,5415738
HSU1-03-13,3,5828292
HSU1-03-14,3,5828296
HSU1-03-21,3,5828297
HSU1-03-19,3,5828300
HSU1-03-13,3,5828301
M2S1-04-09,2,5596618
HSU1-03-13,2,5828313
HSU1-04-13,2,5828619
M1S1-09-08,4,5412641
HSU1-02-14,3,5570366
HSU1-04-17,3,5828641
HSU1-09-01,1,5847852
M1S1-07-19,3,5412134
HSU1-03-10,3,5828897
HSU1-04-10,3,5828907
HSU1-03-10,4,5828924
HSU1-04-10,3,5828927
M1S1-04-10,3,5415547
HSU1-03-04,4,5828963
M1S1-07-19,4,5413141
HSU1-11-02,3,5843813
HSU1-03-18,3,5828977
M2S1-09-12,2,6037727
HSU1-04-14,4,5828988
HSU1-04-18,4,5828994
HSU1-03-10,4,5828998
M1S1-08-01,3,5411110
M1S1-08-01,3,5412259
M1S1-08-01,3,5412362
M1S1-08-01,4,5412600
M1S1-08-02,3,5412738
HSU1-02-18,2,5841752
HSU1-09-09,3,5576072
M1S1-08-03,4,5412356
M1S1-08-03,4,5412882
M1S1-08-04,3,5410852
M1S1-08-04,3,5410882
M1S1-08-04,3,5413057
M1S1-08-04,3,5413139
M1S1-08-05,3,5410766
M1S1-08-05,3,5410851
M1S1-08-05,4,5411114
M1S1-08-05,3,5412426
HSU1-09-01,1,5842352
HSU1-10-01,2,5842883
HSU1-10-07,2,5842884
HSU1-10-08,3,5842891
HSU1-10-08,3,5842892
HSU1-10-10,3,5842893
HSU1-10-12,3,5842894
M1S1-04-01,3,5411962
HSU1-01-11,2,5843492
HSU1-01-14,3,5843498
M1S1-07-04,3,5531852
HSU1-01-13,3,5843503
HSU1-01-11,2,5843505
HSU1-01-11,4,5843506
HSU1-02-09,3,5843552
M2S1-05-11,3,6038095
HSU1-02-18,4,5843574
HSU1-02-18,3,5843576
HSU1-02-18,3,5843577
HSU1-08-06,2,5843718
HSU1-08-08,2,5843719
HSU1-08-08,3,5843720
HSU1-08-11,3,5843724
HSU1-08-08,3,5843739
HSU1-09-05,3,5843750
HSU1-09-11,3,5843755
HSU1-09-03,3,5843758
HSU1-09-06,3,5843760
HSU1-10-01,2,5843775
HSU1-10-07,2,5843778
HSTA-06-01,3,5581897
HSU1-10-08,3,5843782
EXEP-01-01,3,5175257
HCAL-01-15,4,3451463
H1S2-04-08,5,3451464
HSU1-08-03,2,3451465
HSU1-02-03,2,3451466
HCAL-02-04,3,3451467
HSU1-01-10,3,3451468
HSU1-11-05,4,3451469
H1S2-02-14,4,3451470
H1S2-03-08,4,3451472
HSU1-10-08,5,3451473
H1S2-07-15,2,3451413
HCAL-04-15,2,3451414
HCAL-03-03,2,3451415
HCAL-04-02,3,3451416
HCAL-03-04,3,3451417
HSTA-01-05,3,3451421
HCAL-08-04,3,3451418
HSU1-03-21,3,3451419
HSU1-03-04,3,3451420
HCAL-06-09,3,3451422
HSU1-03-07,3,3451423
HSU1-10-09,3,5843787
HCAL-02-11,3,1095930
HSU1-10-14,3,5843793
M1S1-02-08,3,5412232
HSU1-10-13,2,5843798
HSU1-10-03,3,5843800
H1S1-12-12,3,4985808
HSU1-10-16,3,5843804
M1S1-05-04,3,5413476
M1S1-06-10,3,5416160
M1S1-07-11,3,5412186
HSU1-11-07,2,5843820
M1S1-05-07,4,5414574
HSU2-03-14,4,1095931
M1S1-07-05,3,5410407
M1S1-08-05,4,5412599
M1S1-08-05,3,5412881
M1S1-08-05,3,5413058
M1S1-08-05,4,5414795
M1S1-09-02,3,5410855
HSU1-05-02,2,5849707
HSU1-05-02,2,5849708
HSU2-06-08,4,1095933
M1S1-09-02,4,5412359
HSU1-06-02,3,5849775
HSU1-06-03,3,5849776
HSU1-06-04,3,5849777
HSU1-06-04,3,5849778
HSU1-06-01,5,5849782
HSU1-06-17,3,5849790
HSU1-06-17,3,5849791
HSU1-06-15,3,5849792
HSU1-06-15,3,5849793
HSU1-06-21,3,5849797
HSU1-06-03,3,5849801
HSU1-06-22,4,5849803
HSU1-06-03,3,5849812
HSU1-06-15,3,5849819
M1S1-09-03,3,5410856
HSU1-07-03,2,5849837
M1S1-09-03,3,5412425
HSU1-07-03,2,5849845
HSU1-07-05,4,5849846
HSU1-07-05,3,5849847
M1S1-09-04,3,5410769
HSU1-07-08,3,5849850
HSU1-07-08,3,5849856
HSU1-07-09,3,5849857
HSU1-07-09,3,5849858
HSU1-01-10,2,5840763
M1S1-09-04,3,5412262
HSU1-07-13,3,5849865
HSU1-07-13,4,5849866
M1S1-09-05,3,5412268
HSU1-07-17,3,5849880
HSU2-02-04,4,1095934
M2S1-04-09,2,5596620
M1S1-09-06,4,5410857
HSU1-07-08,3,5849889
HSU2-05-16,4,1095935
M1S1-09-06,4,5412265
HSU1-01-06,4,5823497
HSU1-01-11,4,5823501
HSU1-01-09,4,5823499
HSU1-01-10,3,5823428
M1S1-09-06,5,5412266
M1S1-09-06,4,5412269
M1S1-09-07,3,5411944
M1S1-09-08,4,5412267
M1S1-09-10,3,5410764
M1S1-09-10,3,5410858
HSU1-03-04,3,5837911
M1S1-09-13,5,5410773
M1S1-09-13,4,5410859
HSU1-03-05,3,5837915
HSU1-03-10,4,5837955
HSU1-03-04,4,5846903
HSU1-03-10,4,5846906
HSU1-03-21,3,5846911
HSU1-03-19,3,5846915
HSU1-09-04,4,1095936
HSU1-02-16,3,5847460
HSU1-04-13,3,5847663
HSU1-08-06,3,5847836
HSU1-08-08,3,5847846
HSU1-09-01,3,5847855
HSU1-09-11,3,5847880
HSU1-09-11,3,5847888
HSU1-10-12,3,5847987
HSU1-10-09,4,5848198
HSU1-10-16,3,5848218
HSU1-10-14,3,5848220
HSU1-10-15,3,5848221
HSU1-02-16,3,5848472
HSTA-01-04,3,5829184
HSTA-01-04,3,5829185
HSTA-01-06,3,5829211
HSTA-01-07,3,5829257
HSTA-01-05,3,5829263
HSTA-01-05,3,5829264
HSTA-01-04,3,5829265
HSTA-01-04,3,5829266
HSTA-01-04,3,5829267
HSTA-01-06,3,5829294
HSTA-01-09,3,5829314
HSTA-01-10,3,5829335
HSTA-01-10,3,5829336
HSTA-01-03,3,5829338
HSTA-01-08,3,5829671
HSTA-01-07,3,5829672
HSTA-01-09,3,5829674
HSTA-01-11,3,5829675
HSTA-01-01,3,5829677
HSTA-01-01,3,5829678
HSTA-01-03,3,5829679
HSTA-01-02,3,5829680
HSTA-01-01,3,5829683
HSTA-01-03,3,5829684
HSTA-01-10,3,5829685
HSTA-02-05,3,5829934
HSTA-02-05,3,5829936
HSTA-02-06,3,5829940
HSTA-02-08,3,5829999
HSTA-02-08,3,5830000
HSTA-02-05,3,5830084
HSTA-02-07,3,5830085
HSTA-02-07,3,5830087
HSTA-02-09,3,5830090
HSTA-02-10,3,5830091
HSTA-02-10,3,5829938
HSTA-02-10,3,5830082
HSTA-02-10,3,5830083
HSTA-01-02,3,5580970
HSTA-01-04,3,5580990
HSTA-01-05,3,5580991
HSTA-01-04,3,5580992
HSTA-01-04,3,5581000
HSTA-01-04,3,5581001
HSTA-01-06,3,5581002
HSTA-01-04,3,5581003
HSTA-01-04,3,5581004
HSTA-01-04,3,5581005
HSTA-01-05,3,5581006
HSTA-01-04,3,5581007
HSTA-01-04,3,5581008
HSTA-01-06,3,5581009
HSTA-01-04,3,5581010
HSTA-01-04,3,5581011
HSTA-01-01,3,5581012
HSU1-02-14,3,5570364
HSU1-09-01,3,5847856
HSU1-11-02,2,5843021
HSU1-08-07,2,5576068
M1S1-07-02,2,5530159
M2S1-07-19,3,6037699
HSTA-01-08,3,5829313
HSTA-05-03,3,5581850
M1S1-06-06,3,5414368
HCAL-10-04,3,3451424
HCAL-06-01,3,3451425
HCAL-08-07,4,3451426
HCAL-05-06,4,3451427
HSU1-10-08,4,3451428
HCAL-08-07,4,3451429
HSTA-02-10,4,3451430
HCAL-04-13,4,3451431
HCAL-09-10,4,3451432
HCAL-05-12,5,3451433
HSU1-04-15,2,3451434
HCAL-04-03,2,3451435
H1S2-07-25,3,3451436
HSU1-06-16,3,3451437
HSTA-01-07,4,3451438
HCAL-09-10,4,3451439
HCAL-10-02,4,3451440
HSTA-02-02,4,3451441
HSU2-08-12,5,3451442
HSTA-01-01,3,5581014
HSTA-01-01,3,5581015
HSTA-01-01,3,5581016
HSTA-01-03,3,5581017
HSTA-01-03,3,5581018
HSTA-01-03,3,5581019
HSTA-01-01,3,5581020
HSTA-01-02,3,5581021
HSTA-01-01,3,5581023
HSTA-01-01,3,5581024
HSTA-01-02,3,5581025
HSTA-01-01,3,5581026
HSTA-01-05,3,5581028
HSTA-01-07,3,5581029
HSTA-01-07,3,5581030
HSTA-01-10,3,5581031
HSTA-01-07,3,5581032
HSTA-01-08,3,5581033
HSTA-01-07,3,5581034
HSTA-01-10,3,5581035
HSTA-01-07,3,5581037
HSTA-01-09,3,5581038
HSTA-01-07,3,5581039
HSTA-01-11,3,5581040
HSTA-01-10,3,5581041
HSTA-01-11,3,5581042
HSTA-02-05,3,5581080
HSTA-02-05,3,5581081
HSTA-02-05,3,5581083
HSTA-02-05,3,5581085
HSTA-02-05,3,5581086
HSTA-02-10,3,5581087
HSTA-02-05,3,5581088
HSTA-02-05,3,5581089
HSTA-02-05,3,5581090
HSTA-02-05,3,5581091
HSTA-02-07,3,5581092
HSTA-02-05,3,5581093
HSTA-02-05,3,5581094
HSTA-02-07,3,5581095
HSTA-02-06,3,5581096
HSTA-02-08,3,5581097
HSTA-02-05,3,5581098
HSTA-03-02,3,5581302
HSTA-03-02,3,5581305
HSTA-03-02,3,5581307
HSTA-03-02,3,5581309
HSTA-03-07,3,5581311
HSTA-03-07,3,5581313
HSTA-03-07,3,5581314
HSTA-03-02,3,5581315
HSTA-03-05,3,5581316
HSTA-03-07,3,5581319
HSTA-03-07,3,5581320
HSTA-03-03,3,5581321
HSTA-03-03,3,5581322
HSTA-03-03,3,5581323
HSTA-03-02,3,5581324
HSTA-03-07,3,5581325
HSTA-03-02,3,5581326
HSTA-03-10,3,5581327
HSTA-03-10,3,5581328
HSTA-03-10,3,5581329
HSTA-03-10,3,5581330
HSTA-03-09,3,5581331
HSTA-03-10,3,5581332
HSTA-03-10,3,5581333
HSTA-03-07,3,5581334
HSTA-03-04,3,5581335
HSTA-03-07,3,5581336
HSTA-03-07,3,5581337
HSTA-03-06,3,5581338
HSTA-03-06,3,5581340
HSTA-03-03,3,5581341
HSTA-03-03,3,5581342
HSTA-03-07,3,5581343
HSTA-03-07,3,5581344
HSTA-03-09,3,5581345
HSTA-03-07,3,5581346
HSTA-03-07,3,5581347
HSTA-03-07,3,5581348
HSTA-03-02,3,5581349
HSTA-03-14,3,5581350
HSTA-03-13,3,5581351
HSTA-03-03,3,5581353
HSTA-03-07,3,5581354
HSTA-03-08,3,5581355
M1S1-07-15,3,5415539
HSTA-03-08,3,5581360
HSTA-03-08,3,5581361
HSTA-03-08,3,5581362
HSTA-03-09,3,5581363
HSTA-03-09,3,5581364
HSTA-03-09,3,5581365
HSTA-03-09,3,5581366
HSTA-03-09,3,5581367
HSTA-03-09,3,5581368
HSTA-03-09,3,5581369
HSTA-03-09,3,5581370
HSTA-03-09,3,5581371
HSTA-03-09,3,5581372
HSTA-03-12,3,5581373
HSTA-03-12,3,5581374
HSTA-03-12,3,5581375
HSTA-03-12,3,5581376
HSTA-03-12,3,5581377
HSTA-03-13,3,5581378
HSTA-03-12,3,5581379
HSTA-03-10,3,5581380
M1S1-02-08,4,5412233
HSTA-03-13,3,5581390
HSTA-03-13,3,5581391
HSTA-03-12,3,5581392
HSTA-03-15,3,5581393
HSTA-03-14,3,5581394
HSTA-03-15,3,5581395
HSTA-03-14,3,5581396
HSTA-03-15,3,5581397
HSTA-03-14,3,5581398
HSTA-03-15,3,5581399
HSTA-03-15,3,5581400
HSTA-03-14,3,5581401
HSTA-03-15,3,5581402
HSTA-03-15,3,5581403
HSTA-03-14,3,5581404
HSTA-03-14,3,5581405
HSTA-03-14,3,5581406
HSTA-03-14,3,5581407
HSTA-04-02,3,5581408
HSTA-04-02,3,5581409
HSTA-04-02,3,5581410
HSTA-04-02,3,5581411
HSTA-04-02,3,5581412
HSTA-04-02,3,5581413
HSTA-04-02,3,5581414
HSTA-04-02,3,5581415
HSTA-04-02,3,5581416
HSTA-04-03,3,5581417
HSTA-04-02,3,5581418
HSTA-04-02,3,5581419
HSTA-04-03,3,5581420
HSTA-04-03,3,5581421
HSTA-04-03,3,5581422
HSTA-04-03,3,5581423
HSTA-04-04,3,5581424
HSTA-04-03,3,5581425
HSTA-04-03,3,5581426
HSTA-04-03,3,5581427
HSTA-04-05,3,5581428
HSTA-04-05,3,5581429
HSTA-03-15,3,5581430
HSTA-04-01,3,5581431
HSTA-04-04,3,5581432
HSTA-04-01,3,5581433
HSTA-04-01,3,5581434
HSTA-04-01,3,5581435
HSTA-04-06,3,5581436
HSTA-04-06,3,5581437
HSTA-04-06,3,5581438
HSTA-04-06,3,5581439
HSTA-04-06,3,5581440
HSTA-04-06,3,5581441
HSTA-04-06,3,5581442
HSTA-04-08,3,5581443
HSTA-04-08,3,5581444
HSTA-04-08,3,5581445
HSTA-04-08,3,5581447
HSTA-04-08,3,5581448
HSTA-04-08,3,5581449
HSTA-04-08,3,5581450
HSTA-04-08,3,5581451
HSTA-04-09,3,5581452
HSTA-04-09,3,5581453
HSTA-04-08,3,5581455
HSTA-04-08,3,5581459
HSTA-04-08,3,5581461
HSTA-04-10,3,5581462
HSTA-04-10,3,5581464
HSTA-04-11,3,5581465
HSTA-04-11,3,5581467
HSTA-04-11,3,5581469
HSTA-04-11,3,5581471
HSTA-04-11,3,5581472
HSTA-04-11,3,5581473
HSTA-04-10,3,5581474
HSTA-04-11,3,5581475
HSTA-04-11,3,5581476
HSTA-04-11,3,5581477
HSTA-04-11,3,5581478
HSTA-04-11,3,5581479
M1S1-07-12,3,5415208
HSTA-05-03,3,5581851
M1S1-05-13,3,5413196
M1S1-06-06,3,5410774
HSTA-05-01,3,5581854
HSTA-05-01,3,5581855
HSTA-05-02,3,5581856
HSTA-05-02,3,5581859
HSTA-05-12,3,5581867
HSTA-05-12,3,5581868
HSTA-05-06,3,5581872
HSTA-05-06,3,5581873
HSTA-05-06,3,5581874
HSTA-05-04,3,5581875
HSTA-05-04,3,5581876
HSTA-05-04,3,5581877
HSTA-05-11,3,5581878
HSTA-05-05,3,5581879
HSTA-05-06,3,5581880
M1S1-06-11,3,5416161
HSTA-05-05,3,5581882
HSTA-05-10,3,5581883
HSTA-05-10,3,5581885
HSTA-05-09,3,5581886
HSTA-05-11,3,5581889
HSTA-05-11,3,5581890
HSTA-05-11,3,5581891
HSTA-05-10,3,5581892
HSTA-05-09,3,5581893
HSTA-05-09,3,5581894
HSTA-05-11,3,5581895
HSTA-06-02,3,5581896
EXEP-01-01,,5412187
HSTA-06-01,3,5581898
HSTA-06-01,3,5581899
HSTA-06-01,3,5581900
HSTA-06-01,3,5581901
HSTA-06-01,3,5581902
HSTA-06-02,3,5581903
HSTA-06-01,3,5581904
HSTA-06-03,3,5581906
HSTA-06-03,3,5581907
HSTA-06-03,3,5581908
HSTA-06-03,3,5581909
HSTA-06-03,3,5581910
HSTA-06-03,3,5581911
HSTA-06-03,3,5581912
HSTA-06-03,3,5581913
HSTA-06-05,3,5581914
HSTA-06-06,3,5581919
HSTA-06-07,3,5581920
HSTA-06-07,3,5581962
M2S1-03-15,3,5538069
HSTA-06-07,3,5581964
HSTA-06-08,3,5581965
HSTA-06-09,3,5581966
HSTA-06-07,3,5581967
HSTA-06-09,3,5581969
HSTA-06-11,3,5581970
HSTA-06-10,3,5581971
HSTA-06-09,3,5581972
HSTA-06-11,3,5581973
HSTA-06-09,3,5581974
HSTA-06-12,3,5581975
HSTA-06-12,3,5581976
HSTA-06-13,3,5581977
HSTA-06-13,3,5581978
HSTA-06-13,3,5581979
HSTA-06-14,3,5581980
M1S1-09-13,3,5412437
HSTA-07-01,3,5581986
HSTA-07-02,3,5581988
HSTA-07-02,3,5581989
HSTA-07-01,3,5581992
HSTA-07-01,3,5581993
HSTA-07-02,3,5581994
HSTA-07-04,3,5581995
HSTA-07-04,3,5581996
HSTA-07-05,3,5581997
HSTA-07-04,3,5581998
HSTA-07-06,3,5581999
M1S1-02-06,4,5413199
M1S1-05-17,3,5415526
HSTA-07-08,3,5582003
HSTA-07-10,3,5582004
HSTA-07-08,3,5582005
HSTA-07-11,3,5582006
HSTA-07-10,3,5582007
HSTA-07-14,3,5582008
HSTA-07-10,3,5582009
HSTA-01-04,3,5824816
HSTA-01-04,3,5824817
HSTA-01-07,3,5824821
HSTA-01-09,3,5824822
HSTA-01-01,3,5824831
HSTA-01-01,3,5824833
HSTA-02-05,3,5824905
HSTA-02-05,3,5824906
HSTA-02-06,3,5824915
HSTA-02-06,3,5824916
HSTA-02-06,3,5824918
M2S1-01-02,2,5368409
HSTA-03-14,3,5824924
HSTA-03-12,3,5824925
HSTA-04-08,3,5824951
HSTA-05-01,3,5824955
HSTA-05-04,3,5824968
M2S1-01-02,3,5368920
HSTA-05-05,3,5824970
M2S1-01-04,3,5367497
HSTA-06-06,3,5824990
HSTA-06-12,3,5824994
HSTA-06-13,3,5824995
HSTA-07-02,3,5825015
M2S1-01-04,3,5367512
HSTA-07-07,3,5825022
HSTA-01-02,3,5827585
HSTA-01-02,3,5827594
HSTA-01-02,3,5827604
HSTA-01-05,3,5827612
HSTA-01-04,3,5827613
HSTA-01-07,3,5827614
HSTA-01-09,3,5827615
HSTA-01-02,3,5827616
HSTA-01-01,3,5827617
HSTA-01-04,3,5827621
M2S1-01-04,4,5369484
HSTA-01-08,3,5827623
HSTA-01-07,3,5827624
HSTA-01-11,3,5827625
HSTA-01-01,3,5827626
HSTA-01-01,3,5827627
HSTA-01-04,3,5827631
HSTA-01-07,3,5827632
HSTA-01-07,3,5827633
HSTA-01-07,3,5827634
HSTA-01-07,3,5827635
HSTA-01-07,3,5827636
HSTA-01-03,3,5827637
HSTA-01-03,3,5827638
HSTA-02-05,3,5827644
HSTA-02-05,3,5827645
HSTA-02-06,3,5827646
HSTA-02-06,3,5827647
HSTA-02-05,3,5827653
HSTA-02-05,3,5827654
HSTA-02-06,3,5827655
HSTA-02-06,3,5827657
HSTA-02-06,3,5827659
HSTA-01-08,3,5827661
HSTA-02-06,3,5827686
HSTA-02-08,3,5827692
HSTA-02-09,3,5827694
HSTA-02-05,3,5827695
HSTA-02-10,3,5827697
HSTA-03-03,3,5827699
HSTA-03-13,3,5827701
HSTA-03-14,3,5827704
HSTA-03-12,3,5827705
HSTA-03-07,3,5827706
HSTA-03-02,3,5827708
HSTA-03-02,3,5827710
HSTA-03-07,3,5827711
HSTA-03-06,3,5827712
HSTA-03-02,3,5827714
HSTA-03-08,3,5827717
HSTA-04-02,3,5827718
HSTA-03-13,3,5827719
HSTA-03-12,3,5827720
HSTA-03-02,3,5827721
HSTA-03-03,3,5827723
HSTA-03-09,3,5827725
HSTA-03-14,3,5827726
HSTA-03-07,3,5827727
HSTA-03-06,3,5827728
HSTA-03-02,3,5827738
HSTA-03-02,3,5827739
HSTA-03-03,3,5827741
HSTA-03-03,3,5827743
HSTA-03-13,3,5827744
HSTA-04-02,3,5827747
HSTA-04-08,3,5827748
HSTA-04-09,3,5827749
HSTA-04-01,3,5827751
HSTA-04-01,3,5827752
HSTA-04-02,3,5827753
HSTA-04-02,3,5827754
HSTA-04-01,3,5827755
HSTA-04-02,3,5827756
HSTA-04-08,3,5827757
HSTA-04-05,3,5827758
HSTA-04-11,3,5827759
HSTA-04-11,3,5827760
HSTA-04-08,3,5827761
HSTA-04-01,3,5827762
HSTA-04-05,3,5827763
HSTA-04-07,3,5827764
HSTA-04-09,3,5827765
HSTA-04-05,3,5827766
HSTA-04-02,3,5827767
HSTA-04-08,3,5827768
HSTA-04-05,3,5827769
HSTA-04-05,3,5827770
HSTA-05-02,3,5827772
M1S1-07-12,3,5411315
HSTA-05-06,3,5827774
HSTA-05-06,3,5827775
HSTA-05-09,3,5827776
HSTA-05-11,3,5827777
HSTA-05-02,3,5827778
M2S1-03-15,4,3295339
HSTA-05-12,3,5827781
HSTA-05-07,3,5827783
HSTA-05-12,3,5827784
HSTA-05-11,3,5827786
HSTA-05-11,3,5827787
M1S1-05-12,2,5411287
HSTA-05-12,3,5827790
HSTA-05-12,3,5827791
HSTA-05-05,3,5827792
HSTA-05-06,3,5827795
HSTA-05-11,3,5827796
HSTA-05-11,3,5827797
M1S1-05-11,3,5413011
HSTA-06-01,3,5827800
HCAL-02-16,4,1095964
HSTA-06-06,3,5827802
HSTA-06-06,3,5827803
HSTA-06-06,3,5827804
HSTA-06-01,3,5827805
HSTA-06-01,3,5827806
HSTA-06-01,3,5827807
HSTA-06-06,3,5827808
HSTA-06-07,3,5827809
HSTA-06-06,3,5827810
HSTA-06-09,3,5827811
HSTA-06-13,3,5827813
HSTA-06-13,3,5827814
HSTA-06-13,3,5827815
HSTA-06-02,3,5827817
HSTA-06-03,3,5827818
HSTA-06-06,3,5827819
M1S1-01-02,2,5413259
HSTA-06-07,3,5827822
HSTA-06-11,3,5827823
HSTA-06-13,3,5827824
HSTA-06-13,3,5827826
HSTA-06-13,3,5827827
H1S2-02-15,4,1095953
HSTA-06-13,3,5827830
HSTA-07-01,3,5827831
EXEP-01-01,2,5415595
M1S1-04-21,3,5413724
HSTA-07-01,3,5827835
HSTA-07-02,3,5827837
HSTA-07-01,3,5827838
HSTA-07-03,3,5827839
HSTA-07-04,3,5827840
HSTA-07-07,3,5827845
HSTA-07-05,3,5827846
HSTA-07-08,3,5827847
HSTA-07-14,3,5827848
HSTA-07-04,3,5827851
HSTA-07-03,3,5827852
HSTA-07-13,3,5827854
HSTA-07-10,3,5827855
HSTA-07-11,3,5827862
M2S1-01-04,3,5370183
M2S1-01-06,3,5367480
HSTA-07-09,3,5827865
HSTA-07-11,3,5827866
M2S1-06-11,3,5594478
M1S1-01-01,3,3157574
M1S1-01-01,4,3157688
M1S1-01-01,3,3157695
M1S1-01-09,4,3157649
HCAL-07-04,5,1095954
M1S1-01-09,3,3157712
M1S1-02-10,3,3157803
M2S1-01-06,3,5368448
M1S1-04-06,3,3166711
M1S1-04-06,3,3166712
M1S1-04-06,4,3166719
M1S1-04-06,3,5731495
M1S1-04-06,3,5731940
M1S1-04-06,3,5732262
M1S1-04-18,3,5731516
M1S1-04-18,3,5731518
M1S1-05-03,2,3168275
M1S1-05-03,3,3168295
M1S1-05-03,3,3168310
M1S1-05-03,3,3168311
M1S1-05-03,3,3168322
M1S1-05-03,3,3168327
M1S1-05-04,2,3168234
M1S1-05-04,2,3168235
M1S1-05-04,3,3168276
M1S1-05-04,3,3168287
M1S1-05-14,3,3168460
M2S1-01-06,3,5368926
M2S1-01-07,4,5367500
M1S1-05-14,3,3168479
M1S1-05-14,3,5731921
M1S1-05-16,3,3168459
M2S1-01-07,5,5369696
M1S1-05-16,4,3168472
M2S1-01-11,3,5367481
M2S1-01-11,3,5367509
M2S1-01-11,3,5368927
HSU1-01-05,2,1095955
M1S1-06-13,4,3168701
M1S1-06-13,4,3168727
M1S1-06-13,3,5732057
M1S1-06-17,3,5732067
M1S1-06-17,3,5732268
M2S1-01-17,3,5368418
M1S1-07-08,3,3168645
M2S1-01-17,3,5369480
M1S1-07-08,3,3173022
M1S1-07-11,3,5732223
M2S1-02-04,3,5368934
M2S1-02-04,3,5370162
M1S1-07-20,3,3168691
M2S1-02-05,3,5369729
M2S1-02-07,3,5369730
M1S1-07-21,3,5732250
M2S1-02-08,3,5369688
M2S1-02-09,4,5369485
M2S1-02-11,5,5369846
M1S1-09-06,3,3172946
M2S1-02-14,4,5368937
M1S1-09-06,3,5732480
M1S1-09-06,3,5732481
M1S1-09-12,3,3172925
M1S1-09-12,3,3172931
M2S1-02-14,4,5369703
M1S1-09-12,3,5732488
M1S1-09-12,5,5732489
M2S1-01-10,3,5740316
M2S1-02-07,3,5740379
M2S1-02-14,3,5369840
M2S1-02-14,4,5370164
M2S1-02-15,3,5369699
M2S1-02-15,3,5369733
M2S1-02-10,3,5740399
M2S1-02-16,3,5740413
M2S1-02-16,3,5740417
M2S1-03-04,3,5740460
M2S1-03-04,3,5740462
M2S1-03-04,4,5740469
M2S1-03-04,3,5740617
M2S1-03-06,3,5740475
M2S1-02-15,3,5370065
M2S1-03-10,3,5740484
M2S1-03-10,3,5740485
M2S1-03-15,3,5740625
M2S1-04-01,3,5740859
M2S1-04-15,3,5740898
M2S1-05-01,3,5740945
M2S1-05-01,4,5740952
M2S1-05-02,3,5740957
M1S1-07-12,3,5410864
H1S2-04-16,2,1095956
M2S1-05-11,3,5740997
M2S1-05-12,3,5740950
M2S1-05-12,3,5740965
M2S1-05-13,3,5740964
M2S1-06-10,3,5740728
M2S1-06-19,3,5740738
HSU1-10-08,1,5842876
M2S1-07-03,3,5740749
M1S1-05-02,3,5413474
M1S1-06-12,3,5410270
HSU1-10-04,3,1095957
M2S1-07-07,3,5740757
HSU2-02-05,3,1095958
M2S1-07-10,3,5740761
M2S1-07-10,3,5740763
H1S2-03-16,4,1095959
HCAL-02-04,4,1095960
HSU1-03-06,3,5573354
M2S1-07-17,3,5740781
M2S1-07-19,3,5740785
HSU1-11-01,4,1095961
M2S1-07-19,4,5740789
M2S1-08-01,3,5732394
M2S1-08-01,3,5732395
M2S1-08-01,3,5732396
M2S1-08-01,3,5732517
M2S1-08-02,3,5732398
M2S1-08-02,3,5732399
M2S1-08-02,3,5732400
M2S1-08-02,3,5732401
M2S1-08-02,3,5732403
M2S1-08-05,3,5741041
M2S1-08-05,3,5741050
M2S1-08-05,4,5741051
M2S1-09-03,3,5741100
M2S1-09-03,3,5741101
M2S1-09-03,3,5741234
M2S1-09-15,3,5732497
M2S1-09-15,3,5732499
M2S1-09-15,3,5741112
M2S1-10-02,3,5741181
M2S1-10-03,3,5741191
HSU1-01-06,2,5840762
M2S1-10-03,3,5741195
M2S1-10-05,3,5741222
M2S1-10-10,3,5741211
M2S1-10-10,3,5741212
M2S1-10-10,4,5741218
M2S1-10-15,3,5741230
M2S1-10-15,3,5741251
M2S1-10-15,3,5741252
M3S1-01-02,3,3313384
M3S1-01-02,3,5767528
M2S1-06-18,3,5594475
HSU1-02-12,3,5570358
M3S1-02-02,2,3313513
M3S1-02-02,3,3313540
M3S1-02-02,3,3313584
M3S1-03-04,2,3313515
M3S1-03-04,2,3313516
M3S1-03-04,2,3313518
M3S1-03-04,3,3313563
M3S1-03-04,3,3313565
M3S1-03-04,3,5768149
HSU1-01-02,2,6064605
M3S1-03-07,3,3313908
M3S1-03-07,3,3313909
M3S1-06-03,3,3324954
M3S1-06-03,4,3324955
M3S1-06-03,3,3324967
M3S1-06-03,3,5768332
M3S1-06-03,4,5768333
M3S1-06-06,4,3324952
M3S1-06-06,4,3324958
M3S1-06-06,3,3324981
M3S1-06-06,3,3324982
HSU1-05-11,2,5160388
M3S1-06-06,3,5768343
M3S1-06-06,3,5768344
M3S1-06-06,3,5768345
M1S1-07-14,3,5530214
M3S1-07-03,2,3325922
M3S1-07-03,2,3325923
M3S1-07-03,2,3325924
M3S1-07-03,2,3325925
M3S1-07-03,3,3326275
M3S1-07-03,3,3326298
M3S1-07-03,4,3326299
M3S1-07-03,3,5768457
M3S1-07-10,3,3326325
M2S1-04-08,3,5371056
M3S1-08-03,3,3327840
M3S1-08-03,3,3327900
M3S1-08-10,3,3327854
M3S1-08-10,3,3327907
M3S1-08-10,3,3360233
M3S1-08-10,3,5825762
M3S1-08-10,3,5834703
M1S1-04-01,1,5529889
M3S1-09-02,3,5768493
M3S1-09-02,3,5768494
M3S1-09-02,3,5768495
M3S1-09-02,3,5768582
HSTA-07-13,3,5827864
HSTA-04-10,3,5187188
M3S1-09-08,3,3327911
M3S1-09-10,3,3327815
M3S1-09-10,3,3327909
M3S1-09-10,3,3360210
M3S1-11-06,3,3359923
M1S1-06-06,3,5412887
M3S1-11-06,4,3359944
M3S1-11-06,3,3360189
M3S1-11-06,3,3360219
HSU1-01-05,2,3456554
H1S1-01-01,2,3456555
M3S1-11-07,3,3359927
H1S1-04-02,2,3456556
M3S1-11-07,2,5832788
H1S1-09-07,3,3456557
M3S1-11-07,3,5832790
M3S1-11-07,3,5832896
H1S2-04-10,3,3456558
M3S1-11-07,3,5834789
H1S1-02-01,3,3456559
M3S1-12-02,3,3359995
M3S1-12-02,3,3359996
M3S1-12-02,3,3360037
M3S1-12-02,3,3360057
M3S1-12-09,3,3360028
M3S1-09-10,4,4986491
M3S1-04-12,3,4976761
M3S1-01-01,4,4977305
H1S1-02-06,3,3456560
M3S1-01-04,2,4977699
H1S2-06-07,3,3456561
M3S1-12-11,3,4976997
M3S1-01-05,5,4987098
M3S1-12-10,3,4984155
M3S1-01-06,3,4977713
M3S1-01-06,3,4982772
H1S1-06-06,3,3456564
H1S1-07-12,3,3456562
H1S2-03-07,3,3456563
H1S1-11-14,3,3456565
M3S1-01-07,4,4976211
M3S1-01-07,4,4977474
H1S2-04-01,3,3456566
M3S1-12-09,3,4980902
H1S2-02-14,4,3456567
M3S1-02-04,5,4981070
M3S1-02-05,3,4978315
M3S1-02-05,4,4982841
M3S1-02-06,3,4980964
M3S1-02-07,5,4987557
M3S1-02-08,3,4983050
HSU1-10-11,4,3456568
M3S1-02-08,5,4984283
M3S1-02-08,4,4983339
HSU1-01-03,4,5310044
HSU1-02-08,4,3456569
H1S2-06-10,4,3456570
HSU1-11-11,4,3456571
H1S2-03-16,4,3456572
H1S1-08-13,4,3456573
H1S2-02-05,5,3456574
HSU1-02-01,2,3456575
H1S1-05-08,2,3456576
H1S1-12-07,3,3456577
H1S2-05-24,3,3456578
HSU1-11-05,4,3456579
H1S1-12-05,4,3456580
HSU1-01-05,4,3456581
HSU1-01-12,3,5304937
HSU1-01-09,3,5352866
HSU1-01-11,4,5309906
HSU1-02-18,2,5308782
M1S1-01-04,2,5415697
HSU1-03-10,4,5163954
M1S1-03-02,3,5393168
M1S1-05-01,3,5413191
EXEP-01-01,,5161129
HSU1-04-12,3,5159493
HSU1-04-09,4,5163185
M2S1-10-03,3,3305805
HSU1-04-12,4,5161016
HSU1-04-12,3,5159421
EXEP-01-01,,5159248
HSU1-06-07,4,5162469
HSU1-06-07,4,5163393
HSU1-06-07,4,5161481
HSU1-06-19,2,5159593
HSU1-06-19,3,5159734
HSU1-06-19,3,5159006
EXEP-01-01,,5413321
M1S1-07-12,3,5412525
HSU1-06-22,4,5163316
HSU1-08-03,3,5307712
HSU1-08-03,3,5307397
HSU1-08-05,3,5307919
HSU1-02-06,2,5570304
HSU1-08-08,3,5843730
HSU1-08-10,3,5304808
HSU1-08-10,3,5306418
EXEP-01-01,,5308972
HSU1-09-02,4,5309905
HSU1-11-02,3,5306634
HSU1-08-03,3,5307486
HSU1-09-09,3,5308168
HSU1-11-03,3,5304692
H1S1-02-14,4,4980139
H1S1-02-02,4,4985497
H1S1-02-02,3,4987196
H1S1-02-14,4,4978772
H1S1-02-01,3,4985372
H1S1-02-09,4,4984781
H1S1-02-05,3,4981916
H1S1-02-12,2,4984162
H1S1-02-06,2,4984882
H1S1-03-06,2,4978777
H1S1-02-06,2,4980392
HSU1-11-04,3,5848480
H1S1-02-05,4,4981589
H1S1-02-05,2,4987843
HSU1-06-12,4,5162996
H1S1-03-06,4,4985875
H1S1-03-03,3,4978985
H1S1-03-06,4,4985826
H1S1-04-07,4,4985319
H1S1-04-09,3,4985877
H1S1-04-08,4,4987695
H1S1-04-09,3,4987834
H1S1-04-09,3,4987878
H1S1-04-05,4,4978889
H1S1-04-06,4,4978767
H1S1-04-08,4,4986424
H1S1-04-08,3,4986580
H1S1-04-08,3,4986840
HSU1-06-22,3,5628732
H1S1-05-08,4,4980159
H1S1-05-08,4,4984746
HSU1-05-13,3,5163398
H1S1-05-08,4,4989069
H1S1-07-02,3,4987479
H1S1-06-02,3,4979433
H1S1-06-02,3,4984019
H1S1-06-02,3,4985697
H1S1-06-02,3,4986450
H1S1-06-01,4,4987845
H1S1-10-05,3,4979042
M1S1-09-10,3,5412586
M1S1-07-02,3,5710866
H1S1-10-02,4,4985615
H1S1-10-02,4,4988426
H1S1-10-02,4,4988572
HSU1-11-13,3,5310016
H1S1-10-09,3,4986995
EXEP-01-01,,4989018
H1S1-11-14,3,4978874
H1S1-11-14,3,4980112
H1S1-11-08,3,4986283
H1S1-11-18,3,4985271
H1S1-12-02,4,4982091
H1S1-12-02,3,4983979
H1S1-12-06,3,4986789
H1S1-12-03,3,4981629
EXEP-01-01,,5308654
M1S1-04-20,5,5411656
EXEP-01-01,,5163048
M1S1-01-08,3,5415139
HSTA-03-02,3,5184551
M1S1-01-08,3,5410479
M1S1-01-08,3,5412031
M1S1-02-02,2,5391100
M1S1-02-02,2,5414908
M1S1-04-03,1,5529893
M2S1-02-16,3,5369543
M1S1-02-06,4,5413793
M1S1-02-10,4,5415902
EXEP-01-01,2,5413978
EXEP-01-01,2,5413407
EXEP-01-01,2,5415853
EXEP-01-01,3,5413757
EXEP-01-01,,5411966
M1S1-02-04,3,5412750
M1S1-05-19,4,6065744
M1S1-03-07,4,5415145
M1S1-03-07,4,5393191
EXEP-01-01,,5414570
M1S1-03-07,3,5414183
M1S1-05-06,3,5411506
M1S1-03-10,3,5415608
HSTA-06-14,3,5177243
HSTA-04-07,3,5187137
EXEP-01-01,4,3456582
HSU1-08-03,5,3456583
M1S1-03-08,3,5413864
M1S1-03-08,3,5410376
M1S1-03-06,3,5411140
M1S1-03-06,3,5412104
M1S1-03-06,3,5414913
M1S1-03-09,3,5413290
M1S1-03-09,3,5413589
M1S1-04-01,3,5415544
M1S1-04-01,3,5411668
EXEP-01-01,,5413734
M1S1-04-09,3,5410370
M1S1-04-12,3,5414382
M1S1-04-14,4,5413593
M1S1-04-14,3,5416016
M1S1-04-15,3,5413791
EXEP-01-01,,5413499
M1S1-03-04,4,5416012
M1S1-03-04,3,5412273
M1S1-03-07,3,5416113
M1S1-05-03,3,5412938
M1S1-05-02,3,5414761
M1S1-05-02,3,5414028
M1S1-05-05,3,5415188
M1S1-05-05,3,5412669
M1S1-05-05,3,5414860
M1S1-05-05,3,5413435
EXEP-01-01,,5414017
EXEP-01-01,,5410750
M1S1-05-05,4,5410664
H1S1-01-01,2,3456178
H1S2-02-01,2,3456179
M2S1-02-16,3,5369700
M2S1-02-17,3,5367527
M1S1-05-11,3,5412872
M1S1-05-11,3,5393161
M1S1-05-11,3,5415567
M1S1-05-09,3,5413404
M1S1-05-13,3,5411509
M1S1-05-13,3,5411050
M1S1-05-13,3,5391115
HSU1-02-03,2,3456180
H1S1-04-02,3,3456181
M2S1-03-01,3,5368940
M2S1-03-03,3,5369487
M2S1-03-03,3,5369673
M2S1-03-03,3,5369704
M2S1-03-04,3,5368428
M2S1-03-04,4,5369844
M2S1-03-05,3,5370068
M2S1-03-06,3,5368941
M2S1-03-07,3,5368425
M2S1-03-09,5,5367482
M2S1-03-09,3,5369705
M2S1-03-09,3,5369734
M2S1-03-11,4,5368944
M2S1-03-12,5,5369552
HCAL-07-04,4,1095962
M1S1-05-13,3,5412471
HSU1-02-05,5,1095963
M1S1-05-13,3,5414772
HCAL-03-10,2,1095836
M1S1-05-02,4,5411782
HCAL-04-01,2,1095840
M1S1-06-08,3,5412966
M1S1-06-03,3,5415644
M1S1-06-03,3,5410606
M1S1-06-08,3,5414781
M1S1-06-02,3,5416039
M1S1-07-12,3,5415305
M1S1-06-08,3,5411395
M1S1-06-08,3,5416087
M1S1-06-12,3,5413052
M1S1-05-17,3,5413591
HCAL-03-04,2,1095843
HSU2-01-02,3,1095845
EXEP-01-01,,5415990
HSU2-07-05,3,1095847
EXEP-01-01,,5412160
HSU2-04-01,3,1095848
HSU1-10-05,2,5842878
HSU1-04-15,3,1095849
M1S1-09-01,3,5412566
M1S1-09-02,3,5412211
M1S1-09-02,3,5412815
M1S1-09-05,3,5415827
M1S1-09-05,3,5412622
M1S1-09-05,3,5415723
M1S1-09-05,3,5411516
EXEP-01-01,,5412097
HSU2-03-11,3,1095851
HCAL-04-15,3,1095853
M1S1-09-11,3,5415657
M1S1-09-07,3,5412424
M1S1-09-07,3,5412768
M1S1-09-11,4,5414880
M1S1-09-11,4,5413114
M1S1-09-11,3,5412062
M1S1-09-11,3,5412624
M1S1-09-11,3,5410411
M1S1-09-10,4,5412988
M1S1-09-10,4,5410215
M1S1-09-10,3,5412229
M1S1-09-10,3,5412261
M1S1-09-10,3,5411407
M1S1-09-10,4,5415593
M1S1-09-10,4,5414174
M1S1-09-10,4,5412718
M1S1-09-10,4,5412502
M2S1-01-06,3,5372194
M2S1-01-02,3,5370155
M2S1-09-16,3,3305877
M2S1-01-16,4,5368599
M2S1-01-11,3,5393485
M2S1-02-03,1,5534550
M2S1-01-12,4,5372584
M2S1-01-03,3,5393626
M2S1-01-15,3,5369814
M2S1-01-15,3,5408748
M2S1-01-15,4,5408533
HSU1-02-05,3,5827554
M2S1-01-15,3,5372583
HSU1-10-13,3,5842910
M2S1-02-12,3,5406447
M2S1-02-08,3,5367090
M2S1-02-05,3,5393426
M2S1-02-12,3,5368190
M2S1-02-01,3,5372002
M2S1-02-04,3,5370328
M2S1-02-05,3,5369895
M2S1-02-09,3,5368269
M2S1-02-05,3,5369649
M2S1-02-05,3,5369139
M2S1-02-05,3,5368420
M2S1-02-05,3,5369590
M2S1-02-09,3,5406448
M2S1-02-04,3,5371453
M2S1-02-05,3,5369197
M2S1-02-05,3,5368932
M2S1-02-05,3,5372143
M2S1-02-11,4,5370199
HSU1-07-01,1,5843182
M2S1-02-14,3,5369650
M2S1-02-14,3,5369817
M2S1-02-05,3,5367088
M2S1-03-04,5,5393504
HSU1-05-13,4,5160849
M2S1-04-06,3,5367359
M2S1-04-08,3,5370282
M1S1-05-10,2,5586540
M2S1-04-12,3,5370752
M2S1-05-10,3,5393683
M2S1-05-10,3,5369977
M2S1-05-10,3,5369790
M2S1-05-10,3,5368558
M2S1-05-10,3,5370259
M2S1-05-10,3,5393449
M2S1-06-07,3,5368767
M2S1-06-09,3,5369852
M2S1-06-07,3,5368871
M2S1-06-09,4,5368394
M2S1-06-09,4,5368221
M2S1-06-09,4,5408693
M2S1-06-06,3,5406489
M2S1-06-07,3,5368480
M2S1-06-07,4,5372595
M2S1-06-07,3,5368487
M2S1-06-06,4,5370629
M2S1-06-09,4,5370738
M1S1-07-15,3,5530215
M2S1-06-12,4,5367157
HSU1-09-06,3,6065350
M2S1-06-05,3,5372152
M2S1-06-05,3,5408710
M2S1-06-05,3,5368217
M2S1-06-05,3,5367197
M2S1-06-05,3,5367631
M2S1-10-11,3,5409934
M1S1-04-01,1,5529890
M2S1-07-12,3,5368550
M1S1-05-18,3,6106445
M2S1-07-12,3,5368746
M2S1-08-03,3,5393257
M2S1-08-03,3,5368566
M2S1-08-03,3,5371863
M2S1-08-03,3,5367680
M2S1-08-05,2,5369475
M2S1-08-05,3,5367683
M2S1-08-05,3,5369776
M2S1-08-05,2,5369071
M2S1-08-05,3,5367177
M2S1-08-05,3,5408834
M2S1-08-05,3,5369177
M2S1-08-01,3,5367400
M2S1-09-09,3,5372526
M2S1-09-09,3,5370463
M2S1-10-02,3,5370682
M2S1-06-02,3,5408691
M2S1-09-05,3,5409932
M2S1-08-08,3,5371864
M2S1-08-09,2,5369766
M2S1-08-08,3,5393527
HSU1-01-14,3,5306599
M2S1-08-09,3,5367554
M2S1-09-02,3,5409838
M2S1-09-07,3,5393529
M2S1-08-07,3,5369004
M2S1-08-07,3,5370112
M2S1-09-07,4,5370884
M2S1-10-01,3,5369180
M2S1-10-03,3,5370035
M2S1-09-06,3,5370459
M2S1-08-07,3,5408618
H1S1-02-06,3,3456182
M2S1-09-02,3,5371103
H1S1-10-08,3,3456183
M2S1-09-07,2,5369794
H1S1-08-20,3,3456184
M2S1-09-07,2,5370436
M2S1-09-07,3,5368083
M2S1-08-07,3,5408664
M2S1-08-07,3,5367216
M2S1-09-06,4,5368915
M2S1-10-04,3,5370827
H1S1-05-05,3,3456185
M2S1-08-07,3,5368677
M2S1-08-07,3,5368569
M2S1-08-07,3,5369341
HSU1-01-11,3,3456186
H1S2-03-16,3,3456187
H1S1-08-08,3,3456188
H1S2-05-16,3,3456189
HSU1-08-03,3,3456191
H1S1-07-01,4,3456195
M2S1-08-06,3,5368681
M2S1-08-07,2,5393258
M2S1-10-15,4,5370466
M2S1-10-15,4,5371229
M2S1-06-03,3,5370006
M2S1-06-03,3,5368737
M2S1-09-06,3,5408721
M2S1-10-04,3,5372767
M1S1-01-09,4,3157700
M2S1-10-11,3,5370803
M2S1-10-03,3,5370467
M2S1-06-11,3,5594641
M2S1-09-07,4,5372525
M2S1-10-07,3,5368687
M2S1-10-04,4,5369577
M2S1-06-17,3,5408839
M2S1-06-17,3,5369796
M2S1-09-16,4,5369629
M2S1-09-16,4,5370403
EXEP-01-01,,5370190
EXEP-01-01,,5372419
EXEP-01-01,,5370889
EXEP-01-01,,5370604
EXEP-01-01,,5370261
EXEP-01-01,,5371939
EXEP-01-01,,5409845
EXEP-01-01,,5372687
HCAL-10-02,3,1095855
EXEP-01-01,,5371099
EXEP-01-01,,5370454
HSU1-06-21,3,1095860
EXEP-01-01,,5371201
EXEP-01-01,,5369337
M3S1-12-09,3,4987667
M3S1-12-09,3,4978362
M3S1-12-08,4,4976924
M3S1-03-01,3,4982630
M3S1-03-03,4,4978127
M3S1-12-06,4,4983555
M2S1-02-13,2,5592895
M3S1-03-06,3,4976151
HSU1-08-01,3,5309538
HSU1-01-08,3,5570232
HSU1-06-23,3,5162903
M2S1-07-03,2,5371829
HSU1-05-11,2,5159414
M1S1-05-10,2,5586538
M3S1-12-06,3,4985411
M3S1-12-06,3,4980540
M3S1-12-06,3,4981014
M3S1-03-07,3,4977538
M3S1-04-01,4,4983624
M3S1-04-02,4,4977091
M3S1-12-03,3,4976466
M3S1-10-12,3,4977341
M3S1-10-06,3,4981232
M3S1-04-08,3,4982631
M3S1-04-08,3,4987605
M3S1-04-08,3,4986059
M3S1-04-09,5,4977815
M3S1-04-09,5,4981210
M3S1-04-11,3,4976595
M3S1-01-01,4,4978558
M3S1-03-07,3,4977715
M3S1-04-11,4,4987576
M3S1-04-13,4,4987456
M3S1-05-04,3,4982777
M3S1-04-12,3,4977113
M3S1-05-05,4,4983959
M3S1-05-06,4,4981160
M3S1-05-07,3,4982527
M3S1-05-08,2,4986119
M3S1-05-10,3,4982477
M3S1-05-10,3,4978563
M3S1-05-10,3,4986755
M3S1-06-02,3,4980985
M3S1-06-04,5,4978019
M3S1-06-06,3,4984303
M3S1-06-07,3,4981187
M3S1-06-07,3,4987979
M3S1-06-08,2,4983739
M3S1-06-09,3,4976382
M3S1-07-04,4,4987668
M3S1-07-05,4,4980987
M3S1-07-05,4,4978352
M3S1-07-06,4,4981064
M3S1-07-08,4,4976309
M3S1-07-08,4,4987673
M3S1-07-09,3,4983465
M3S1-07-09,4,4983004
M3S1-08-01,3,4976310
M3S1-08-02,3,4982684
M3S1-08-02,3,4977117
M3S1-08-05,4,4978176
M3S1-08-08,4,4983741
M3S1-08-09,3,4976897
M3S1-08-11,3,4983405
M3S1-09-03,3,4987275
M3S1-09-03,3,4986191
M3S1-09-03,2,4978364
M3S1-09-05,3,4980665
M3S1-09-05,4,4978353
M3S1-09-06,3,4982686
M3S1-09-08,4,4985136
M3S1-09-08,3,4983207
M3S1-09-09,5,4978143
M3S1-09-11,3,4981011
M3S1-09-11,4,4986012
M3S1-09-11,3,4976335
M3S1-09-11,3,4983434
M3S1-09-11,5,4978484
M3S1-10-05,2,4982440
M3S1-10-06,3,4976530
M3S1-10-06,3,4988605
M3S1-10-11,3,4986274
M3S1-11-01,3,4988074
M3S1-11-01,3,4987265
M3S1-11-01,2,4980848
M3S1-11-02,3,4977344
M3S1-11-04,3,4988082
M3S1-11-10,3,4976532
M3S1-11-10,5,4976794
M3S1-12-03,3,4985787
M3S1-12-04,3,4980696
M3S1-01-05,4,4977901
M3S1-06-08,3,4977477
M3S1-12-05,3,4982501
M3S1-12-01,4,4976235
M3S1-03-03,3,4977581
EXEP-01-01,3,4978124
EXEP-01-01,3,4982802
M3S1-12-09,3,4986483
M3S1-12-08,3,4980781
M3S1-12-08,3,4987263
M3S1-12-06,2,4976189
HSTA-02-01,3,5167611
HSTA-03-07,3,5183187
HSTA-01-11,4,5186411
HSTA-01-11,4,5186329
HSTA-01-04,3,5161271
EXEP-01-01,2,5172663
EXEP-01-01,2,5167196
EXEP-01-01,2,5183467
HSTA-03-03,3,5188658
HSTA-03-03,3,5174119
HSTA-03-03,3,5185082
HSTA-03-03,3,5160289
EXEP-01-01,,5167716
HSTA-05-02,3,5186998
HSTA-05-02,3,5188518
HSTA-05-02,3,5172938
HSTA-03-14,3,5176185
HSTA-05-11,3,5187000
HSTA-06-02,3,5188346
HSTA-06-02,3,5178551
HSTA-06-02,3,5167249
HSTA-06-02,4,5176335
HSTA-06-05,3,5187689
HSTA-06-05,3,5188166
HSTA-06-06,3,5178930
HSTA-06-09,4,5167306
HSTA-06-14,3,5178341
HSTA-06-13,3,5178406
HSTA-06-13,3,5173404
HSTA-06-13,3,5177116
HSTA-07-06,3,5187692
HSTA-07-06,3,5162374
HSU1-10-06,2,5842879
HSTA-07-13,3,5178401
HSTA-07-10,3,5173864
HSTA-07-10,3,5184999
M1S1-01-04,3,5415698
M1S1-03-02,3,5393170
M1S1-05-03,3,5414506
M1S1-01-09,4,5415913
M1S1-07-12,3,5415158
HSTA-07-14,4,5187775
HSU1-01-02,1,5575970
HSU1-01-13,3,5823471
HSU1-01-13,3,5823502
M1S1-02-03,3,5411968
HSU1-01-14,3,5823478
HSU1-01-14,3,5823484
HSU1-01-14,3,5823493
HSU1-01-14,3,5823512
HSU1-02-04,3,5306550
HSU1-03-08,3,5159419
HSU1-03-10,4,5573372
HSU1-03-10,4,5573377
HSU1-03-10,4,5163812
HSU1-04-03,3,5162796
HSU1-04-03,3,5159440
HSU1-04-03,3,5164422
HSU1-04-03,4,5159160
HSU1-01-08,3,5570231
M1S1-07-13,3,5414800
HSU1-01-12,3,5827241
HSU1-02-06,4,5306291
HSU1-02-06,3,5304333
HSU1-02-06,4,5305223
HSU1-02-06,4,5309818
HSU1-02-06,2,5309868
HSU1-03-06,1,5573352
HSU1-02-06,4,5306331
HSU1-02-06,3,5309789
M2S1-05-08,3,5596596
HSU1-02-07,3,5570315
HSU1-02-07,3,5304815
HSU1-02-07,4,5309917
HSU1-02-07,3,5307555
HSU1-03-11,4,5162672
HSU1-03-14,3,5159625
HSU1-04-03,3,5160772
HSU1-04-03,4,5163165
HSU1-04-03,3,5160583
HSU1-04-03,3,5160718
HSU1-04-03,4,5162827
HSU1-04-03,3,5161809
HSU1-04-03,3,5161950
HSU1-04-07,4,5161152
HSU1-04-07,4,5161984
HSU1-02-11,3,5573479
HSU1-02-11,4,5573481
HSU1-04-16,3,5577224
HSTA-02-06,4,5165350
HSU1-04-16,3,5827564
M2S1-02-13,2,5592893
HSU1-04-16,3,5828639
M2S1-03-14,4,5370073
HSU1-04-20,4,5161538
HSU1-01-12,4,5570266
HSU1-04-20,3,5163486
HSU1-05-04,4,5163674
HSU1-05-04,4,5161885
HSU1-05-06,4,5163368
HSU1-05-04,3,5162035
HSU1-05-04,3,5163809
HSU1-08-06,2,5842008
HSU1-05-04,3,5159141
HSU1-05-04,3,5160836
HSU1-05-04,3,5161373
HSU1-05-04,3,5161164
HSU1-05-11,3,5575897
HSU1-06-05,2,5843134
HSU1-06-08,4,5162830
HSU1-06-08,4,5163177
HSU1-06-08,4,5159730
HSU1-06-11,4,5163964
HSU1-06-11,4,5163811
HSU1-06-11,3,5161675
HSU1-06-11,3,5162873
HSU1-06-10,4,5164435
HSU1-06-07,3,5843165
HSU1-10-15,2,6038804
HSU1-06-20,3,5628683
HSU1-06-22,3,5628716
HSU1-06-23,4,5628720
HSU1-07-07,2,5628748
HSU1-07-07,4,5576101
HSU1-07-07,4,5843198
HSU1-07-07,3,5843238
HSU1-07-13,4,5628757
HSU1-07-11,4,5849863
HSU1-07-11,4,5849867
HSU1-08-03,3,5841920
HSU1-08-03,3,5841921
HSU1-08-03,2,5841922
HSU1-08-03,2,5841924
HSU1-08-03,3,5827358
HSU1-08-03,3,5827374
HSU1-08-07,2,5847803
HSU1-08-07,2,5827359
HSU1-09-04,3,5827395
HSU1-08-12,3,5309535
HSU1-08-12,3,5305504
HSU1-08-12,3,5309865
HSU1-08-12,3,5309525
HSU1-08-12,3,5309344
M2S1-09-12,4,6037731
HSU1-09-01,4,5576465
HSU1-09-01,4,5827362
HSU1-09-01,4,5308843
HSU1-09-01,4,5306254
HSU1-09-01,4,5304927
HSU1-09-06,4,5309296
HSU1-09-10,3,5306095
HSU1-09-10,3,5847915
HSU1-10-04,1,5824340
HSU1-10-01,3,5827412
HSU1-10-04,1,5847946
HSU1-10-02,4,5576491
HSU1-10-05,2,5842886
HSU1-10-05,2,5842887
HSU1-10-08,3,5576078
HSU1-10-08,3,5576485
HSU1-10-08,3,5576486
HSU1-10-08,3,5576487
HSU1-10-05,3,5827405
HSU1-10-05,3,5827430
HSU1-10-05,4,5827431
HSU1-10-11,4,5827416
HSU1-10-13,3,5824375
EXEP-01-01,3,5371831
HSU1-10-13,3,5827424
EXEP-01-01,0,5161511
HSU1-01-09,2,5575997
HSU1-01-04,3,5827233
HSU1-01-06,3,5570249
HSU1-01-06,3,5570250
HSU1-01-06,3,5570251
HSU1-01-13,3,5575974
HSU1-01-06,3,5827232
HSU1-01-10,2,5570219
M1S1-03-06,2,5529704
HSU1-03-05,3,5159624
HSU1-03-11,4,5160362
HSU1-03-05,5,5828965
M2S1-10-11,3,5408813
M2S1-03-07,2,5372844
M2S1-04-02,2,5370266
M1S1-05-19,4,3168475
HSU1-01-09,4,3456196
EXEP-01-01,4,3456197
HSU1-11-11,4,3456198
H1S2-02-01,4,3456199
H1S1-10-05,4,3456200
H1S2-06-10,4,3456201
H1S1-08-17,5,3456202
HSU1-09-01,2,3456203
H1S1-05-08,2,3456204
H1S2-04-19,3,3456205
H1S1-11-18,3,3456206
EXEP-01-01,4,3456207
EXEP-01-01,4,3456208
H1S1-12-05,4,3456209
H1S1-08-11,4,3456210
HSU1-09-04,5,3456211
HSU1-01-02,2,3456274
H1S1-08-01,2,3456275
HSU1-04-07,3,1095862
M1S1-03-02,2,5393167
M1S1-07-02,3,5414265
M1S1-09-02,4,5412071
EXEP-01-01,,5411919
M1S1-09-05,3,5414267
HSU2-02-11,3,1095863
HSTA-02-06,4,5167340
M2S1-03-15,5,5368450
M2S1-03-15,5,5369677
M2S1-03-15,4,5369847
M2S1-04-01,3,5369566
M2S1-04-02,2,5368834
M2S1-04-03,3,5367393
M2S1-04-03,3,5368833
M2S1-04-04,3,5368749
M2S1-04-04,3,5368835
M2S1-04-04,3,5369615
M2S1-04-04,4,5370097
M2S1-04-06,3,5367392
M2S1-04-06,3,5368837
M2S1-04-06,3,5370094
M2S1-04-08,3,5369972
M2S1-04-09,3,5369618
M2S1-04-09,3,5370095
M2S1-04-10,3,5368751
M2S1-04-10,3,5369568
M2S1-04-10,3,5370019
M2S1-04-10,3,5370096
M2S1-04-12,4,5368838
M2S1-04-12,3,5369579
M2S1-05-04,3,5368758
M2S1-05-04,5,5368842
M2S1-05-05,3,5370351
M2S1-05-05,3,5371076
M2S1-05-06,3,5369633
M2S1-05-06,4,5370101
M2S1-05-06,3,5371072
M2S1-05-06,3,5371117
M2S1-05-06,3,5371350
M2S1-05-06,3,5371417
M2S1-05-06,3,5372539
M2S1-06-01,3,5368434
M2S1-06-02,3,5367489
M2S1-06-02,3,5368735
M2S1-06-02,3,5370077
M2S1-06-03,3,5367528
M2S1-06-04,2,5368955
M2S1-06-05,3,5368822
M2S1-06-07,3,5368436
M2S1-06-07,3,5368819
M2S1-06-09,4,5367491
M2S1-06-10,5,5367522
M2S1-06-11,4,5368741
M2S1-06-12,3,5367529
M2S1-06-15,5,5369497
M2S1-06-17,3,5367492
M2S1-06-17,3,5369498
M2S1-06-18,3,5367495
M2S1-06-18,5,5368441
M2S1-07-02,4,5369553
M2S1-07-04,5,5369861
M2S1-07-04,3,5370084
M2S1-07-04,3,5370352
M2S1-07-06,3,5368832
M2S1-07-07,4,5369614
M2S1-07-08,3,5367496
M2S1-07-08,4,5368744
M2S1-07-09,3,5368768
M2S1-07-09,3,5369685
M2S1-07-09,3,5370248
M2S1-07-09,3,5370354
M2S1-07-11,3,5369692
M2S1-07-11,3,5369856
M2S1-07-12,3,5369612
M2S1-07-16,3,5370353
M2S1-07-21,3,5367530
M2S1-08-01,3,5370103
M2S1-08-03,3,5370102
M2S1-08-03,3,5370355
M2S1-08-07,3,5368763
M2S1-08-07,3,5370023
M2S1-08-08,4,5370356
M2S1-08-08,3,5370428
M2S1-08-08,3,5370669
M2S1-08-09,3,5369625
M2S1-08-09,3,5370025
M2S1-08-10,4,5368850
M2S1-08-10,3,5369623
M2S1-08-10,3,5370049
M2S1-08-11,4,5369992
M2S1-08-11,3,5370681
M2S1-08-11,4,5371003
M2S1-08-12,3,5369626
M2S1-09-01,5,5367404
M2S1-09-01,4,5369985
M2S1-09-02,3,5369569
M2S1-09-04,3,5367402
M2S1-09-04,4,5369575
M2S1-09-04,3,5369984
M2S1-09-05,4,5369982
M2S1-09-06,4,5369986
M2S1-09-07,4,5367401
M2S1-09-07,4,5369630
M2S1-09-09,3,5367405
M2S1-09-12,3,5368869
M2S1-09-14,4,5367414
M2S1-09-15,3,5369582
M2S1-09-16,4,5367409
M2S1-09-16,3,5370438
M2S1-10-01,3,5370034
M2S1-10-03,2,5369576
M2S1-10-04,3,5370032
M2S1-10-04,3,5370441
M2S1-10-07,4,5370105
M2S1-10-07,3,5370427
M2S1-10-07,3,5370997
M2S1-10-09,4,5371135
M2S1-10-10,5,5369585
M2S1-10-11,5,5367406
M2S1-10-11,3,5370442
M2S1-10-12,3,5368854
M2S1-10-12,5,5370037
M2S1-10-12,3,5370674
M2S1-10-12,3,5371083
M2S1-10-13,4,5370029
M2S1-10-13,3,5370106
M2S1-10-14,4,5367407
M3S1-01-01,4,4976336
M3S1-01-01,3,4977364
M3S1-01-04,3,4976337
M3S1-01-04,3,4976551
M3S1-01-04,3,4977365
M3S1-01-04,3,4977367
M3S1-01-05,4,4976342
M3S1-01-05,4,4976343
M3S1-01-05,4,4977099
M3S1-01-05,4,4977410
M3S1-01-05,4,4977868
M3S1-01-06,4,4977411
M3S1-01-07,4,4976422
M3S1-01-08,4,4977087
M3S1-01-08,4,4977531
M3S1-01-09,3,4976414
M3S1-01-09,3,4976549
M3S1-01-10,3,4976339
M3S1-02-01,3,4977368
M3S1-02-01,3,4977414
M3S1-02-02,3,4977096
M3S1-02-04,4,4977370
M3S1-02-04,3,4977525
M3S1-02-04,3,4981081
M3S1-02-05,3,4976882
M3S1-02-05,4,4977078
M3S1-02-05,5,4977415
M3S1-02-05,5,4980969
M3S1-02-06,3,4976548
M3S1-02-06,3,4977523
M3S1-02-07,4,4977080
M3S1-02-07,4,4977537
M3S1-02-07,4,4980965
M3S1-02-08,4,4976417
M1S1-01-07,3,5413189
M1S1-03-02,3,5416077
M1S1-07-03,3,5415679
M1S1-04-21,4,5415967
M1S1-05-18,4,5412048
HSU2-09-03,4,1095865
HSU2-06-06,4,1095867
HSTA-02-09,3,5166038
M3S1-02-08,3,4976421
M3S1-02-08,3,4977076
M3S1-02-08,4,4977527
M3S1-02-08,3,4980967
M3S1-03-01,3,4976273
M3S1-03-01,3,4977528
M3S1-03-01,3,4986767
M3S1-03-01,3,4987086
M3S1-03-04,3,4977865
M3S1-03-04,3,4980966
M3S1-03-04,3,4987087
M3S1-03-05,5,4976341
M3S1-03-05,3,4977374
M3S1-03-05,3,4977534
M3S1-03-05,3,4981169
M3S1-03-05,3,4986101
M3S1-03-05,3,4986768
M3S1-03-06,3,4976546
M3S1-04-01,3,4976274
M3S1-04-01,4,4976279
M3S1-04-01,3,4976550
M3S1-04-01,5,4977082
M3S1-04-01,3,4977372
M3S1-04-05,3,4976420
M3S1-04-05,4,4977083
M3S1-04-05,5,4977101
M3S1-04-06,4,4976344
M3S1-04-06,4,4977107
M3S1-04-06,3,4977416
M3S1-04-07,3,4976881
M3S1-04-08,3,4976878
M3S1-04-08,2,4977371
M3S1-04-12,5,4977100
M3S1-04-13,4,4976278
M3S1-04-13,3,4976419
M3S1-04-13,3,4976545
M3S1-04-13,4,4976883
M3S1-05-01,3,4976347
M3S1-05-01,3,4976423
M3S1-05-02,3,4976280
M3S1-05-02,3,4976424
M3S1-05-02,3,4977375
M3S1-05-03,3,4976348
M3S1-05-03,4,4976350
M3S1-05-05,3,4976346
M3S1-05-05,4,4976354
M3S1-05-05,4,4976427
M3S1-05-05,3,4976555
M3S1-05-07,4,4976286
M3S1-05-07,3,4976352
M3S1-05-08,3,4976282
M3S1-05-08,3,4976426
M3S1-05-08,3,4976557
M3S1-05-09,3,4977102
M3S1-05-10,3,4976349
M3S1-05-11,3,4976281
M3S1-06-04,5,4977088
M3S1-06-07,3,4976283
M3S1-06-07,4,4976428
M3S1-06-07,3,4977377
M3S1-06-07,3,4981084
M3S1-06-07,4,4981093
M3S1-06-07,3,4982516
M3S1-06-07,3,4986106
M3S1-06-07,3,4988151
M3S1-06-08,4,4976886
M3S1-06-08,4,4977084
M3S1-06-08,5,4977086
M3S1-06-08,3,4977419
M3S1-06-08,5,4980974
M3S1-06-08,4,4981085
M3S1-06-09,4,4976429
M3S1-06-09,4,4977103
M3S1-06-09,3,4977378
M3S1-07-01,3,4976887
M3S1-07-01,3,4977000
M3S1-07-01,3,4977108
M3S1-07-01,3,4981087
M3S1-07-02,3,4977001
M3S1-07-04,3,4977347
M3S1-07-04,5,4980975
M3S1-07-05,3,4976445
M3S1-07-05,4,4977109
M3S1-07-06,3,4977005
M3S1-07-06,3,4977878
M3S1-07-06,3,4981088
M3S1-07-06,4,4981089
M3S1-07-11,3,4977877
M3S1-07-11,3,4982513
M3S1-07-11,3,4982519
M3S1-07-12,3,4976447
M3S1-07-12,3,4977003
M3S1-07-12,3,4977880
M3S1-08-01,3,4976637
M3S1-08-01,4,4977427
M3S1-08-01,3,4980768
M3S1-08-01,3,4981086
M3S1-08-01,3,4981222
M3S1-08-02,3,4976641
M3S1-08-02,3,4976646
M3S1-08-02,3,4977006
M3S1-08-03,4,4977879
M3S1-08-03,3,4977881
M3S1-08-05,4,4980535
M3S1-08-05,3,4981220
M3S1-08-07,3,4981221
M3S1-08-08,5,4980978
M3S1-08-09,3,4976446
M3S1-08-09,3,4977426
M3S1-08-09,3,4980767
M3S1-08-11,3,4976449
M3S1-08-11,3,4976978
M3S1-08-11,4,4977425
M3S1-09-04,3,4978505
M3S1-09-05,3,4976642
M3S1-09-05,4,4980770
M3S1-09-05,3,4982893
M3S1-09-06,3,4977007
M3S1-09-06,3,4977348
HCAL-02-15,4,1095870
HSU1-04-06,4,1095872
HSU2-09-11,4,1095874
HCAL-01-08,4,1095875
HCAL-09-11,4,1095877
HCAL-04-13,5,1095878
HCAL-01-14,2,1095879
HSU2-07-02,2,1095880
HSU2-05-05,3,1095881
HCAL-02-04,3,1095882
HSU2-01-13,4,1095883
HCAL-01-17,4,1095885
HCAL-03-07,4,1095886
HCAL-04-04,4,1095887
HSU2-05-16,5,1095888
H1S1-01-01,2,1095389
H1S2-02-01,2,1095390
H1S1-04-02,2,1095391
H1S2-06-07,3,1095392
H1S2-04-12,3,1095393
H1S1-02-14,3,1095395
H1S1-10-01,3,1095397
H1S2-03-16,3,1095398
H1S1-08-20,3,1095400
H1S1-09-07,3,1095402
H1S1-05-08,3,1095406
H1S2-05-12,3,1095408
H1S2-05-22,3,1095451
H1S1-02-11,4,1095426
H1S1-06-08,4,1095427
H1S1-12-13,4,1095428
H1S1-12-13,4,1095429
H1S1-07-10,4,1095430
H1S1-06-03,4,1095431
H1S1-02-06,4,1095433
H1S1-11-18,5,1095434
HSU1-08-03,2,1095435
H1S1-12-02,2,1095436
HSU1-08-09,3,1095437
H1S2-01-09,3,1095438
H1S2-04-19,4,1095439
H1S1-07-16,4,1095440
H1S2-03-25,4,1095441
HSU1-09-08,4,1095443
H1S1-12-01,5,1095446
HSU1-01-05,2,865844
H1S2-02-01,2,865845
HCAL-01-14,2,865846
HSTA-04-08,3,865847
H1S2-04-19,3,865848
HSU1-08-03,3,865849
HSU2-01-01,3,865850
H1S2-03-07,3,865851
HCAL-09-10,3,865852
HSTA-04-02,3,865853
HSTA-03-11,3,865854
HSU2-06-08,3,865855
HCAL-01-08,3,865856
H1S2-05-15,4,865857
HSTA-05-04,4,865858
HSU2-08-13,4,865859
HSU2-01-13,4,865860
HCAL-02-16,4,865861
HSTA-05-05,4,865862
HSU2-06-01,4,865863
H1S2-06-15,5,865864
H1S2-07-15,2,865865
HSU2-03-11,2,865866
H1S2-02-02,3,865867
HSU1-10-10,3,865868
HSU2-04-16,4,865869
HSTA-06-07,4,865870
HSTA-02-03,4,865871
HSU1-11-09,4,865872
HSU2-03-16,5,865873
HSU1-04-15,2,865874
EXEP-01-01,2,865875
HSTA-03-13,2,865876
HCAL-09-08,3,865877
HSTA-07-02,3,865878
EXEP-01-01,3,865879
HSU1-06-05,3,865880
EXEP-01-01,3,865881
HSTA-03-03,3,865882
EXEP-01-01,3,865883
HSTA-04-02,3,865908
HCAL-05-02,3,865884
H1S2-07-02,3,865886
HCAL-05-12,4,865887
EXEP-01-01,4,865888
HCAL-08-05,4,865889
HCAL-03-04,4,865890
EXEP-01-01,4,865891
HSTA-05-05,4,865893
EXEP-01-01,4,865894
HCAL-07-09,5,865895
HSTA-06-11,2,865897
HSTA-01-05,2,865898
HCAL-05-10,3,865899
HCAL-03-11,3,865900
H1S2-07-21,4,865901
HCAL-04-13,4,865902
EXEP-01-01,4,865903
EXEP-01-01,4,865905
HCAL-10-04,5,865907
HSU1-01-05,2,953019
H1S2-01-06,2,953020
HCAL-01-14,2,953021
H1S2-04-10,3,953022
HSU2-01-02,3,953024
H1S2-03-16,3,953025
HSTA-04-02,3,953026
H1S2-07-25,3,953027
HSU2-08-02,3,953029
HSTA-04-08,3,953031
H1S2-05-22,3,953033
HSTA-02-05,3,953035
HSU1-11-05,3,953036
HSU1-10-02,4,953037
HSTA-07-04,4,953039
HSU1-02-03,4,953041
HSTA-05-07,4,953042
HSU2-03-11,4,953043
HCAL-02-16,4,953063
HSU2-05-17,4,953050
H1S2-04-15,5,953054
H1S2-07-15,2,953056
HSU2-03-11,2,953057
H1S2-01-05,3,953058
HSU2-01-04,3,953059
HSU2-09-02,4,953060
HSU1-10-04,4,953061
HSTA-04-11,4,953062
HSU2-06-06,4,953064
HCAL-01-19,5,953065
EXEP-01-01,2,952765
HCAL-03-04,2,952766
EXEP-01-01,2,952772
HSTA-04-08,3,952776
HSU1-03-07,3,952777
HSTA-02-05,3,952784
HSU1-06-19,3,952786
EXEP-01-01,3,952791
HCAL-05-01,3,952794
HSTA-07-04,3,952799
HCAL-05-12,3,952810
HCAL-10-08,3,952815
HSTA-04-02,3,952820
HCAL-04-03,4,952826
HCAL-08-05,4,952834
EXEP-01-01,4,952839
HCAL-04-13,4,952843
HSTA-01-07,4,952912
HSTA-05-01,4,952916
EXEP-01-01,4,952920
HCAL-05-05,5,952928
H1S2-07-15,2,952929
HCAL-05-05,2,952930
HCAL-05-10,3,952931
EXEP-01-01,3,952932
HSTA-06-07,4,952933
EXEP-01-01,4,952934
HSTA-03-07,4,952935
EXEP-01-01,4,952936
HSU2-08-12,5,952937
HSU1-06-07,4,5163676
HSU1-02-02,3,5306017
HSU1-03-09,3,5163738
HSU1-03-06,2,5573353
HSU1-04-10,3,6064635
M2S1-01-11,2,5369740
M3S1-03-04,3,4982702
M2S1-07-16,4,5370179
M2S1-07-11,4,5371379
M2S1-01-08,3,5370842
M3S1-09-06,3,4976624
HSTA-05-08,3,5183003
HSTA-07-02,3,5177260
HSTA-01-11,4,5173122
M3S1-01-08,4,4980418
HSTA-06-13,3,5174063
HSU1-01-14,3,5305489
HSU1-08-08,3,5827392
HSU1-09-10,5,6065373
M3S1-06-08,3,4977539
M3S1-12-10,3,4978233
M2S1-07-11,3,5370010
M2S1-08-04,3,6037704
M3S1-09-10,2,4983466
HSTA-01-10,4,5183481
HSTA-05-09,4,5173842
HSTA-06-02,3,5188057
HSTA-06-02,3,5176973
M3S1-04-05,1,4976262
M3S1-04-11,3,5532017
HSU1-06-07,3,5160838
H1S1-06-03,3,4979064
HSTA-07-04,4,5167823
HSTA-05-09,3,5167819
HSU1-05-13,4,5160734
H1S1-06-02,2,4984018
M2S1-05-06,3,5370444
M3S1-01-05,4,4976353
M2S1-08-13,4,5369983
H1S1-08-21,3,5998332
HSU1-11-02,3,5824480
H1S1-10-01,2,4985043
M1S1-09-07,3,5412346
M3S1-06-07,5,4988165
HSU1-03-12,4,5163498
HSTA-03-05,3,5166555
M3S1-04-06,3,4976892
M2S1-03-13,3,5370091
H1S1-01-08,3,4981865
H1S1-08-24,4,4980064
H1S1-09-03,3,4981537
H1S1-11-14,4,4982090
HSU1-10-10,3,5306621
HSTA-03-15,4,5167620
HSTA-02-06,4,5167374
HSTA-05-11,3,5167814
HSTA-06-03,3,5178099
HSU1-07-05,4,5159721
HSU1-11-05,4,5306644
M2S1-01-02,3,5370371
HSU1-11-01,3,5576511
HSU1-10-14,3,5576504
HSU1-04-09,4,5161309
HSU1-02-10,5,5306560
HSU1-08-06,3,6065322
HSU1-10-06,4,6064845
M3S1-06-09,2,4987458
M2S1-04-10,3,5408782
M2S1-07-10,3,6038124
M3S1-03-07,3,4977483
M3S1-09-06,3,4988316
HSTA-04-04,3,5187190
HSTA-05-04,3,5188603
HSTA-02-05,4,5183745
HSTA-06-10,3,5184005
HSTA-06-09,3,5175249
M3S1-05-08,3,4981063
HSU1-04-18,3,5163612
M3S1-04-11,3,5532018
HSU1-08-09,4,5306637
HSU1-11-11,3,5305294
H1S1-08-08,3,4985414
M3S1-05-08,3,4976885
M1S1-09-05,4,5412363
M2S1-09-05,3,5370026
HSU1-04-08,3,5162051
HSU1-11-13,4,5306627
HSU1-11-13,4,5304840
H1S1-10-07,3,4979479
M1S1-07-11,4,5413063
M2S1-01-13,3,5370171
HSU1-01-09,3,5305298
H1S1-03-10,3,4987890
M3S1-06-09,3,4987575
H1S1-01-08,4,4983869
H1S1-08-16,3,4979474
H1S1-09-08,2,4982083
H1S2-07-26,3,5172331
HSTA-03-11,2,5174749
HSTA-05-09,2,5166154
HSU1-04-02,2,5163434
HSU1-11-05,3,5306643
HSU1-03-18,3,5828283
HSU1-11-03,3,5576501
HSU1-05-03,3,5158998
HSU1-01-01,1,5309042
HSU1-09-08,4,5309331
HSU1-06-14,3,6064674
M2S1-09-04,3,5372541
M3S1-09-04,3,4980690
M2S1-02-07,3,5371198
M2S1-01-13,3,5367931
M2S1-05-12,3,6038097
M3S1-03-04,3,4976197
M3S1-08-11,3,4978460
M3S1-05-04,4,4986049
HSTA-05-06,3,5162376
HSTA-04-10,3,5183005
HSTA-03-02,4,5188289
M3S1-11-01,2,4976654
H1S1-04-08,4,5625864
HSU1-03-09,3,5573370
EXEP-01-01,3,5998262
HSTA-03-13,3,5175398
HSU1-09-12,4,5305486
M1S1-05-05,3,5393045
M1S1-03-08,3,5414740
M1S1-04-06,5,5413703
HSU1-02-08,4,6064610
M1S1-08-07,3,6037770
HSU1-04-06,4,5159720
M2S1-09-10,3,5369637
M3S1-01-06,4,4976289
M3S1-09-08,3,4977359
H1S1-10-11,2,4984931
HSU1-11-11,4,5306633
M3S1-12-09,4,4982446
H1S1-03-11,3,4987887
H1S1-04-06,4,4984449
H1S1-01-08,3,4980056
H1S1-08-13,3,4985021
H1S1-09-07,2,4984924
H1S1-12-08,4,4987943
HSTA-03-07,3,5175414
HSTA-05-01,1,5167021
HSTA-06-13,3,5166170
HSTA-07-06,3,5162019
HSU1-05-02,2,5161981
EXEP-01-01,4,5160645
HSTA-03-07,4,5171877
HSU1-11-03,3,5576512
HSU1-09-11,3,5576464
HSU1-11-03,3,5576499
H1S1-08-13,3,6106477
HSU1-03-05,4,5162829
HSU1-08-12,4,5307522
HSU1-06-09,3,6065258
HSU1-10-02,3,6064431
M2S1-07-09,3,5370278
M2S1-09-01,3,5369079
M2S1-05-06,2,5369403
M2S1-07-13,5,6106410
M1S1-05-16,3,5413443
HSTA-03-12,3,5176935
HSTA-03-12,4,5175881
HSTA-05-09,3,5174859
M3S1-08-05,4,4988410
M3S1-11-02,3,4986559
HSTA-04-01,3,5184630
H1S1-04-02,3,5625833
M3S1-02-05,3,6037893
HSU1-02-04,4,5306100
HSTA-07-05,3,5188351
HSU1-04-03,3,5161983
HSU1-08-12,3,5304834
H1S1-10-07,3,4982085
M1S1-05-03,3,5413184
M2S1-05-10,4,5372065
M2S1-05-10,5,5367410
HSU1-02-15,2,5843557
M1S1-07-08,4,5410239
M2S1-02-11,5,5367538
M1S1-02-09,4,5393051
HSU1-11-05,4,5304854
H1S1-02-05,4,4986082
H1S1-08-20,3,4984262
H1S1-10-05,4,4982089
HSTA-01-08,3,5167392
H1S2-07-19,4,5172328
HSTA-03-07,3,5177688
HSTA-05-01,2,5167023
HSTA-06-13,4,5167315
HSTA-07-06,4,5175748
HSTA-07-12,3,6065542
HSTA-07-11,4,5167824
HSU1-11-01,3,5827447
HSU1-07-03,3,5577096
HSU1-10-14,3,5827436
M2S1-03-07,2,5593326
H1S1-05-07,3,5998206
HSU1-11-12,3,5307699
HSU1-11-09,3,5304314
HSU1-07-06,4,6064689
HSU1-11-10,2,6038807
M2S1-03-05,3,5368506
M2S1-01-15,3,5372195
M3S1-09-10,4,4984297
M3S1-03-02,4,4983088
M1S1-05-16,3,3168437
HSTA-01-05,4,5175366
HSTA-06-02,3,5175998
HSTA-02-02,3,5178239
HSTA-04-07,3,5183070
M3S1-08-05,3,4986054
M3S1-07-10,3,5552115
H1S1-05-04,4,5604821
HSU1-07-05,2,6065302
HSU1-05-06,2,5162009
HSTA-07-04,3,5166169
HSU1-10-11,3,5304930
HSU1-04-06,4,5163440
H1S1-05-08,2,4987201
HSU1-04-06,3,5160384
M2S1-06-13,5,5370092
HSTA-01-07,2,5174743
HSU1-06-08,3,6065252
H1S1-02-03,4,4985027
M3S1-09-06,3,4978523
M1S1-07-11,4,5413152
M2S1-08-13,4,5370053
HSU1-08-11,3,5308632
M2S1-06-09,3,5369507
M1S1-04-13,3,5393062
H1S1-04-06,4,4980457
HSTA-01-11,3,5167607
HSTA-03-02,4,5177696
HSTA-05-01,1,5167297
HSTA-06-13,2,5167816
HSTA-07-12,3,5167311
HSU1-01-01,4,5306645
M2S1-10-12,5,5369587
HSU1-08-09,2,5576451
HSU1-07-02,3,5576081
H1S1-08-07,3,5998189
HSU1-10-06,3,5827402
EXEP-01-01,,5161308
M2S1-03-07,2,5593323
M2S1-02-10,3,6065705
H1S1-08-03,3,5998274
HSU1-06-03,3,5161832
HSU1-10-08,4,5307254
HSU1-04-17,3,6064392
HSU1-02-12,1,5570334
M2S1-04-05,3,5367565
M2S1-10-10,5,5372135
M2S1-10-04,3,5369342
M2S1-05-07,3,5370605
M3S1-09-07,5,4986553
M3S1-03-06,3,4981065
M1S1-05-16,3,3168482
HSTA-04-04,3,5184072
HSTA-01-05,4,5183484
HSTA-03-08,3,5581356
M3S1-09-02,3,5549236
H1S1-08-07,3,5998196
HSU1-10-11,3,5306266
HSU1-09-08,3,5307705
HSU1-10-06,3,5827403
HSU1-02-02,3,5306255
H1S1-10-12,3,4978798
H1S1-01-04,3,4979027
M2S1-03-13,3,5369737
M2S1-09-03,3,5370364
M2S1-07-04,3,5370250
M3S1-02-04,5,5583513
HSTA-03-05,3,6065562
M1S1-05-07,5,5413553
M3S1-03-01,4,4976288
M2S1-05-06,3,5372240
M2S1-09-10,3,5369994
M2S1-10-14,3,5371092
HSU1-11-05,4,5304853
M3S1-12-05,4,4977363
H1S1-04-08,4,4980061
H1S1-08-21,3,4985035
HSTA-02-03,4,5172265
HSTA-02-05,3,5160569
HSTA-03-12,3,5174750
HSTA-05-07,3,5167821
HSTA-06-02,3,5166165
HSU1-03-05,3,5837913
HSU1-08-06,5,5305497
M1S1-06-01,3,5412628
M1S1-04-14,3,5410646
HSU1-11-05,4,5576515
HSU1-02-14,3,5576372
HSTA-06-10,3,5176336
M2S1-07-15,2,6037747
HSU1-01-05,2,5570229
HSU1-08-05,2,5842007
HSU1-03-12,3,5164436
HSU1-02-18,3,5307542
HSU1-10-12,3,5309931
HSU1-06-09,3,5162902
M2S1-07-08,2,5371308
M3S1-10-04,3,4977351
M2S1-09-14,2,5372752
M2S1-07-04,4,5372472
M3S1-03-06,2,4981066
HSTA-03-08,4,5177685
HSTA-04-04,3,5187004
HSTA-02-06,4,5172325
HSTA-02-08,3,6065489
HSU1-01-01,2,5305477
HSU1-10-05,4,5306257
HSTA-01-01,4,5167378
HSU1-08-03,3,5304833
H1S1-12-13,3,4984322
HSU1-11-11,3,5304933
M2S1-01-07,4,5368930
M2S1-01-17,3,5367510
M2S1-08-07,3,5367399
HSU1-10-13,3,5827435
M1S1-09-06,4,3172926
H1S1-10-07,3,4984315
M2S1-07-12,5,5368862
HSTA-02-05,3,5174762
M3S1-09-05,4,4976467
HSU1-04-15,3,5164437
HSU1-09-05,4,5306105
HSU1-11-05,4,5306103
M3S1-07-06,3,4976464
HSU1-11-07,5,5306287
H1S1-08-21,3,4984239
H1S1-11-14,3,4984316
M3S1-03-01,4,4986753
HSTA-02-05,3,5172323
HSTA-04-06,3,5178091
HSTA-05-11,4,5175752
HSTA-06-06,3,5162017
HSU1-10-02,4,5305295
H1S1-11-18,5,4985812
HSU1-09-08,3,5827397
HSU1-11-03,3,5827463
M2S1-03-14,3,5594040
H1S1-07-08,3,5998234
HSU1-03-12,3,5159722
HSU1-06-11,4,5164558
HSU1-01-09,4,5823506
HSU1-06-02,4,6065239
M2S1-06-09,4,5372053
M2S1-02-07,3,5372359
M2S1-01-02,3,5409897
M3S1-12-09,3,4983438
HSTA-02-10,4,5187037
HSTA-07-05,4,5185419
HSTA-04-01,3,5183002
HSTA-04-07,4,5187255
HSTA-07-12,3,6065540
M3S1-07-09,3,4986469
M2S1-01-15,4,5367536
M3S1-06-03,3,6037897
HSU1-02-10,5,5306622
H1S1-02-06,3,4979652
H1S1-01-04,4,4979028
HSU1-08-09,5,5306626
HSU1-06-07,3,5162687
M3S1-03-05,4,4981146
M1S1-02-09,3,5413252
M1S1-08-04,3,5412360
M1S1-09-13,4,5412264
HSTA-01-01,3,5172674
M1S1-05-03,3,5413830
H1S1-09-07,3,4978799
M3S1-03-01,3,4986097
M2S1-03-10,3,3295300
M2S1-06-08,3,5594785
M2S1-05-06,4,5372577
M2S1-07-04,3,5369508
HSU1-03-20,3,6064364
HSU1-03-20,3,6064365
M2S1-07-15,3,6037750
H1S1-03-09,4,4984049
M2S1-02-08,3,3213117
HSU1-04-10,3,6064370
HSU1-04-13,3,6064371
HSU1-04-13,3,6064373
HSU1-04-13,3,6064374
HSU1-04-13,3,6064375
HSU1-04-14,4,6064378
HSU1-04-14,3,6064379
HSU1-08-04,3,5847706
HSU1-04-14,3,6064382
HSU1-04-14,3,6064383
HSU1-04-14,3,6064385
HSU1-09-03,1,6065343
HSU1-04-16,3,6064387
HSU1-04-16,3,6064388
HSU1-04-17,3,6064389
HSU1-04-17,3,6064391
M2S1-09-12,3,5741109
HSU1-04-17,3,6064395
HSU1-04-18,3,6064396
HSU1-05-13,4,5162554
HSU1-04-19,3,6064399
HSU1-04-20,3,6064401
HSU1-04-20,3,6064403
HSU1-04-20,3,6064404
HSU1-04-20,3,6064405
HSU1-04-20,3,6064406
HSU1-05-01,2,6064419
HSU1-05-01,2,6064420
HSU1-10-01,2,6064421
HSU1-10-01,2,6064422
HSU1-10-02,3,6064423
HSU1-10-02,3,6064425
HSU1-10-02,2,6064426
HSU1-10-02,3,6064427
HSU1-10-02,3,6064428
HSU1-10-02,3,6064429
HSU1-10-02,4,6064432
HSU1-10-03,3,6064434
HSU1-10-03,3,6064435
HSU1-10-03,3,6064436
HSU1-10-03,3,6064437
HSU1-10-03,3,6064438
HSU1-10-03,3,6064439
HSU1-01-08,3,6064442
HSU1-01-08,3,6064443
HSU1-01-08,3,6064445
HSU1-01-08,3,6064446
HSU1-01-08,3,6064448
H1S1-01-01,2,5407364
HSU1-02-08,4,6064607
HSU1-02-08,3,6064609
HSU1-02-08,4,6064611
HSU1-02-14,5,6064612
HSU1-02-14,4,6064613
HSU1-02-14,2,6064615
HSU1-02-14,3,6064616
HSU1-03-16,3,6064618
HSTA-02-02,3,5174746
M1S1-05-10,2,5586589
HSU1-04-02,3,6064622
HSU1-04-02,3,6064623
HSU1-04-02,3,6064624
HSU1-04-02,5,6064626
HSU1-04-02,3,6064627
HSU1-04-08,4,6064628
EXEP-01-01,4,5531573
M2S1-03-05,3,5369966
HSU1-04-08,4,6064631
HSU1-04-08,3,6064632
HSU1-04-10,3,6064634
HSU1-05-10,3,6064667
HSU1-06-04,3,6064668
HSU1-06-11,3,6064670
EXEP-01-01,3,5370177
HSU1-06-13,3,6064672
HSU1-06-14,3,6064675
HSU1-06-16,4,6064676
HSU1-06-20,3,6064679
HSU1-06-20,3,6064680
HSU1-06-20,2,6064682
HSU1-06-21,2,6064684
HSU1-06-24,3,6064685
HSTA-02-08,3,5172337
HSU1-07-06,2,6064690
HSU1-07-06,3,6064692
HSTA-04-08,2,5167807
HSU1-07-14,3,6064694
HSU1-08-01,3,6064696
HSU1-08-01,3,6064697
HSU1-08-02,2,6064699
HSU1-08-02,3,6064700
HSU1-08-02,3,6064702
HSU1-08-02,3,6064703
HSU1-08-04,4,6064705
HSU1-08-04,3,6064706
HSU1-08-04,2,6064708
HSU1-08-04,2,6064709
HSU1-08-04,3,6064711
HSU1-08-06,1,6064712
HSTA-06-03,2,5167031
HSU1-08-09,3,6064731
HSU1-08-12,3,6064732
HSU1-09-02,3,6064733
HSU1-09-02,5,6064734
HSU1-09-02,2,6064735
HSU1-09-02,3,6064742
HSU1-09-02,3,6064743
HSU1-09-06,3,6064745
HSU1-10-01,3,6064746
HSU1-10-01,2,6064748
HSU1-10-01,4,6064749
HSU1-10-01,3,6064750
HSU1-10-09,4,6064751
HSU1-10-15,3,6064752
HSU1-11-03,4,6064754
HSU1-04-03,3,5162022
HSU1-11-03,3,6064757
HSU1-11-06,4,6064758
HSU1-11-06,4,6064759
M1S1-04-03,1,5529896
M1S1-07-20,3,3168692
HSTA-01-09,3,5167623
HSTA-01-10,3,5160003
H1S1-03-11,2,3456276
H1S1-01-01,3,3456277
EXEP-01-01,3,3456278
EXEP-01-01,3,3456279
EXEP-01-01,3,3456280
EXEP-01-01,3,3456281
EXEP-01-01,3,3456282
EXEP-01-01,3,3456283
EXEP-01-01,3,3456284
HSU1-10-04,4,5305480
H1S1-07-17,3,4981880
HSU1-08-14,3,5576457
HSU1-11-05,4,5576514
HSU1-11-06,4,6064761
HSU1-11-06,3,6064762
HSU1-11-06,3,6064764
HSU1-11-12,3,6064817
M2S1-05-01,2,5534851
HSU1-11-06,3,6064822
HSU1-11-06,3,6064824
HSU1-11-06,3,6064825
HSU1-11-06,4,6064826
M1S1-02-02,2,5413229
HSU1-10-07,3,6064831
HSU1-10-07,3,6064832
HSU1-10-10,3,6064834
HSU1-10-10,3,6064835
HSU1-10-10,3,6064836
HSU1-10-10,3,6064840
M1S1-03-03,4,5416078
M2S1-07-15,3,6037724
HSU1-01-04,2,5570224
HSU1-10-06,3,6064846
HSU1-10-06,3,6064847
HSU1-06-01,2,6065225
HSU1-06-01,2,6065226
HSU1-06-01,3,6065228
HSU1-06-02,1,6065229
HSU1-06-02,2,6065230
HSU1-06-02,2,6065231
HSU1-06-02,2,6065232
HSU1-06-02,3,6065234
HSU1-06-02,3,6065237
HSU1-09-03,3,6065345
M1S1-04-11,3,5414156
HSU1-06-04,2,6065242
HSU1-06-04,2,6065243
HSU1-06-04,3,6065244
HSU1-06-08,2,6065245
HSU1-06-08,2,6065246
M2S1-09-12,5,6037729
HSU1-06-08,3,6065251
HSU1-07-06,4,5843218
HSU1-06-09,2,6065254
HSU1-06-23,2,5159594
HSU1-06-09,2,6065256
HSU1-06-09,3,6065259
M1S1-05-10,2,5586587
M1S1-07-13,3,5587235
HSU1-06-09,4,6065263
HSU1-06-09,3,6065265
HSU1-06-20,2,6065268
EXEP-01-01,2,5529623
HSU1-06-20,3,6065271
M1S1-08-02,3,5414595
HSU1-06-21,3,6065275
M2S1-02-16,3,3213147
HSU1-06-22,3,6065277
HSU1-06-22,3,6065278
HSU1-06-22,1,6065279
HSU1-06-26,2,6065280
HSU1-06-26,2,6065282
HSU1-06-26,2,6065284
HSU1-06-26,3,6065285
HSU1-06-26,3,6065288
HSU1-07-03,2,6065289
HSU1-07-03,2,6065290
HSU1-07-03,3,6065291
HSU1-07-03,3,6065292
HSU1-07-03,3,6065294
HSU1-07-04,2,6065295
HSU1-07-04,3,6065296
HSU1-07-04,3,6065297
HSU1-07-04,3,6065299
HSU1-07-04,3,6065300
HSU1-07-04,3,6065301
HSU1-07-05,2,6065303
HSU1-07-05,3,6065305
HSU1-07-05,3,6065306
HSU1-07-05,3,6065307
HSU1-08-02,1,6065308
HSU1-08-02,2,6065309
HSU1-08-02,3,6065310
HSU1-08-04,1,6065311
HSU1-08-05,2,6065313
HSU1-08-05,3,6065314
HSU1-08-06,1,6065315
HSU1-08-06,2,6065319
HSU1-08-06,2,6065320
HSU1-08-06,3,6065321
HSU1-08-10,1,6065323
HSU1-08-10,1,6065324
HSU1-08-10,3,6065325
HSU1-08-10,3,6065326
HSU1-08-11,3,6065327
M1S1-04-21,2,6106460
HSU1-08-11,3,6065330
HSU1-08-11,3,6065331
HSU1-08-13,1,6065332
HSU1-08-14,2,6065333
HSU1-08-14,2,6065334
HSU1-08-14,3,6065335
M3S1-09-06,4,4978516
HSU1-08-14,3,6065339
HSU1-08-14,4,6065340
HSU1-09-03,1,6065341
M3S1-09-06,3,4980530
HSU1-09-03,2,6065344
M3S1-09-07,3,4976643
M3S1-09-07,4,4976987
HSU1-09-03,3,6065347
HSU1-09-05,3,6065348
HSU1-09-05,3,6065349
M3S1-09-07,3,4980652
HSU1-09-06,3,6065351
M3S1-09-07,3,4981228
HSU1-09-06,3,6065354
HSU1-09-06,3,6065356
HSU1-09-07,2,6065357
HSU1-09-07,4,6065358
HSU1-09-07,2,6065360
HSU1-09-07,2,6065361
HSU1-09-07,2,6065362
HSTA-04-08,3,5187757
HSU1-09-07,3,6065366
HSU1-09-07,3,6065367
HSU1-09-07,4,6065368
HSU1-09-10,2,6065369
EXEP-01-01,3,3456285
HSU1-09-10,3,6065371
HSU1-09-10,2,6065372
M3S1-09-07,4,4982911
M3S1-09-10,4,4977355
EXEP-01-01,3,3456286
EXEP-01-01,4,3456287
EXEP-01-01,4,3456288
EXEP-01-01,4,3456289
EXEP-01-01,4,3456290
EXEP-01-01,4,3456291
EXEP-01-01,4,3456292
EXEP-01-01,4,3456293
EXEP-01-01,5,3456294
EXEP-01-01,2,3456295
EXEP-01-01,2,3456296
EXEP-01-01,3,3456297
EXEP-01-01,3,3456298
EXEP-01-01,4,3456299
EXEP-01-01,4,3456301
EXEP-01-01,4,3456302
EXEP-01-01,5,3456303
HSU1-01-05,2,4770364
HSU2-03-11,2,4770365
HCAL-01-14,2,4770366
H1S2-02-02,3,4770367
H1S2-04-16,3,4770368
H1S2-01-09,3,4770369
H1S2-03-16,3,4770370
HSU2-03-04,3,4770371
H1S2-03-22,3,4770372
HCAL-02-04,3,4770373
H1S2-04-10,3,4770374
HSU2-05-05,3,4770375
H1S2-05-15,3,4770376
HSU1-08-03,4,4770377
HSU2-01-02,4,4770378
HSU2-06-08,4,4770379
HSU1-10-04,4,4770380
HSU1-10-10,4,4770381
HSTA-03-05,3,6065556
HSTA-03-05,3,6065557
HSTA-03-05,3,6065559
HSTA-03-05,3,6065560
HSTA-03-05,3,6065561
M3S1-09-10,4,4982673
HSTA-03-05,3,6065563
M3S1-09-10,3,4982894
M3S1-10-01,3,4976456
M3S1-10-01,3,4976980
M1S1-02-01,3,5413186
HSTA-03-06,3,6065565
HSTA-03-06,3,6065566
HSTA-03-06,3,6065573
HSTA-03-06,3,6065575
HSTA-05-07,2,6065576
HSTA-05-07,3,6065577
HSTA-06-04,3,6065578
HSTA-06-04,3,6065579
HSTA-06-04,3,6065580
HSTA-06-04,3,6065581
HSTA-06-04,4,6065582
HSTA-06-04,3,6065583
HSTA-06-08,3,6065584
HSTA-06-08,2,6065586
HSTA-06-08,2,6065587
HSTA-06-08,3,6065588
HSTA-06-14,2,6065589
HSTA-06-14,5,6065590
HSTA-07-06,3,6065591
HSTA-07-06,3,6065592
HSTA-07-06,3,6065594
HSTA-07-06,3,6065595
M2S1-02-06,3,6065689
M2S1-02-06,3,6065690
M2S1-02-06,3,6065692
M2S1-02-06,3,6065693
M1S1-05-13,3,5414058
M1S1-07-03,3,5416162
M2S1-02-06,3,6065697
M1S1-04-07,4,5412335
M1S1-09-02,4,5412936
M2S1-02-10,3,6065701
M2S1-02-10,3,6065703
M2S1-02-10,3,6065704
M1S1-08-02,3,5415683
M2S1-02-10,3,6065706
M3S1-05-02,3,4987616
HSTA-02-10,3,5165466
M2S1-03-08,3,6065710
M3S1-10-01,3,4977325
M3S1-10-02,3,4982897
M2S1-04-01,3,6065714
M2S1-04-01,3,6065715
M1S1-05-14,3,6065716
M1S1-05-14,3,6065717
M2S1-05-03,4,3305291
M2S1-06-05,3,5594294
HSU1-09-04,2,5305881
M2S1-07-14,3,5740778
M3S1-10-03,3,4977340
HSU1-07-15,3,5628770
HSU1-09-03,3,6065346
HSU1-06-19,5,5163454
EXEP-01-01,1,5371828
M3S1-10-04,3,4977326
M1S1-07-09,3,5531881
M1S1-03-04,3,5529855
M1S1-06-09,2,5587172
M1S1-02-10,4,3157849
M3S1-10-04,3,4977327
M2S1-07-21,3,6065760
M2S1-07-21,3,6065761
M2S1-08-07,1,6065763
M2S1-08-07,1,6065764
M2S1-08-07,1,6065765
M2S1-08-07,1,6065766
M2S1-08-07,3,6065768
HSTA-01-10,4,5165681
HSU1-02-16,3,6043184
HSU1-02-16,2,6043185
HSU1-02-16,3,6043186
HSU1-02-16,3,6043187
HSU1-11-10,2,6038808
HSU1-11-10,2,6038809
HSU1-10-09,3,6069227
HSU1-10-09,3,6069228
M3S1-10-08,3,6069528
M3S1-07-08,3,6069529
M3S1-07-08,5,6069530
HSU1-07-10,4,5576100
M3S1-08-04,2,6069532
M3S1-08-04,3,6069533
M3S1-10-05,3,4976981
M3S1-10-05,3,4977010
M3S1-08-04,2,6069536
M3S1-10-05,3,4977011
M3S1-08-04,3,6069538
M3S1-08-04,2,6069539
M3S1-08-04,4,6069540
M3S1-10-08,3,6069541
M3S1-09-01,5,6069546
M3S1-10-06,4,4976453
M3S1-11-02,3,6069548
M3S1-12-05,3,6069549
M3S1-12-05,4,6069550
M3S1-11-03,4,6069551
M3S1-11-03,4,6069552
M3S1-05-02,5,6037896
M3S1-10-06,3,4977328
H1S1-01-01,3,4986212
H1S1-01-04,3,4979790
M3S1-10-07,3,4977331
H1S1-01-07,4,4984758
H1S1-01-07,4,4986455
M2S1-01-06,4,5370844
H1S1-08-01,3,4988517
HCAL-08-05,3,5395040
H1S1-02-02,3,4980070
H1S1-02-03,4,4987848
H1S1-02-03,4,4979442
H1S1-02-06,3,4981898
H1S1-02-07,4,4978858
H1S1-02-07,4,4984821
H1S1-02-07,3,4980071
H1S1-02-07,3,4986137
H1S1-02-08,3,4984957
H1S1-02-08,3,4987849
H1S1-02-08,3,4980563
H1S1-02-08,3,4988625
H1S1-02-08,3,4984370
H1S1-02-08,3,4988284
H1S1-02-10,3,4986645
HCAL-03-04,3,5395041
H1S1-02-12,2,4980260
H1S1-02-14,4,4979788
H1S1-03-04,3,4985999
H1S1-03-06,4,4988049
HCAL-10-09,3,5395042
H1S1-03-09,3,4986000
HCAL-03-07,4,5395043
H1S1-03-09,3,4985756
H1S1-03-10,4,4984753
H1S1-04-04,3,4980566
H1S1-04-04,3,4980565
H1S2-07-17,4,5395045
H1S1-04-04,3,4984549
HCAL-09-04,4,5395046
H1S2-07-17,4,5395047
HCAL-04-03,4,5395049
H1S1-05-05,3,4978768
H1S1-05-05,3,4988051
H1S1-05-08,4,4988984
H1S1-05-08,4,4985361
H1S1-05-09,3,4985623
H1S1-05-10,4,4979440
H1S1-05-10,3,4985712
H1S1-05-10,3,4980184
H1S1-05-13,4,4989102
H1S1-05-13,3,4981610
H1S1-05-13,2,4987130
H1S1-05-13,3,4979791
H1S1-05-15,4,4989010
H1S1-06-01,4,4987215
H1S1-06-02,3,4980185
H1S1-06-03,3,4981754
H1S1-06-03,3,4980264
H1S1-06-06,3,4979792
H1S1-06-06,4,4985327
H1S1-06-08,3,4985840
H1S1-07-06,3,4988359
H1S1-07-06,3,4980167
H1S1-07-11,3,4982111
H1S1-07-11,3,4987491
H1S1-07-11,3,4986088
H1S1-07-12,3,4987209
H1S1-07-12,3,4978952
H1S1-07-15,4,4989012
H1S1-07-16,3,4988825
H1S1-07-16,3,4988968
H1S1-07-16,3,4981586
H1S1-08-08,2,4985622
H1S1-08-12,4,4983866
H1S1-08-12,4,4985621
H1S1-08-12,3,4984930
H1S1-08-13,3,4980028
H1S1-08-14,4,4981540
H1S1-08-15,3,4984607
H1S1-08-16,3,4989049
H1S1-08-20,3,4981631
H1S1-08-21,4,4988539
M2S1-05-03,3,5534977
H1S1-05-03,3,5604799
H1S1-08-24,3,4986312
H1S1-08-25,3,4988937
H1S1-08-25,3,4984052
H1S1-09-02,3,4983863
H1S1-09-02,4,4984673
H1S1-09-02,3,4978709
H1S1-09-04,3,4988337
H1S1-09-04,3,4981680
H1S1-09-05,4,4986288
H1S1-09-05,4,4986523
H1S1-09-06,3,4979486
HSU1-09-11,3,5307253
H1S1-09-07,4,4984327
H1S1-09-09,3,4985914
H1S1-09-09,3,4979847
H1S1-09-11,4,4987948
H1S1-09-11,4,4979968
H1S1-10-01,2,4987303
H1S1-10-01,3,4985624
M2S1-05-13,3,3305285
H1S1-10-07,4,4985281
H1S1-10-09,3,4986599
H1S1-10-09,3,4980234
M2S1-03-10,3,3295269
H1S1-10-10,4,4984552
HSU1-03-20,3,5161806
M2S1-07-13,3,5740724
M1S1-02-03,2,5413185
H1S1-10-14,3,4982094
HSU1-07-12,2,5843210
H1S1-11-02,3,4986598
H1S1-11-02,4,4987763
H1S1-11-03,3,4988564
H1S1-11-03,3,4981493
H1S1-11-03,3,4985658
H1S1-11-04,4,4986522
H1S1-11-04,3,4988584
HSU1-08-14,3,6065336
H1S1-11-06,3,4984675
H1S1-11-10,3,4982076
M1S1-03-02,3,5413339
H1S1-11-11,4,4980238
H1S1-11-13,4,4986087
H1S1-11-13,3,4980526
H1S1-11-14,3,4981518
H1S1-11-14,3,4989178
H1S1-11-15,3,4988541
H1S1-11-15,4,4987795
H1S1-11-16,3,4986292
H1S1-11-18,3,4978975
H1S1-11-18,4,4989050
H1S1-11-18,3,4984328
H1S1-11-19,3,4985243
H1S1-11-19,3,4988487
H1S1-11-19,3,4988100
H1S1-12-02,3,4986293
H1S1-12-02,4,4984676
H1S1-12-02,3,4986378
H1S1-12-02,3,4981844
H1S1-12-03,4,4985627
M1S1-04-21,4,5415966
H1S1-12-04,3,4983865
H1S1-12-06,3,4978827
HSU1-06-12,3,6043214
H1S1-12-13,3,4985437
H1S1-12-13,2,4988879
H1S1-12-13,4,4985014
H1S1-12-12,4,4986377
H1S1-12-11,3,4982024
M1S1-09-02,4,5412937
M2S1-08-09,3,5371592
H1S1-12-10,3,4984329
H1S1-12-08,3,4980313
H1S1-12-07,4,4978829
M1S1-02-05,5,5415640
H1S1-01-07,4,4978592
H1S1-01-07,2,4980369
H1S1-01-08,3,4984349
H1S1-01-09,3,4987128
M3S1-04-13,4,4977607
H1S1-01-09,2,4981879
H1S1-02-02,3,4988821
H1S1-02-11,4,4978951
H1S1-03-08,4,4986596
H1S1-03-09,4,4988283
H1S1-04-04,3,4988358
M2S1-04-06,3,5370590
H1S1-04-06,3,4978856
H1S1-05-05,3,4978857
H1S1-05-10,4,4988172
H1S1-07-11,3,4984451
H1S1-08-16,4,4986159
H1S1-08-22,4,4984398
M2S1-07-18,3,5369564
H1S1-10-11,4,4988200
H1S1-10-11,3,4988437
M2S1-02-10,3,5368159
H1S1-10-16,5,4987596
H1S1-12-06,3,4986826
H1S1-12-11,4,4986827
M3S1-12-03,4,4980949
M2S1-01-06,3,5367739
M2S1-01-06,4,5372505
M2S1-01-07,3,5406482
M2S1-01-07,3,5393651
M2S1-01-11,3,5370634
M2S1-01-12,2,5370341
M2S1-01-13,3,5406481
M2S1-01-13,3,5369743
M2S1-01-13,3,5371895
M2S1-02-05,3,5369090
HSTA-05-10,3,5187110
M2S1-01-13,4,5372008
M2S1-01-13,3,5408757
M2S1-01-13,4,5370172
M2S1-01-14,4,5372792
M2S1-01-15,3,5408599
M2S1-01-15,3,5370088
M2S1-01-15,3,5369663
M2S1-01-15,3,5369908
M2S1-01-15,4,5370087
M2S1-02-01,3,5371472
M2S1-02-06,4,5372186
M2S1-02-09,3,5372676
M2S1-02-09,3,5369909
M2S1-02-09,3,5368499
M2S1-02-11,3,5369157
M2S1-02-11,4,5372370
M2S1-02-14,3,5371667
M2S1-02-14,4,5408642
M2S1-02-15,3,5369664
M2S1-02-15,4,5409915
M2S1-02-17,3,5371287
M2S1-03-05,3,5368507
M2S1-03-05,3,5371285
M2S1-03-05,3,5368813
M2S1-03-05,3,5367846
M2S1-03-07,3,5371476
M2S1-03-07,2,5372009
M2S1-03-07,3,5371477
M2S1-03-08,3,5371026
M2S1-03-09,2,5369158
M2S1-03-09,2,5369159
M2S1-03-10,2,5367436
M2S1-03-11,3,5370741
M2S1-03-11,3,5367539
M2S1-03-14,3,5406483
M2S1-04-02,2,5367564
M2S1-04-02,2,5371345
M2S1-04-02,2,5371347
M2S1-04-02,2,5367563
M2S1-04-05,3,5367183
M2S1-04-05,3,5367566
M2S1-04-06,4,5370890
M2S1-04-08,3,5372106
M2S1-04-10,3,5371111
M2S1-04-10,3,5367698
M2S1-04-12,3,5369800
M2S1-04-13,3,5367123
M2S1-04-14,4,5406438
M2S1-04-14,3,5369884
M2S1-05-02,3,5393695
M2S1-05-02,3,5370678
M2S1-05-05,4,5371087
M2S1-05-05,5,5371112
M2S1-05-06,3,5370656
M2S1-05-06,3,5370043
M2S1-05-06,3,5408510
M2S1-05-06,3,5371059
M2S1-05-07,3,5371001
M2S1-05-09,3,5369081
M2S1-05-10,4,5369358
M2S1-05-10,4,5409939
M2S1-05-13,3,5370270
M2S1-06-04,2,5368243
M2S1-06-05,3,5409914
M2S1-06-05,3,5368546
M2S1-06-05,3,5408645
M2S1-06-07,3,5408725
M2S1-06-11,3,5372163
M2S1-06-12,3,5406434
M2S1-06-14,4,5369718
M2S1-03-13,3,5593779
M2S1-06-14,4,5371479
M2S1-06-14,4,5368240
M2S1-06-15,4,5371210
M2S1-06-15,3,5409872
M2S1-06-16,2,5370869
M2S1-06-16,3,5370870
M2S1-06-16,3,5369163
M2S1-06-16,5,5371638
M2S1-07-01,2,5369399
M2S1-07-04,3,5367854
M2S1-07-04,3,5372798
M2S1-07-05,3,5370359
M2S1-07-05,3,5369882
M2S1-07-05,3,5369802
M2S1-07-07,3,5369632
M2S1-07-08,3,5370603
M2S1-07-08,4,5368458
M2S1-07-08,3,5371209
M2S1-07-09,3,5370204
M2S1-07-09,3,5370638
M2S1-07-09,3,5367506
M2S1-07-09,3,5371211
M2S1-07-09,3,5372192
M2S1-07-09,3,5372509
M2S1-07-11,3,5368065
M2S1-07-11,4,5371380
M2S1-07-12,3,5372928
M2S1-07-12,3,5408668
M2S1-07-12,3,5409916
M2S1-07-12,3,5370093
M2S1-07-12,3,5409917
M2S1-07-12,4,5408621
M2S1-07-12,4,5409918
M2S1-07-12,3,5409965
M2S1-07-13,3,5372326
M2S1-07-16,5,5369862
M2S1-07-17,3,5370016
M2S1-07-17,3,5372653
M2S1-07-17,3,5367502
M2S1-07-18,4,5371639
M2S1-07-18,3,5372510
M2S1-07-20,4,5371292
M2S1-07-21,4,5371230
M2S1-07-21,3,5367253
M2S1-08-06,2,5371063
M2S1-08-07,2,5409888
M2S1-08-08,2,5370361
M2S1-08-10,2,5371064
M2S1-08-11,4,5370471
M2S1-08-13,3,5371140
M2S1-08-13,3,5372402
M2S1-09-05,2,5368096
M2S1-09-06,2,5371570
M2S1-09-06,3,5372705
M2S1-09-06,4,5370360
M2S1-09-06,3,5367384
M2S1-09-07,2,5372622
M2S1-09-07,3,5371877
H1S1-08-01,4,4986362
HSU1-04-13,3,5847599
H1S1-03-02,4,4981893
M2S1-09-07,2,5371376
M2S1-09-08,3,5367413
M2S1-09-09,3,5393275
M2S1-09-10,2,5370812
M2S1-09-10,3,5369041
M2S1-09-10,3,5370813
M2S1-09-10,3,5369133
M2S1-09-10,2,5369132
M2S1-09-11,2,5370723
M2S1-09-11,2,5367707
M2S1-09-11,2,5370418
M2S1-09-11,3,5370957
M2S1-09-11,2,5367709
M2S1-09-11,2,5370956
M2S1-09-11,3,5370419
M2S1-09-12,4,5369082
M2S1-09-13,3,5370893
M2S1-09-13,3,5372551
M2S1-09-13,3,5370894
M2S1-09-13,2,5372552
M2S1-09-14,3,5372753
M2S1-09-14,3,5367290
M2S1-09-16,2,5372818
M2S1-10-01,3,5370054
M2S1-10-01,2,5372749
M2S1-10-03,2,5370891
M2S1-10-03,3,5409940
M2S1-07-10,3,5740755
M2S1-10-07,2,5409894
M2S1-10-08,3,5409895
M2S1-10-09,3,5369359
M2S1-10-11,3,5371235
M2S1-10-12,5,5371355
M2S1-10-13,4,5370152
M2S1-10-14,4,5369190
M2S1-10-14,4,5371006
HSU1-01-02,3,5570217
M2S1-10-15,4,5367920
HSTA-03-04,2,6106317
HSTA-03-04,3,6106318
HSTA-05-08,3,6106320
HSTA-06-10,3,6106322
HSTA-06-14,3,6106324
HSTA-07-07,3,6106327
M2S1-04-07,2,6106330
M2S1-04-07,3,6106331
M2S1-04-13,3,6106335
M2S1-05-08,2,6106339
M2S1-05-08,3,6106342
M2S1-05-08,3,6106343
M2S1-05-09,3,6106346
M2S1-05-09,3,6106347
M2S1-05-09,3,6106348
M2S1-05-09,3,6106349
M2S1-05-09,3,6106351
M2S1-05-09,3,6106352
M2S1-05-09,3,6106353
M2S1-06-01,3,6106354
M2S1-06-06,3,6106355
M2S1-06-06,2,6106356
M2S1-06-06,2,6106357
M2S1-06-06,2,6106358
M2S1-06-08,3,6106359
M2S1-06-08,3,6106360
M2S1-06-08,3,6106361
M2S1-06-08,3,6106362
M2S1-06-08,3,6106363
M2S1-01-07,2,6106364
M2S1-01-11,2,6106366
M2S1-01-14,2,6106367
M2S1-01-14,3,6106368
M2S1-01-14,3,6106369
M2S1-01-14,3,6106370
M2S1-01-14,2,6106372
M2S1-01-14,3,6106373
M2S1-02-02,3,6106374
M2S1-02-10,3,6106375
M2S1-02-10,3,6106376
M2S1-04-02,2,6106377
M2S1-04-02,3,6106378
M2S1-09-08,2,6106379
M2S1-09-08,3,6106380
M2S1-10-02,2,6106381
M2S1-10-09,3,6106382
M2S1-10-09,3,6106383
M2S1-10-09,3,6106384
HSU1-07-12,3,5843209
M2S1-10-09,3,6106386
M2S1-07-14,3,6106387
M2S1-07-21,5,6106388
M2S1-09-04,2,6106389
M2S1-09-03,3,5741102
HSU1-07-06,1,5843193
HSU1-05-08,2,5160185
M1S1-06-07,2,5587167
M1S1-07-09,3,5532002
HSTA-06-11,3,5827821
M1S1-08-07,5,6037771
M1S1-05-07,1,6106448
HSTA-07-08,2,5176101
HSTA-04-06,3,5166431
HSU1-11-05,4,4770382
HCAL-02-16,4,4770383
HSU2-02-01,5,4770384
HSU1-02-01,2,4770385
H1S2-06-07,2,4770386
HCAL-01-07,3,4770387
HSU2-07-06,3,4770388
HSU2-03-12,4,4770389
HSU1-10-02,4,4770390
HSU2-01-16,4,4770391
HSU2-01-13,4,4770395
M2S1-09-04,3,6106390
M2S1-09-04,3,6106391
M2S1-09-04,3,6106392
M2S1-09-08,2,6106393
M2S1-09-09,2,6106394
M2S1-09-09,3,6106395
M2S1-09-09,3,6106396
M2S1-09-09,2,6106397
M2S1-09-11,2,6106399
M2S1-09-11,3,6106400
M2S1-09-11,5,6106402
M2S1-06-12,2,6106404
M2S1-06-12,3,6106405
M2S1-06-12,3,6106406
M2S1-06-12,3,6106407
M2S1-06-12,2,6106408
M2S1-07-13,3,6106409
M2S1-08-01,3,6106411
M2S1-08-01,3,6106412
M2S1-08-01,3,6106413
M2S1-08-02,2,6106414
M2S1-08-02,3,6106415
M2S1-08-02,2,6106416
M2S1-08-02,3,6106417
M2S1-08-02,3,6106418
M2S1-08-10,2,6106419
M2S1-08-10,2,6106420
M2S1-08-10,3,6106422
M2S1-08-10,2,6106423
M2S1-08-10,3,6106424
M2S1-08-10,2,6106426
M2S1-08-12,3,6106427
M2S1-09-01,3,6106428
M2S1-09-04,3,6106429
M2S1-09-04,3,6106431
M2S1-09-05,2,6106432
M2S1-09-05,2,6106433
M2S1-09-05,3,6106434
M2S1-09-05,3,6106435
M2S1-09-05,3,6106436
HSU1-01-08,3,6106437
HSU1-01-08,3,6106438
HSU1-01-08,3,6106439
HSU1-01-08,3,6106440
HSU1-01-08,3,6106441
HSU1-01-08,3,6106442
M1S1-05-12,1,6106444
M1S1-05-03,3,5411260
M1S1-03-08,2,5416136
M1S1-05-12,2,6106447
EXEP-01-01,3,5415991
M1S1-06-02,1,6106449
M1S1-05-12,1,6106450
M1S1-05-01,1,6106452
M1S1-05-12,2,6106453
M1S1-05-01,2,6106455
M1S1-04-21,3,6106456
HSU1-04-21,4,5162057
M3S1-05-02,4,4982761
M1S1-04-11,3,6106461
M1S1-04-11,3,6106462
M1S1-04-10,1,6106463
M1S1-04-10,1,6106464
M3S1-10-09,3,4976462
M1S1-03-05,1,6106467
M1S1-03-05,1,6106468
M1S1-03-05,1,6106475
M2S1-05-13,3,3305307
H1S1-12-03,2,6106482
H1S1-12-12,3,6106484
HSU1-07-10,3,5843220
HSU1-08-01,4,6064695
M2S1-08-04,3,5741040
M1S1-05-19,5,6065745
M1S1-05-19,4,6065720
M1S1-06-17,3,6065746
M1S1-06-17,3,6065747
M1S1-06-17,3,6065748
M1S1-06-17,3,6065750
M1S1-06-17,3,6065751
M1S1-06-17,4,6065752
M1S1-07-07,3,6065753
M1S1-07-07,3,6065754
M1S1-07-07,3,6065756
M1S1-07-07,3,6065759
M2S1-07-10,2,6038123
M2S1-07-14,5,6038125
M2S1-07-14,3,6038126
M2S1-07-14,2,6038127
M2S1-07-14,3,6038128
M2S1-07-14,3,6038129
M2S1-07-14,4,6038130
M2S1-07-14,2,6038131
M2S1-07-14,3,6038132
HSTA-02-08,2,6065488
HSTA-02-08,3,6065490
HSTA-03-01,2,6065512
HSTA-03-01,3,6065514
HSTA-03-01,2,6065516
HSTA-03-01,2,6065517
HSTA-07-06,3,6065518
HSTA-07-06,3,6065522
HSTA-07-09,3,6065524
HSTA-07-09,3,6065526
HSTA-07-09,3,6065528
HSTA-07-09,3,6065532
HSTA-07-09,3,6065533
HSTA-07-09,3,6065534
HSTA-07-12,3,6065535
HSTA-07-12,3,6065536
HSTA-07-12,3,6065537
HSTA-07-12,3,6065546
HSTA-07-13,3,6065552
HSTA-07-14,3,6065553
HSTA-07-14,3,6065554
H1S1-10-03,1,5998112
H1S1-10-03,2,5998113
HSTA-01-03,4,5183038
HSTA-02-02,3,5166049
HSTA-02-03,4,5183044
HSTA-02-04,3,5183781
HSTA-01-06,3,5183779
HSTA-04-03,3,5188174
HSTA-05-03,3,5188602
HSTA-05-10,3,5167264
HSTA-06-10,3,5162629
HSTA-06-09,3,5162625
HSTA-06-13,4,5187114
HSTA-01-05,4,5174759
HSTA-02-04,4,5183041
HSTA-01-06,4,5183040
HSTA-01-06,3,5187054
HSTA-04-05,3,5188529
HSTA-06-01,3,5176989
HSTA-03-04,3,5175645
HSTA-05-09,3,5166441
HSTA-05-06,3,5188428
HSTA-05-06,3,5187019
EXEP-01-01,2,5367852
HSU1-05-11,2,5162712
M1S1-05-18,3,5532053
HSTA-01-02,3,5829687
HSTA-07-07,3,5582001
HSTA-04-06,3,5184489
HCAL-01-17,5,4770396
HSU1-05-08,2,4770312
HCAL-03-09,2,4770313
HCAL-03-04,2,4770314
HSU2-01-02,3,4770315
HSU2-04-01,3,4770316
HCAL-01-14,3,4770317
HSU2-08-01,3,4770318
HSU1-06-07,3,4770319
HSU1-04-15,3,4770323
HSU2-07-02,3,4770324
HSU2-03-08,3,4770325
HCAL-10-02,3,4770326
HCAL-02-10,3,4770327
HCAL-10-13,4,4770328
HSU1-04-03,4,4770329
HSU1-06-19,4,4770330
HSU2-08-07,4,4770331
HSU2-01-16,4,4770332
HSU2-05-17,4,4770333
HCAL-04-13,4,4770334
HCAL-09-10,5,4770335
HSU2-07-01,2,4770336
HSU1-03-07,2,4770337
HCAL-02-04,3,4770338
HCAL-04-15,3,4770339
HSU2-03-04,4,4770340
HCAL-01-04,4,4770341
HSTA-05-10,3,5167318
M1S1-02-09,4,5415855
HSTA-05-12,4,5176205
HSTA-06-11,3,5167768
HSTA-06-11,3,5188429
HSTA-06-11,3,5182938
HSTA-06-13,3,5177763
HSTA-06-13,4,5174866
HSTA-06-13,3,5178477
HSTA-07-04,3,5178417
HSTA-01-06,5,5186975
HSTA-02-05,4,5166557
HSTA-02-07,3,5188674
HSTA-03-07,4,5186837
HSTA-03-11,3,5184490
HSTA-04-05,3,5175470
HSTA-05-04,3,5188062
HSTA-05-04,3,5172860
HSTA-05-06,3,5188357
HSTA-06-11,3,5174985
HSTA-07-08,3,5184829
HSTA-01-02,3,5188130
HSTA-02-07,3,5188577
HSTA-03-15,5,5186869
HSTA-04-06,5,5184827
HSTA-05-08,3,5175758
HSTA-06-03,3,5160020
HSTA-06-06,3,5187109
HSTA-06-10,3,5178109
HSTA-07-07,3,5185789
HSTA-02-09,3,5183111
HSTA-04-08,3,5174858
HSTA-04-09,3,5187112
HSTA-06-06,3,5175256
HSTA-07-02,3,5187165
HSTA-07-03,3,5178023
HSTA-06-06,3,5165819
HSTA-06-05,3,5178475
HSTA-06-09,3,5161391
HSTA-01-06,4,5173353
HSTA-01-08,3,5188708
HSTA-01-11,4,5172805
HSTA-03-07,4,5172763
HSTA-03-09,3,5177702
HSTA-03-11,5,5175422
HSTA-03-14,3,5172271
HSTA-04-06,5,5178533
HSTA-04-08,3,5174981
HSTA-04-09,3,5188426
HSTA-04-10,3,5178765
HSTA-05-04,3,5177760
HSU1-11-09,2,5306434
HSU1-11-11,3,5306463
M1S1-07-04,3,5412748
HSU1-08-03,2,5308506
HSU1-08-12,3,5308508
M1S1-07-21,3,5413986
M1S1-02-05,3,5415639
M3S1-04-09,2,4980277
HSU1-11-08,2,5307849
HSU1-05-07,4,5164441
HSU1-03-10,4,5163050
HSU1-05-11,4,5159415
HSU1-06-25,3,5161393
HSU1-05-13,4,5159896
HSU1-03-10,4,5161347
HSU1-11-04,3,5305355
HSU1-06-18,4,5163188
HSU1-06-16,3,5163827
HSU1-06-24,3,5164438
HSU1-06-25,4,5159418
HSU1-02-11,4,5310018
HSU1-02-06,4,5307990
HSU1-06-19,3,5163546
HSU1-03-08,3,5161616
HSU1-06-25,3,5164330
HSU1-06-25,3,5162814
HSU1-03-07,2,5160815
HSU1-04-09,4,5159634
HSU1-04-08,4,5159787
HSU1-04-20,4,5163542
HSU1-01-12,3,5307249
HSU1-04-11,3,5160376
HSU1-03-09,3,5160817
HSU1-06-25,3,5163228
HSU1-03-17,3,5163824
HSU1-03-18,4,5163184
HSU1-03-15,4,5159830
HSU1-06-25,3,5160977
HSU1-04-06,4,5159435
HSU1-01-09,3,5306533
HSU1-05-05,4,5159894
HSU1-05-04,3,5161626
HSU1-04-15,1,5163136
HSU1-03-12,3,5160681
HSU1-05-07,4,5160607
HSU1-08-08,4,5307663
HSU1-08-03,3,5309544
HSU1-08-08,3,5307947
HSU1-04-15,3,5160821
HSU1-03-04,4,5159150
HSU1-02-03,3,5306231
HSU1-04-15,4,5160098
HSU1-02-17,3,5308666
HSU1-02-13,3,5305299
HSU1-01-12,3,5307182
HSU1-02-18,3,5305500
HSU1-05-06,3,5164224
HSU1-11-03,3,5309399
HSU1-09-08,3,5304313
HSU1-11-09,3,5309944
HSU1-05-13,3,5162078
HSU1-08-05,3,5304337
HSU1-06-03,4,5159723
HSU1-03-08,2,5163849
HSU1-11-11,4,5307853
HSU1-02-18,3,5309064
HSU1-03-03,4,5163566
HSU1-09-09,3,5308951
HSU1-06-25,4,5164356
HSU1-03-21,3,5163543
HSU1-09-09,3,5309710
HSU1-02-13,3,5310039
HSU1-09-12,2,5306333
HSU1-01-13,3,5308794
HSU1-02-11,3,5306435
HSU1-10-05,4,5307993
HSU1-02-11,4,5304615
HSU1-10-11,4,5304795
HSU1-02-17,3,5308543
HSU1-11-09,3,5309779
HSU1-11-07,3,5308877
HSU1-02-18,3,5304826
HSU1-09-04,4,5307633
HSU1-09-05,4,5306104
H1S1-10-02,3,4983989
H1S1-12-03,2,4980031
H1S1-11-18,3,4984275
H1S1-09-05,3,4985961
HSU1-01-13,3,5306028
HSU1-08-13,3,5307815
EXEP-01-01,0,4987330
H1S1-08-20,3,5560567
H1S1-08-20,3,5560566
H1S1-08-12,3,5560440
H1S1-08-11,3,5847283
H1S1-08-11,3,5847295
H1S1-08-20,3,5560690
H1S1-08-03,3,5560691
H1S1-08-01,2,5560467
H1S1-07-19,4,5560138
H1S1-07-19,3,5560137
H1S1-07-19,3,5560314
H1S1-07-19,4,5560316
H1S1-07-14,3,5560372
H1S1-07-14,3,5560130
H1S1-07-13,3,5560289
H1S1-07-04,3,5559854
H1S1-07-03,3,5559819
H1S1-07-03,3,5559818
H1S1-07-02,3,5559820
H1S1-05-10,3,5559467
H1S1-05-03,2,5559222
H1S1-05-02,3,5559082
H1S1-05-02,3,5559083
M2S1-03-13,3,5594036
H1S1-05-01,1,5559076
H1S1-05-01,1,5558953
H1S1-05-01,1,5558951
H1S1-05-01,1,5559130
H1S1-05-01,1,5559077
H1S1-05-01,1,5559078
H1S1-05-01,1,5559131
H1S1-05-01,1,5558964
M2S1-07-07,3,5740721
H1S1-04-03,2,5554251
H1S1-04-02,1,5592221
H1S1-04-01,1,5592182
H1S1-03-05,2,5557949
H1S1-03-05,2,5557994
H1S1-03-03,2,5557992
H1S1-03-01,2,5557647
H1S1-03-01,1,5557644
H1S1-03-01,1,5557643
H1S1-02-14,1,5556620
H1S1-01-03,2,5554370
H1S1-01-03,2,5554369
H1S1-07-13,3,5560287
H1S1-07-18,3,5560379
H1S1-04-01,1,5554248
H1S1-07-18,3,5560095
H1S1-07-02,3,5559910
H1S1-08-16,3,5560503
H1S1-05-12,3,5616301
H1S1-03-07,4,5616136
H1S1-07-18,3,5560136
H1S1-07-03,3,5559738
H1S1-10-16,3,5846353
H1S1-03-08,4,5594216
H1S1-06-08,3,5834275
H1S1-03-05,3,5616135
H1S1-07-02,3,5559858
H1S1-10-15,3,5846328
H1S1-08-23,3,5606296
HSU1-07-09,3,5843244
HSU1-01-01,3,5306097
HSU1-01-01,2,5306239
HSU1-01-05,2,5306237
HSU1-01-05,2,5305277
HSU1-01-05,2,5304936
HSU1-01-06,4,5304842
HSU1-01-06,3,5306096
HSU1-01-08,4,5306263
HSU1-01-09,4,5306612
HSU1-01-09,5,5306247
HSU1-01-11,3,5305494
HSU1-01-13,4,5306559
HSU1-01-13,4,5304938
HSU1-01-13,5,5306098
HSU1-01-14,3,5306615
HSU1-01-14,2,5304939
HSU1-02-02,3,5304847
HSU1-02-03,2,5306238
HSU1-02-03,3,5304942
HSU1-02-04,3,5305283
HSU1-02-06,3,5306271
HSU1-02-07,3,5305484
HSU1-02-08,3,5304941
HSU1-02-08,3,5305488
HSU1-02-10,3,5306242
HSU1-02-11,4,5304850
HSU1-02-11,3,5306260
HSU1-02-12,2,5306618
HSU1-02-12,4,5304944
HSU1-02-13,5,5305296
HSU1-02-14,3,5305292
HSU1-02-14,3,5306551
HSU1-02-17,3,5306267
HSU1-08-03,2,5308607
HSU1-08-03,3,5307559
HSU1-08-03,3,5306537
HSU1-08-03,2,5307669
HSU1-08-04,2,5307611
HSU1-08-07,2,5308137
HSU1-08-09,4,5308150
HSU1-08-09,4,5307569
HSU1-08-09,4,5308629
HSU1-08-10,3,5306087
HSU1-08-10,2,5308149
HSU1-08-12,3,5307627
HSU1-08-15,3,5307693
HSU1-09-02,3,5307690
HSU1-09-04,4,5308628
HSU1-09-04,3,5306554
HSU1-09-04,2,5305281
HSU1-09-04,3,5306610
HSU1-09-04,3,5308138
HSU1-09-08,2,5308615
HSU1-09-08,3,5306540
HSU1-09-08,3,5307623
HSU1-09-09,3,5305289
HSU1-09-09,3,5305481
HSU1-09-12,3,5305290
HSU1-09-12,3,5306246
HSU1-09-12,4,5307707
HSU1-09-12,3,5306086
HSU1-09-12,4,5306272
HSU1-10-04,2,5306607
HSU1-10-04,2,5304928
HSU1-10-07,3,5305483
HSU1-10-08,4,5306553
HSU1-10-08,3,5306285
HSU1-10-08,3,5306259
HSU1-10-09,3,5304836
HSU1-10-09,3,5306538
HSU1-10-10,4,5304943
HSU1-10-11,2,5306541
HSU1-10-12,3,5305284
HSU1-10-14,3,5305291
HSU1-10-15,3,5306278
HSU1-11-01,2,5307558
HSU1-11-02,3,5304835
HSU1-11-03,3,5306268
HSU1-11-05,3,5306274
HSU1-11-05,3,5306543
HSU1-11-05,3,5306611
HSU1-11-06,3,5306240
HSU1-11-11,3,5306276
HSU1-11-11,4,5306249
HSU1-03-03,3,5162678
HSU1-03-03,3,5163482
HSU1-03-04,4,5162541
HSU1-03-04,2,5164388
HSU1-03-06,4,5164342
HSU1-03-11,1,5160381
HSU1-03-11,2,5161845
HSU1-03-11,1,5162907
HSU1-03-11,3,5164389
HSU1-03-12,2,5159222
HSU1-03-12,3,5162540
HSU1-03-15,4,5159712
HSU1-03-15,3,5161480
HSU1-03-15,4,5161472
HSU1-03-16,3,5161476
HSU1-03-17,4,5162685
HSU1-04-01,1,5162927
M2S1-03-08,3,5740482
M2S1-07-20,4,3295523
HSU1-07-10,3,5843221
HSU1-04-06,5,5162045
HSU1-04-06,5,5162910
HSU1-04-07,3,5163432
HSU1-04-07,4,5163490
HSU1-04-15,2,5160382
HSU1-04-15,3,5160720
HSU1-04-15,2,5161852
HSU1-04-16,3,5161474
HSU1-04-21,3,5159226
HSU1-04-21,3,5161860
HSU1-04-21,3,5161998
HSU1-04-21,4,5162031
HSU1-04-21,3,5162931
HSU1-05-03,2,5160639
HSU1-05-05,3,5163441
HSU1-05-05,3,5163932
HSU1-05-06,2,5160389
HSU1-05-06,2,5160712
HSU1-05-06,2,5161847
HSU1-05-06,1,5162915
HSU1-05-06,2,5163433
HSU1-05-06,2,5164336
HSU1-05-11,2,5161995
HSU1-05-11,3,5162681
HSU1-05-11,4,5162916
HSU1-05-11,2,5163915
HSU1-05-12,3,5161996
HSU1-05-12,4,5162004
HSU1-06-01,3,5162548
HSU1-06-07,3,5162940
HSU1-06-10,3,5159239
HSU1-06-10,3,5160646
HSU1-06-10,2,5161469
HSU1-06-11,4,5162037
HSU1-06-13,5,5161015
HSU1-06-18,2,5163444
HSU1-06-21,4,5162920
HSU1-06-23,3,5159243
HSU1-06-23,3,5160722
HSU1-06-23,2,5162938
HSU1-06-23,3,5164398
HSU1-06-24,3,5160390
HSU1-06-24,4,5162943
H1S1-10-06,3,5626627
H1S1-05-02,3,5559224
H1S1-05-04,3,5604814
H1S1-01-01,2,4978751
H1S1-01-01,3,4979017
H1S1-01-01,1,4979009
H1S1-01-01,1,4979052
H1S1-01-01,2,4984013
H1S1-01-01,2,4984037
H1S1-01-02,3,4978755
H1S1-01-02,3,4984038
H1S1-01-02,3,4987192
H1S1-01-04,3,4978753
H1S1-01-04,3,4979026
H1S1-01-04,3,4979053
H1S1-01-04,4,4979651
H1S1-01-06,4,4980445
H1S1-01-07,4,4978760
H1S1-01-07,4,4987198
H1S1-01-08,3,4984040
H1S1-01-08,3,4987195
H1S1-02-01,1,4979054
H1S1-02-01,1,4979638
H1S1-02-02,2,4981863
H1S1-02-02,3,4987222
H1S1-02-03,3,4979642
H1S1-02-03,3,4980443
H1S1-02-05,4,4988498
H1S1-02-06,4,4984438
H1S1-02-11,2,4985033
H1S1-02-12,2,4981928
H1S1-02-13,3,4979015
H1S1-02-13,4,4980057
H1S1-02-14,4,4981866
H1S1-03-01,3,4979639
H1S1-03-01,2,4980059
H1S1-03-01,3,4983871
H1S1-03-01,3,4986065
H1S1-03-02,4,4979643
H1S1-03-02,3,4985026
H1S1-03-04,3,4983870
H1S1-03-04,3,4984039
H1S1-03-05,4,4981867
H1S1-03-06,2,4979014
H1S1-03-06,2,4979057
H1S1-03-06,2,4984026
H1S1-03-06,2,4984022
H1S1-03-06,2,4984448
H1S1-03-06,2,4987525
H1S1-03-09,3,4987470
H1S1-03-10,4,4979056
H1S1-04-01,1,4984021
H1S1-04-02,2,4979061
H1S1-04-02,2,4983873
H1S1-04-02,2,4984023
H1S1-04-02,1,4987190
H1S1-04-04,3,4981871
H1S1-04-04,4,4981935
H1S1-04-05,2,4980060
H1S1-04-05,2,4985022
H1S1-04-06,3,4980448
H1S1-04-07,3,4979020
H1S1-04-08,5,4978766
H1S1-04-08,4,4979647
H1S1-04-08,4,4981869
H1S1-04-09,3,4978752
H1S1-04-09,1,4979060
H1S1-04-09,2,4986069
H1S1-05-05,2,4981860
H1S1-05-05,2,4981929
H1S1-05-05,2,4983874
H1S1-05-05,4,4984043
H1S1-05-05,3,4984440
H1S1-05-05,2,4986070
H1S1-05-08,3,4978756
H1S1-05-08,3,4980441
H1S1-05-08,3,4983875
H1S1-05-08,3,4984027
H1S1-05-08,3,4984441
H1S1-05-10,2,4979012
H1S1-05-10,4,4981872
H1S1-05-10,3,4984044
H1S1-05-12,2,4984015
H1S1-05-13,3,4979019
H1S1-05-13,2,4979063
H1S1-05-13,4,4980063
H1S1-06-01,3,4978764
H1S1-06-01,4,4981938
H1S1-06-01,3,4983881
H1S1-06-02,3,4978758
H1S1-06-02,3,4979018
H1S1-06-02,3,4981861
H1S1-06-04,4,4979065
H1S1-06-05,4,4981874
H1S1-06-06,5,4979021
H1S1-06-06,3,4979066
H1S1-06-06,3,4979645
H1S1-06-06,4,4981943
H1S1-06-06,3,4983878
H1S1-06-09,3,4980447
H1S1-06-10,4,4979022
H1S1-06-10,4,4979067
H1S1-07-01,3,4988510
H1S1-07-03,4,4978763
H1S1-07-03,3,4979470
H1S1-07-05,3,4979646
H1S1-07-05,3,4987206
H1S1-07-06,4,4980451
H1S1-07-06,3,4981877
H1S1-07-06,3,4981941
H1S1-07-06,3,4984028
H1S1-07-09,3,4983880
H1S1-07-09,3,4987226
H1S1-07-10,4,4981934
H1S1-07-10,4,4984047
H1S1-07-10,3,4987205
H1S1-07-10,4,4987228
H1S1-07-17,4,4981878
H1S1-07-17,3,4981940
H1S1-08-01,2,4985721
H1S1-08-08,2,4984240
H1S1-08-08,3,4984268
H1S1-08-08,2,4984759
H1S1-08-11,3,4981529
H1S1-08-12,2,4985796
H1S1-08-14,3,4985037
H1S1-08-18,4,4985051
H1S1-08-20,4,4979473
H1S1-08-22,4,4984761
H1S1-08-22,4,4984926
H1S1-08-22,4,4985420
H1S1-08-24,3,4983877
H1S1-09-01,2,4982079
H1S1-09-02,3,4978805
H1S1-09-02,2,4984235
H1S1-09-02,2,4984310
H1S1-09-02,2,4984918
H1S1-09-05,4,4979483
H1S1-09-07,2,4984763
H1S1-09-07,2,4984922
H1S1-09-07,3,4985039
H1S1-09-08,3,4984312
H1S1-09-08,3,4984764
H1S1-09-09,1,4984237
H1S1-09-09,1,4984257
H1S1-09-09,3,4984311
H1S1-09-09,2,4984917
H1S1-10-01,2,4984259
H1S1-10-01,1,4984915
H1S1-10-02,3,4984245
H1S1-10-05,3,4984313
H1S1-10-07,3,4981533
H1S1-10-08,2,4978794
H1S1-10-08,2,4984236
H1S1-10-08,3,4984241
H1S1-10-08,3,4984270
H1S1-10-08,3,4984314
H1S1-10-10,3,4981536
H1S1-10-11,2,4984260
H1S1-10-12,3,4984242
H1S1-10-13,3,4984266
H1S1-11-01,1,4984912
H1S1-11-01,2,4985045
H1S1-11-11,3,4981535
H1S1-11-11,3,4982084
H1S1-11-11,3,4982082
H1S1-11-11,2,4985049
H1S1-11-13,3,4984265
H1S1-11-17,3,4984916
H1S1-11-17,3,4985952
H1S1-11-17,3,4986365
H1S1-11-18,4,4982088
H1S1-11-18,4,4984320
H1S1-11-18,4,4985729
H1S1-11-18,4,4985730
H1S1-11-18,4,4985811
H1S1-11-19,3,4985434
H1S1-11-19,3,4985804
H1S1-12-01,1,4984246
H1S1-12-01,1,4984321
H1S1-12-02,2,4978795
H1S1-12-02,2,4984771
H1S1-12-03,2,4984267
H1S1-12-04,3,4988840
H1S1-12-06,2,4984243
H1S1-12-08,4,4985807
H1S1-12-08,4,4985958
H1S1-12-08,3,4987783
H1S1-12-09,4,4987945
H1S1-12-10,3,4978803
H1S1-12-10,4,4984765
H1S1-12-11,4,4987944
H1S1-12-11,5,4988873
H1S1-12-12,4,4986361
H1S1-12-13,3,4981532
H1S1-10-03,3,5677188
HSTA-01-01,4,5167613
HSTA-01-01,3,5173024
HSTA-01-01,3,5175358
HSTA-01-03,2,5166539
HSTA-01-03,4,5171860
HSTA-01-03,4,5184748
HSTA-01-04,1,5167604
HSTA-01-05,2,5172260
HSTA-01-05,4,5175359
HSTA-01-08,4,5166552
HSTA-01-09,3,5173031
HSTA-01-10,3,5173029
HSTA-01-10,4,5184744
HSTA-01-11,4,5174739
HSTA-02-01,3,5171866
HSTA-02-02,3,5167608
HSTA-02-03,2,5172321
HSTA-02-04,3,5172330
HSTA-02-05,3,5167615
HSTA-02-05,3,5172261
HSTA-02-05,3,5172685
HSTA-02-07,3,5166541
HSTA-02-07,4,5167395
HSTA-02-09,3,5172334
HSTA-02-09,3,5172669
HSTA-03-02,2,5160561
HSTA-03-02,4,5171874
HSTA-03-07,2,5176933
HSTA-03-13,3,5160574
HSTA-03-13,2,5172665
HSTA-03-13,2,5173022
HSTA-03-13,2,5177030
HSTA-03-14,3,5167617
HSTA-03-14,3,5172340
HSTA-03-14,3,5172687
HSTA-03-14,2,5173028
HSTA-04-01,3,5167813
HSTA-04-01,3,5175735
HSTA-04-01,3,5175743
HSTA-04-01,3,5176750
HSTA-04-01,3,5178092
HSTA-04-02,3,5166544
HSTA-04-02,4,5172338
HSTA-04-02,4,5162002
HSTA-04-02,2,5167020
HSTA-04-02,3,5167029
HSTA-04-02,3,5167307
HSTA-04-02,3,5167310
HSTA-04-08,2,5161987
HSTA-04-10,2,5161992
HSTA-04-10,2,5175736
HSTA-04-11,3,5166545
HSTA-04-11,2,5166155
HSTA-05-04,2,5161994
HSTA-05-05,3,5167309
HSTA-05-06,2,5167025
HSTA-05-06,3,5167300
HSTA-05-06,2,5175738
HSTA-05-10,1,5166151
HSTA-05-10,2,5167024
HSTA-05-10,1,5167805
HSTA-06-01,2,5162008
HSTA-06-02,2,5167032
HSTA-06-02,2,5167303
HSTA-06-03,3,5162014
HSTA-06-04,2,5166157
HSTA-06-07,3,5166152
HSTA-06-07,4,5167316
HSTA-06-07,2,5176757
HSTA-06-08,4,5167314
HSTA-06-09,4,5178102
HSTA-06-10,4,5167036
HSTA-06-10,3,5167815
HSTA-06-11,3,5166171
HSTA-07-01,3,5166550
HSTA-07-01,2,5161997
HSTA-07-01,2,5166156
HSTA-07-04,3,5162005
HSTA-07-04,4,5166161
HSTA-07-04,3,5167313
HSTA-07-04,3,5187768
HSTA-07-05,2,5167811
HSTA-07-06,3,5166162
HSTA-07-06,3,5167312
HSTA-07-07,4,5162024
HSTA-07-07,4,5175755
HSTA-07-11,3,5166166
HSTA-07-12,3,5166553
H1S1-05-04,3,5559084
H1S1-06-05,3,5834274
H1S1-10-04,2,5677198
H1S1-07-19,3,5560096
H1S1-07-19,3,5560381
H1S1-07-06,3,5656932
H1S1-10-15,3,5846364
H1S1-09-04,3,5846293
H1S1-09-06,3,5657136
H1S1-10-03,3,5626625
H1S1-10-04,3,5846314
H1S1-10-14,3,5677217
H1S1-08-03,2,5608140
H1S1-08-21,3,5657042
H1S1-07-03,3,5656928
H1S1-02-04,3,5593662
H1S1-02-05,4,5593675
H1S1-02-11,2,5593720
H1S1-05-04,3,5604822
H1S1-04-07,3,5554264
H1S1-04-02,2,5614659
H1S1-07-06,3,5559909
H1S1-07-11,3,5604837
H1S1-08-09,3,5998294
H1S1-08-03,1,5608139
M1S1-02-06,4,5413854
M2S1-05-12,3,5534852
H1S1-10-16,3,5626634
H1S1-11-08,3,5626640
H1S1-11-09,3,5626641
H1S1-11-09,3,5834098
M2S1-03-12,4,5594032
M2S1-07-06,4,5740794
H1S1-11-16,3,6106481
H1S1-08-13,1,6106486
H1S1-08-25,3,5998102
H1S1-10-07,2,6106479
H1S1-11-07,3,6106480
H1S1-08-13,3,6106476
H1S1-08-13,1,6106485
H1S1-09-12,3,5998109
H1S1-05-11,3,5998211
H1S1-08-15,3,5998303
H1S1-11-08,3,5998127
H1S1-07-20,3,5998242
H1S1-07-20,3,5998239
H1S1-08-02,3,5998266
H1S1-08-02,3,5998267
H1S1-07-21,4,5998097
HSU1-09-06,3,5843763
HSU1-07-09,3,5843229
EXEP-01-01,4,4986541
EXEP-01-01,4,4986542
H1S1-08-18,3,5998312
HSU1-06-20,3,6065273
H1S1-10-15,3,5998114
EXEP-01-01,4,5162698
H1S1-06-04,3,5998160
HSU1-10-14,3,6038800
M3S1-12-02,3,5551207
M3S1-12-02,3,5551196
HSU1-05-11,2,5159238
M3S1-04-04,2,5583583
M2S1-08-09,2,5370759
M3S1-04-02,2,5531895
M2S1-05-06,4,5369405
M3S1-04-02,2,5531894
M3S1-04-02,2,5531899
M3S1-04-02,2,5531903
M3S1-04-02,2,5531905
H1S1-07-14,4,5560387
M3S1-04-02,2,5531897
M3S1-04-02,2,5531902
M3S1-04-04,2,5547790
M3S1-04-04,2,5547789
M3S1-04-04,2,5547794
M3S1-06-04,3,5548498
M3S1-06-04,3,5548525
M3S1-08-08,3,5549182
M3S1-08-08,3,5549183
M3S1-04-01,2,5531884
M3S1-04-01,2,5531880
M3S1-04-01,2,5531870
M3S1-09-10,3,5584405
M3S1-08-07,3,5559510
M3S1-12-09,3,5551416
M3S1-12-03,3,4977138
H1S1-12-11,3,5846737
H1S1-11-07,3,5846618
M3S1-05-03,3,5548558
M3S1-06-05,3,5548504
H1S1-08-06,4,5998186
M3S1-06-05,3,5548526
M3S1-06-06,3,5548589
M3S1-08-01,3,5549140
M3S1-04-08,3,5532028
M3S1-06-06,3,5548590
M3S1-06-05,3,5548502
M3S1-06-05,3,5559173
M3S1-06-05,3,5584068
M3S1-12-08,4,5559615
M3S1-08-07,3,5562286
M3S1-09-02,3,5549237
M3S1-08-11,3,5553523
M3S1-08-03,3,5559505
M3S1-04-06,3,5531928
M3S1-10-02,3,5562387
M3S1-12-06,3,5559614
M3S1-12-06,3,5551390
M3S1-08-03,3,5552127
M3S1-08-08,4,5549192
M3S1-09-02,3,5562191
M3S1-04-06,4,5583443
M3S1-05-03,3,5548449
M3S1-04-03,3,5562523
M3S1-04-04,3,5547816
HSU1-04-09,4,5573461
M3S1-04-06,3,5582865
M3S1-05-03,3,5548448
HSU1-02-04,3,5576019
M3S1-11-06,4,5551172
M1S1-03-09,5,6106465
M3S1-03-07,3,5582839
H1S1-02-05,3,5593672
HSU1-02-15,3,5847454
M3S1-02-04,3,5582383
M3S1-12-04,3,5559604
H1S1-04-08,4,5592379
H1S1-07-11,3,5657075
M3S1-12-04,3,5551234
M3S1-04-03,3,5553494
M3S1-04-08,3,5531993
M3S1-12-10,3,5562514
HSU1-05-02,2,5575828
M3S1-10-12,2,5584895
M3S1-08-06,3,5549219
M1S1-03-06,3,5413091
M3S1-04-03,3,5531978
H1S1-05-02,2,5559216
H1S1-05-04,3,5604820
H1S1-10-01,3,5677985
M3S1-05-01,3,5583755
M3S1-11-01,2,5562462
M3S1-03-05,3,5531962
M3S1-03-01,3,5531827
H1S1-08-22,3,5998334
M3S1-04-06,4,5583447
M3S1-04-06,3,5531930
M3S1-11-08,3,5551280
M3S1-02-04,3,5532054
M3S1-03-05,3,5531960
M3S1-02-04,3,5535245
M3S1-08-06,3,5549173
M3S1-08-07,3,5562322
M3S1-08-09,4,5562325
M3S1-05-04,3,5559120
M3S1-12-08,3,5551387
M3S1-01-04,3,5519656
M3S1-12-08,4,5551401
M3S1-09-10,3,5553292
M3S1-09-08,3,5549235
M3S1-09-08,3,5551902
M3S1-09-08,3,5549198
HSU1-02-12,2,5570362
M3S1-09-07,3,5559520
M3S1-09-10,3,5549199
M3S1-05-03,3,5583951
M2S1-07-06,3,5740720
M3S1-11-07,2,5832787
M3S1-11-07,2,5832789
M1S1-03-06,3,5393139
M3S1-07-03,1,3325920
M3S1-07-03,1,3325921
M3S1-03-04,2,3313517
M1S1-07-16,3,5415993
EXEP-01-01,,5414572
M3S1-04-11,5,4976145
HSU1-05-09,2,5160397
M3S1-06-06,3,3324983
M3S1-08-11,3,3327857
M3S1-09-02,4,5768595
M3S1-11-06,3,3359937
M3S1-08-06,3,5559509
M3S1-11-07,3,5834784
M3S1-09-08,4,3327891
M3S1-11-07,3,3359926
M3S1-01-07,5,6037889
M3S1-10-09,3,4976639
H1S1-12-09,1,5998138
M3S1-10-09,4,4977012
M3S1-05-07,4,6069547
M3S1-07-10,3,5768483
M3S1-08-06,3,5549174
M3S1-01-02,3,6037883
M3S1-08-04,4,6069534
M3S1-10-11,3,4976638
HSU1-04-19,2,5828630
H1S1-08-05,3,5998165
M3S1-10-11,3,4977332
M3S1-10-14,3,4977014
M3S1-11-01,4,4976640
M3S1-08-04,3,6069537
HSU1-04-19,3,6064400
M3S1-11-02,3,4976461
M2S1-02-05,3,5372826
M2S1-09-07,2,5372706
M3S1-09-01,4,4986771
M3S1-10-03,4,4976220
M3S1-11-02,4,4980533
HSU1-10-15,3,5843803
M2S1-01-15,3,5371963
H1S1-08-15,3,5847352
H1S1-08-04,3,5998281
H1S1-07-20,3,5998237
H1S1-05-11,5,5998212
H1S1-08-17,3,5998309
H1S1-08-07,3,5998197
H1S1-08-07,3,5998190
H1S1-07-20,4,5998236
H1S1-08-07,3,5998194
H1S1-11-11,2,5677942
H1S1-10-16,3,5846354
M3S1-04-06,5,5547906
M3S1-12-02,3,3359994
M3S1-07-12,2,6037911
M3S1-11-06,4,3360251
M3S1-01-02,3,6037884
M3S1-08-04,3,6069535
M3S1-01-07,3,5535282
M3S1-08-04,2,6069531
M3S1-02-02,3,3313561
M3S1-03-04,3,5768178
M3S1-01-07,4,6037887
H1S1-08-03,3,5998272
HSU1-10-05,3,5576483
HSTA-06-07,3,5581963
M2S1-06-08,3,5594831
M2S1-03-06,3,5534687
HSU1-07-01,3,5576079
HSU1-03-04,3,5577189
HSU1-04-05,5,5573470
HSU1-04-05,3,5573469
H1S1-12-10,3,4986535
H1S1-09-10,3,4988582
EXEP-01-01,3,4982051
H1S1-12-03,4,4984325
H1S1-10-06,3,5846315
H1S1-10-06,2,5677202
H1S1-02-12,3,5593734
EXEP-01-01,3,5998280
EXEP-01-01,4,5998304
EXEP-01-01,3,5998269
H1S1-06-04,2,5998156
H1S1-08-20,3,5560545
H1S1-03-07,3,5594164
H1S1-08-18,3,5998315
EXEP-01-01,3,6106478
H1S1-10-04,3,5626626
H1S1-03-05,3,5594172
EXEP-01-01,4,5998293
EXEP-01-01,2,3313512
EXEP-01-01,2,3313511
EXEP-01-01,3,4980318
H1S1-05-09,2,4984760
H1S1-12-06,4,4988193
H1S1-05-09,3,4984876
M3S1-05-06,4,4987729
M3S1-05-11,3,4985518
M3S1-05-11,3,4977584
M3S1-02-02,3,5519777
M3S1-02-08,5,4982470
M3S1-06-03,3,5559157
M3S1-10-07,3,6037941
M3S1-06-03,3,5768331
H1S1-01-03,3,4981930
H1S1-01-08,3,4988949
H1S1-02-04,4,4988497
H1S1-03-01,3,4981569
H1S1-03-04,4,4988347
H1S1-03-04,4,4978940
H1S1-03-08,4,4985876
H1S1-04-02,3,4984042
H1S1-04-04,3,4987044
H1S1-04-05,3,4984887
EXEP-01-01,2,3295700
M2S1-02-01,1,5592746
EXEP-01-01,2,3295706
M2S1-06-10,3,5534774
M2S1-02-12,3,5534598
M2S1-04-15,2,6038072
H1S1-10-15,3,5998119
M2S1-03-12,3,3295190
HSU1-02-15,3,5841628
M2S1-02-13,3,5534602
HSU1-04-03,3,5160998
HSU1-02-12,2,5570360
M2S1-08-05,3,6037710
M2S1-06-04,2,5594255
M2S1-10-03,3,5741193
M2S1-10-09,3,6106385
M2S1-07-15,3,5740779
HSU1-08-08,2,5842009
M2S1-05-12,3,6038099
HSU1-01-08,3,6064440
M2S1-02-06,3,6065698
EXEP-01-01,3,6037736
M2S1-05-13,3,6038102
HSU1-07-08,2,5843195
HSU1-05-02,2,5628643
HSU1-04-12,4,5573478
HSU1-02-03,1,5570283
M2S1-04-04,4,5368891
HSU1-07-12,3,5843211
HSU1-06-13,4,5843164
M2S1-03-03,3,5593291
HSU1-05-09,3,5843163
HSU1-08-07,4,5307829
HSU1-11-02,3,5309381
HSU1-01-07,3,5575973
HSU1-06-12,3,6043219
HSU1-02-04,3,5570309
HSU1-05-10,3,5628661
HSU1-04-01,3,5573432
EXEP-01-01,3,5849883
M1S1-07-02,3,5587223
HSU1-03-10,4,5827540
HSU1-07-17,3,5628762
HSU1-06-26,3,5576784
HSU1-07-12,2,5843219
HSU1-03-01,3,5828181
M1S1-04-02,2,5529904
HSU1-06-21,3,5628729
HSU1-04-14,3,5828686
HSU1-06-02,3,6065236
HSTA-01-04,3,5827622
HSU1-10-16,2,6038811
HSTA-06-02,3,5188495
HSU1-07-08,3,5843199
HSU1-02-01,2,5570275
HSU1-07-04,4,5576091
HSU1-07-04,3,5849860
M2S1-06-18,3,5372047
HSU1-04-16,3,5827566
HSU2-02-01,4,4770342
HSU1-06-22,4,5843167
HCAL-04-04,4,4770343
HSU1-07-11,3,5628767
HSU2-05-07,5,4770344
HSU1-03-17,3,5573411
HSU1-01-09,4,5843502
H1S1-01-01,2,4769038
H1S1-02-01,2,4769039
H1S1-04-05,2,4769040
HSU1-03-19,3,6043201
H1S2-04-10,3,4769041
H1S2-03-03,3,4769042
H1S1-06-06,3,4769043
H1S1-07-12,3,4769044
HSU1-04-16,3,6064386
H1S1-04-02,3,4769045
HSU1-05-03,3,5575821
H1S1-09-09,3,4769046
H1S1-01-03,3,4769047
HSU1-04-10,3,6064369
H1S1-02-11,3,4769052
HSU1-02-09,1,6038712
H1S2-03-16,3,4769053
H1S1-06-10,3,4769054
H1S1-08-08,4,4769055
H1S1-12-04,4,4769056
EXEP-01-01,3,6038677
H1S1-03-11,4,4769057
H1S1-10-08,4,4769058
H1S1-02-12,4,4769059
HSU1-04-18,3,6064397
H1S1-12-13,4,4769060
H1S2-02-01,4,4769061
HSU1-03-20,3,6064363
HSU1-04-17,4,6064393
H1S1-11-12,5,4769062
H1S2-02-02,2,4769063
EXEP-01-01,3,6064380
H1S2-04-03,2,4769064
HSU1-02-09,3,6038702
HSU1-02-07,3,6038698
HSU1-06-12,3,6043216
EXEP-01-01,1,5575816
EXEP-01-01,1,5575819
EXEP-01-01,1,5590392
EXEP-01-01,1,5590393
M2S1-02-02,1,5592748
M2S1-02-04,1,5592762
M2S1-02-12,1,5592829
HSU1-07-16,3,6038667
HSU1-11-06,3,6064829
HSU1-04-02,4,6064621
HSU1-09-07,3,6065364
HSU1-04-08,5,6064629
HSU1-06-20,2,6065266
HSU1-06-20,2,6065269
HSU1-08-11,3,6065328
HSU1-11-08,1,6038652
HSU1-06-02,3,6065238
EXEP-01-01,3,6043182
HSU1-06-08,3,6065250
HSU1-02-16,3,6043183
HSU1-03-15,3,6043195
M2S1-01-01,1,3209941
HSU1-02-09,1,6038700
HSU1-10-06,4,6064843
HSU1-04-08,3,6064630
M2S1-01-01,1,3209939
M2S1-01-01,1,3209943
M2S1-01-01,1,3209942
M2S1-02-03,1,5534546
HSU1-03-20,3,6064366
M2S1-02-12,2,5534557
M2S1-02-12,2,5592890
M2S1-02-12,2,5592872
M2S1-02-12,2,5592874
EXEP-01-01,3,6038679
M2S1-02-12,2,5592870
HSU1-06-09,3,6065260
HSU1-02-09,3,6038706
M2S1-02-13,2,5592879
M2S1-03-02,2,5534620
M2S1-03-02,2,5534619
M2S1-03-01,2,5534618
M2S1-03-01,2,5534617
M2S1-03-01,2,5593273
M2S1-03-01,2,5593277
M2S1-03-01,2,5593275
M2S1-03-01,2,5593285
M2S1-03-01,2,5593286
M2S1-03-01,2,5593288
HSU1-07-14,3,6038685
EXEP-01-01,2,5593290
M2S1-03-02,2,5593279
HSU1-06-12,4,6043223
M2S1-03-02,2,5593280
M2S1-03-06,2,5593329
HSU1-04-18,3,6064398
M2S1-03-06,2,5593321
M2S1-03-06,2,5593320
M2S1-03-06,2,5593319
M2S1-03-06,2,5534621
HSU1-06-13,2,6064671
M2S1-03-06,2,5534622
M2S1-03-07,2,5593336
HSU1-11-12,3,6064820
HSU1-06-11,2,6043213
M2S1-03-13,2,5593520
M2S1-03-13,2,5593519
M2S1-03-13,2,5534664
M2S1-03-13,2,5534663
M2S1-03-14,2,5593528
M2S1-03-15,3,5594049
EXEP-01-01,2,3295702
EXEP-01-01,2,3295708
HSU1-10-10,4,6064842
M1S1-02-09,4,5410749
M2S1-05-08,4,5596773
H1S1-07-11,3,4987464
M2S1-02-07,3,5740401
HSU1-11-04,3,5843023
HSU1-06-23,3,5628737
HSU1-06-20,3,6065270
M2S1-07-19,3,5740788
M1S1-03-10,3,5415857
M1S1-07-04,3,5410775
M1S1-06-07,2,5587168
M1S1-04-19,3,5529634
H1S1-08-06,4,5998187
M1S1-09-06,3,3172972
M2S1-07-10,3,5370249
H1S1-09-07,3,4769065
H1S2-03-07,3,4769066
H1S1-11-07,4,4769067
H1S1-07-01,4,4769068
H1S2-04-04,4,4769069
H1S1-06-04,4,4769071
H1S2-04-19,5,4769072
HSU1-01-05,2,4626391
HSU2-03-11,2,4626392
H1S2-02-01,2,4626393
HSU2-08-01,3,4626395
HSU1-08-15,3,4626396
HSU2-01-02,3,4626398
HSTA-05-03,3,4626399
HSU1-02-03,3,4626400
HSTA-06-09,3,4626401
HSTA-04-01,3,4626402
H1S2-06-07,3,4626403
HCAL-10-13,3,4626404
HSTA-04-11,3,4626405
H1S2-02-14,4,4626406
HSU2-02-01,4,4626407
HSTA-04-02,4,4626408
H1S2-03-16,4,4626409
HSTA-05-05,4,4626410
HCAL-02-16,4,4626411
HSU2-06-01,4,4626412
H1S2-05-19,5,4626413
HSTA-01-04,2,4626415
HSU1-09-04,2,4626414
HCAL-01-12,3,4626416
HSU2-08-10,3,4626418
HSTA-02-03,4,4626419
H1S2-07-17,4,4626421
H1S2-04-19,4,4626422
HSU2-09-04,4,4626423
HSU2-04-16,5,4626424
EXEP-01-01,2,4626021
HCAL-03-04,2,4626022
EXEP-01-01,2,4626023
HSTA-03-13,3,4626024
HSU2-04-01,3,4626025
HSTA-05-10,3,4626027
HCAL-04-03,3,4626028
H1S2-07-25,3,4626029
HCAL-09-08,3,4626030
EXEP-01-01,3,4626031
EXEP-01-01,3,4626032
HSU1-06-23,3,4626033
HSU2-08-13,3,4626034
EXEP-01-01,4,4626035
HSTA-04-02,4,4626037
HCAL-10-12,4,4626041
HCAL-04-13,4,4626042
HCAL-07-13,4,4626043
HSTA-02-03,4,4626044
EXEP-01-01,4,4626046
HCAL-05-12,5,4626047
H1S2-07-10,2,4626048
HCAL-05-04,2,4626049
HSU1-04-06,3,4626051
HCAL-05-09,3,4626052
HSTA-06-08,4,4626053
EXEP-01-01,4,4626054
HSTA-03-07,4,4626056
EXEP-01-01,4,4626057
HCAL-10-04,5,4626060
HSU1-01-05,2,4727633
HCAL-01-04,2,4727635
H1S2-04-10,3,4727636
HSU1-08-03,3,4727637
HSTA-02-05,3,4727638
HSU2-01-02,3,4727639
HSTA-03-13,3,4727640
HSU2-05-05,3,4727641
HSTA-06-02,3,4727642
H1S2-03-16,3,4727643
HSTA-07-07,3,4727644
HSU1-11-05,3,4727645
HSU2-08-10,4,4727648
HSU1-02-01,4,4727649
HCAL-02-16,4,4727650
HSU2-09-01,4,4727651
HSTA-04-02,4,4727652
H1S2-04-10,4,4727653
H1S2-05-22,4,4727654
HSU2-02-06,5,4727655
H1S2-07-15,2,4727656
HSU2-03-11,2,4727657
HSU1-09-08,3,4727658
HSU2-08-06,3,4727659
H1S2-06-07,4,4727660
HSU2-06-08,4,4727661
HSTA-03-11,4,4727662
HSU1-10-02,4,4727663
HSU2-06-05,5,4727666
EXEP-01-01,2,4727586
HCAL-03-04,2,4727587
H1S1-09-07,2,4727588
HSTA-03-13,3,4727589
HSU1-04-05,3,4727590
EXEP-01-01,3,4727592
HCAL-05-10,3,4727593
HSTA-05-10,3,4727594
HCAL-05-11,3,4727595
HSTA-03-02,3,4727596
HSU1-06-25,3,4727597
HSTA-02-02,3,4727598
EXEP-01-01,3,4727599
HSU1-03-16,4,4727600
HSTA-06-09,4,4727601
HCAL-09-01,4,4727602
H1S2-07-21,4,4727603
HCAL-04-13,4,4727604
EXEP-01-01,4,4727610
HCAL-06-04,4,4727611
HCAL-08-06,5,4727612
H1S2-07-15,2,4727613
HCAL-04-02,2,4727614
HCAL-07-13,3,4727615
HCAL-08-10,3,4727616
HSTA-07-07,4,4727617
HSTA-04-06,4,4727618
EXEP-01-01,4,4727619
EXEP-01-01,4,4727620
HCAL-06-10,5,4727623
M1S1-04-10,3,5413235
EXEP-01-01,3,5413274
M3S1-04-12,3,4982757
M3S1-11-02,3,4980655
M3S1-11-02,4,4980662
M3S1-11-02,4,4980663
M3S1-11-03,3,4977342
M3S1-11-03,3,4978514
M3S1-11-03,3,4982908
M3S1-11-05,3,4980654
M3S1-11-06,4,4978524
M3S1-11-07,3,4982422
M3S1-11-07,4,4982675
M3S1-11-08,4,4981229
M3S1-11-10,4,4976983
M3S1-11-10,4,4976989
M3S1-11-10,4,4976990
M3S1-11-10,4,4978515
M3S1-11-10,4,4980657
M3S1-11-10,4,4982682
M3S1-12-01,3,4980658
M3S1-12-01,3,4980774
M3S1-12-01,4,4984147
M3S1-12-01,3,4988305
M3S1-12-02,3,4982906
M3S1-12-02,3,4984148
M3S1-12-03,3,4977009
M3S1-12-03,4,4982423
M3S1-12-05,3,4976988
M3S1-12-05,4,4980656
M3S1-12-05,4,4980659
M3S1-12-05,4,4982425
M3S1-12-06,4,4976991
M3S1-12-06,3,4977338
M3S1-12-06,4,4983202
M3S1-12-06,3,4984132
M3S1-12-08,5,4978517
M3S1-12-09,4,4976650
HSU1-09-12,4,5308973
EXEP-01-01,2,5394331
EXEP-01-01,2,5394332
EXEP-01-01,2,5394333
EXEP-01-01,3,5394334
EXEP-01-01,3,5394335
EXEP-01-01,3,5394336
EXEP-01-01,3,5394337
EXEP-01-01,3,5394338
EXEP-01-01,3,5394339
EXEP-01-01,3,5394340
EXEP-01-01,3,5394341
EXEP-01-01,3,5394342
EXEP-01-01,3,5394344
EXEP-01-01,4,5394345
EXEP-01-01,4,5394346
EXEP-01-01,4,5394347
EXEP-01-01,4,5394350
EXEP-01-01,4,5394352
EXEP-01-01,4,5394363
EXEP-01-01,4,5394366
EXEP-01-01,5,5394368
EXEP-01-01,2,5394369
EXEP-01-01,2,5394370
EXEP-01-01,3,5394371
EXEP-01-01,3,5394372
EXEP-01-01,4,5394373
EXEP-01-01,4,5394374
EXEP-01-01,4,5394375
EXEP-01-01,4,5394377
EXEP-01-01,5,5394378
HSU1-01-05,2,5407606
H1S2-02-01,2,5407607
HCAL-01-04,2,5407608
HSU2-03-11,3,5407609
H1S2-04-16,3,5407610
HSU2-02-05,3,5407611
H1S2-03-07,3,5407612
HSU2-07-01,3,5407613
H1S2-03-22,3,5407615
HSU1-09-04,3,5407616
HSU2-01-02,3,5407617
HCAL-02-04,3,5407618
HSU1-01-03,3,5407619
HSU2-05-17,4,5407627
H1S2-01-10,4,5407628
HSU1-02-17,4,5407630
H1S2-05-15,4,5407631
HCAL-02-16,4,5407636
HSU1-11-11,4,5407638
HSU2-01-16,4,5407640
HSU2-02-02,5,5407644
HSU1-08-03,2,5407647
H1S2-04-10,2,5407649
HSU1-10-04,3,5407651
HSU1-02-04,3,5407653
HSU2-03-09,4,5407654
H1S2-06-15,4,5407655
HSU2-04-08,4,5407657
HCAL-01-18,4,5407658
HSU2-06-04,5,5407661
HSU1-05-08,2,5407576
HSU2-03-11,2,5407577
HCAL-03-04,2,5407578
HSU2-07-01,3,5407579
HSU2-03-04,3,5407580
HCAL-02-04,3,5407581
HSU1-04-15,3,5407582
HCAL-03-11,3,5407583
HCAL-01-12,3,5407584
HSU1-06-07,3,5407585
HSU2-08-04,3,5407586
HSU1-03-21,3,5407587
HSU2-01-07,3,5407588
HSU2-09-12,4,5407589
HCAL-04-15,4,5407590
HCAL-02-16,4,5407591
HCAL-04-04,4,5407592
HSU2-06-07,4,5407593
HCAL-01-18,4,5407594
HSU2-08-13,4,5407595
HSU2-02-06,5,5407596
HCAL-01-04,2,5407597
HSU2-02-05,2,5407598
HSU1-06-21,3,5407599
HSU2-08-10,3,5407600
HSU2-09-06,4,5407601
HSU2-01-13,4,5407602
HSU1-03-04,4,5407603
HCAL-04-13,4,5407604
HSU2-05-16,5,5407605
H1S2-02-01,2,5407363
H1S1-04-02,2,5407366
H1S2-06-10,3,5407367
H1S1-08-10,3,5407369
H1S1-04-02,3,5407370
HSU1-08-09,3,5407371
H1S2-05-15,3,5407372
H1S2-06-03,3,5407374
H1S1-07-02,3,5407375
H1S2-03-07,3,5407376
H1S1-09-07,3,5407377
EXEP-01-01,3,5407378
H1S1-01-09,4,5407380
H1S2-01-06,4,5407381
EXEP-01-01,4,5407382
H1S1-06-04,4,5407383
H1S1-12-13,4,5407384
H1S2-04-12,4,5407386
H1S1-08-14,4,5407387
HSU1-09-08,5,5407388
HSU1-08-03,2,5407389
H1S1-10-11,2,5407390
H1S2-03-22,3,5407391
H1S1-11-16,3,5407393
H1S1-07-12,4,5407394
HSU1-09-04,4,5407395
H1S1-02-06,4,5407396
H1S2-04-16,4,5407397
H1S1-10-07,5,5407398
HSU1-02-03,2,5407148
H1S2-02-02,2,5407149
HSU1-01-05,2,5407150
H1S2-07-15,3,5407151
HSU2-06-08,3,5407152
HSTA-03-14,3,5407153
H1S2-04-16,3,5407154
HCAL-01-02,3,5407155
HSTA-04-08,3,5407156
H1S2-05-17,3,5407157
HSTA-06-09,3,5407158
HSTA-04-02,3,5407159
HSU1-10-03,3,5407160
HSU2-02-06,4,5407161
HSU1-10-02,4,5407162
HSTA-05-07,4,5407163
EXEP-01-01,4,5407164
HSU2-04-10,4,5407165
HCAL-02-16,4,5407170
HCAL-01-17,4,5407171
HSU2-07-05,5,5407173
HSU2-01-06,2,5407174
HSU2-03-01,2,5407176
HSU2-08-01,3,5407177
HSU1-02-06,3,5407179
H1S2-05-21,4,5407180
HSU1-09-02,4,5407181
H1S2-07-17,4,5407182
H1S2-03-07,4,5407183
H1S2-07-11,5,5407184
EXEP-01-01,2,5407036
HSU1-05-08,2,5407037
HSTA-02-01,2,5407038
HCAL-09-02,3,5407039
HSTA-04-08,3,5407040
HCAL-05-09,3,5407041
HCAL-04-04,3,5407042
HSTA-04-02,3,5407043
HSTA-07-04,3,5407044
HSU1-04-21,3,5407045
EXEP-01-01,3,5407046
EXEP-01-01,3,5407047
HCAL-06-07,3,5407048
HCAL-05-10,4,5407049
EXEP-01-01,4,5407050
HSU1-03-17,4,5407056
HSTA-03-07,4,5407057
EXEP-01-01,4,5407058
HCAL-09-06,4,5407059
EXEP-01-01,4,5407060
HCAL-07-10,5,5407061
HSTA-05-10,2,5407062
HCAL-09-06,2,5407063
HCAL-05-12,3,5407064
EXEP-01-01,3,5407065
H1S2-07-01,4,5407066
EXEP-01-01,4,5407067
HCAL-04-13,4,5407068
EXEP-01-01,4,5407069
HSTA-02-09,5,5407070
HSU1-01-05,2,5407937
H1S2-02-01,2,5407938
HSU1-02-03,2,5407940
HSTA-02-05,3,5407942
HSU1-09-04,3,5407943
H1S2-04-16,3,5407944
H1S2-03-16,3,5407945
HSU2-01-02,3,5407946
HSU2-08-01,3,5407948
H1S2-05-16,3,5407949
HSTA-04-10,3,5407950
HSU2-09-12,3,5407952
HSTA-04-02,3,5407955
HSU2-02-06,4,5407970
HSU1-08-03,4,5407971
HSTA-07-07,4,5407972
HCAL-02-16,4,5407974
HSU2-01-06,4,5407975
HSTA-05-05,4,5407976
HSU2-08-10,4,5407977
HSU1-10-03,5,5407978
H1S2-07-15,2,5407979
HSU2-03-11,2,5407980
H1S2-02-02,3,5407981
HSU1-10-08,3,5407982
HSU2-04-03,4,5407983
HSTA-02-03,4,5407984
HCAL-01-14,4,5407985
HSTA-06-06,4,5407986
HSU2-06-01,5,5407987
EXEP-01-01,2,5407743
HCAL-03-04,2,5407744
HCAL-09-02,2,5407745
HSTA-04-08,3,5407746
HSTA-01-05,3,5407747
HCAL-05-11,3,5407748
HSTA-04-10,3,5407749
EXEP-01-01,3,5407750
HCAL-08-10,3,5407751
HCAL-07-13,3,5407752
HCAL-10-12,3,5407753
EXEP-01-01,3,5407756
HSTA-07-04,3,5407758
HCAL-04-13,4,5407759
HCAL-06-01,4,5407760
EXEP-01-01,4,5407761
HSTA-05-05,4,5407764
HSTA-06-06,4,5407770
EXEP-01-01,4,5407772
HCAL-09-10,4,5407777
HCAL-09-06,5,5407782
HSTA-02-01,2,5407783
HSU1-03-16,2,5407784
EXEP-01-01,3,5407785
HSU1-06-19,3,5407786
HSTA-03-07,4,5407787
HSTA-02-03,4,5407788
EXEP-01-01,4,5407789
EXEP-01-01,4,5407790
HCAL-06-11,5,5407792
HSU1-01-05,2,717360
H1S2-02-01,2,717361
H1S2-04-16,2,717362
HCAL-01-14,3,717363
HSU2-01-02,3,717364
HSTA-01-01,3,717365
H1S2-05-19,3,717366
HSU2-08-10,3,717367
H1S2-03-03,3,717368
HSTA-04-02,3,717369
HSU1-10-04,3,717370
HSU2-01-13,3,717371
HSU1-02-04,3,717372
HSTA-06-07,4,717373
HSTA-03-02,4,717374
HSTA-02-03,5,717380
HSU2-02-05,4,717375
HCAL-02-16,4,717376
HSU1-11-05,4,717377
HSU2-06-04,4,717378
H1S2-04-17,4,717379
H1S2-07-15,2,717381
HSU2-03-11,2,717382
H1S2-06-07,3,717383
HSU1-08-03,3,717384
HSU2-09-01,4,717385
HSTA-07-05,4,717386
HSTA-05-05,4,717387
HSU2-05-05,4,717388
HSU2-09-08,5,717389
EXEP-01-01,2,717330
HCAL-04-10,2,717331
HSTA-04-01,2,717332
EXEP-01-01,3,717333
HSU1-04-06,3,717334
HSU1-06-18,3,717335
HSU1-03-07,3,717336
HCAL-08-05,3,717337
EXEP-01-01,3,717338
HSTA-01-07,3,717339
H1S2-04-16,3,717340
HSTA-06-07,3,717341
EXEP-01-01,3,717342
HSTA-05-05,4,717343
HCAL-04-03,4,717344
HSU1-04-06,4,717345
EXEP-01-01,4,717349
HCAL-10-04,4,717346
EXEP-01-01,4,717347
HSTA-02-01,4,717348
HCAL-09-10,5,717350
H1S2-07-15,2,717351
HCAL-04-15,2,717352
HCAL-05-10,3,717353
EXEP-01-01,3,717354
HSTA-07-07,4,717355
EXEP-01-01,4,717356
HSTA-04-02,4,717357
EXEP-01-01,4,717358
HCAL-07-08,5,717359
HSU1-01-05,2,717630
H1S2-02-01,2,717631
HCAL-01-04,2,717632
HSU1-02-01,3,717633
HSU1-10-05,3,717634
HSU2-01-02,3,717635
H1S2-03-22,3,717636
H1S2-06-07,3,717637
HSU1-09-01,3,717638
HSU1-11-05,3,717639
HSU1-10-10,3,717640
H1S2-02-08,3,717641
HSU1-04-11,3,717642
HCAL-01-17,4,717643
HSU1-01-13,4,717644
HSU2-01-13,4,717645
HSU2-01-16,4,717646
HCAL-02-09,4,717647
HCAL-02-16,4,717648
HSU2-02-11,4,717649
HSU1-11-09,5,717650
H1S2-03-07,2,717651
H1S2-04-12,2,717657
HCAL-02-04,3,717652
HSU2-03-16,3,717653
H1S2-03-16,4,717654
HSU1-10-03,4,717655
H1S2-05-22,4,717656
HCAL-01-14,4,717659
HSU2-02-06,5,717658
HSU1-01-05,2,717970
H1S2-02-01,2,717971
HCAL-01-04,2,717972
HSU2-03-11,3,717973
HSU1-11-05,3,717974
HSU2-03-18,3,717975
HSU2-01-02,3,717976
H1S2-03-07,3,717977
HCAL-02-04,3,717978
H1S2-06-09,3,717979
H1S2-04-07,3,717980
HSU1-09-11,3,717981
HCAL-10-02,3,717990
HSU1-08-07,4,717986
HSU2-08-12,4,717982
HSU2-01-16,4,717983
HSU2-06-10,4,717984
HCAL-02-09,4,717985
HSU2-01-13,4,717987
HCAL-02-16,4,717988
HSU2-07-06,5,717989
HSU1-02-03,2,717991
HSU2-08-01,2,717992
H1S2-04-18,3,717993
H1S2-02-08,3,717994
HSU2-02-05,4,717995
H1S2-05-22,4,717996
HSU1-08-15,4,717997
HSU1-10-03,4,717998
HSU2-09-04,5,717999
H1S2-02-01,2,717720
H1S1-01-01,2,717721
H1S1-03-01,2,717722
H1S1-07-12,3,717723
H1S1-08-08,3,717724
H1S2-03-05,3,717725
H1S1-04-02,3,717726
H1S1-01-04,3,717727
H1S1-07-09,3,717728
H1S1-11-03,3,717729
H1S1-11-11,3,717730
EXEP-01-01,3,717731
H1S1-12-12,3,717732
H1S2-03-16,4,717733
H1S1-12-08,4,717734
H1S1-10-12,4,717735
H1S1-02-06,4,717736
H1S1-06-02,4,717737
H1S1-02-06,4,717738
H1S1-11-07,4,717739
H1S1-09-10,5,717740
H1S1-04-02,2,717741
H1S1-02-06,2,717742
H1S2-02-08,3,717743
H1S1-06-02,3,717744
EXEP-01-01,4,717745
H1S1-11-19,4,717746
H1S1-06-01,4,717747
H1S1-06-08,4,717748
H1S1-11-19,5,717749
HSU1-01-05,2,345217
HSU1-02-01,2,345218
HSU2-01-08,2,345219
HSU1-10-04,3,345220
HSTA-04-08,3,345221
HSTA-04-08,3,345222
H1S2-02-01,3,345223
HSU2-01-02,3,345224
HSU2-08-01,3,345225
H1S2-05-14,3,345226
H1S2-03-07,3,345227
H1S2-04-10,3,345228
HSTA-03-13,3,345229
HSTA-04-02,4,345230
HSTA-06-09,4,345231
HSU1-08-09,4,345232
HSU2-04-05,4,345233
HCAL-02-16,4,345234
HSTA-05-05,4,345235
HSU2-08-10,4,345236
HSU2-02-06,5,345237
HSU1-09-01,2,345238
H1S2-07-15,2,345239
HSU2-02-05,3,345240
HSU2-08-10,3,345241
HSU1-10-09,4,345242
HSU2-03-11,4,345243
HSTA-02-03,4,345244
HSU2-01-16,4,345245
H1S2-07-23,5,345246
EXEP-01-01,2,345187
HSU1-05-08,2,345188
EXEP-01-01,2,345189
HSTA-04-08,3,345190
HCAL-09-01,3,345191
HCAL-03-08,3,345192
EXEP-01-01,3,345193
HSTA-01-05,3,345194
HCAL-05-09,3,345195
HSTA-04-10,3,345196
HSU1-06-19,3,345197
HSTA-06-09,3,345198
HSTA-04-02,3,345199
EXEP-01-01,4,345200
HCAL-10-12,4,345201
HCAL-05-12,4,345202
HSU2-05-01,4,345203
HSTA-05-05,4,345204
EXEP-01-01,4,345205
HCAL-09-10,4,345206
HCAL-04-13,5,345207
HSU1-03-11,2,345208
HSTA-02-01,2,345209
HSU1-04-03,3,345210
HCAL-05-04,3,345211
H1S2-07-26,4,345212
HCAL-09-09,4,345213
EXEP-01-01,4,345214
EXEP-01-01,4,345215
HCAL-07-08,5,345216
HSU1-01-05,2,344816
H1S2-02-01,2,344817
HCAL-01-14,2,344818
H1S2-04-10,3,344819
HSTA-04-08,3,344820
H1S2-03-16,3,344821
HSTA-01-10,3,344822
H1S2-07-25,3,344823
HSU2-01-02,3,344824
HSU2-05-16,3,344825
H1S2-04-19,3,344826
H1S2-03-09,3,344827
H1S2-05-15,3,344828
HSU2-02-05,4,344829
HSU1-10-02,4,344830
HSU2-03-16,4,344831
HSU2-06-10,4,344832
HCAL-02-16,4,344833
HSTA-02-07,4,344834
HSU2-04-06,4,344835
H1S2-05-22,5,344836
H1S2-07-15,2,344838
HSU2-03-11,2,344839
H1S2-01-09,3,344840
HSU1-02-03,3,344841
HSU1-09-01,4,344842
H1S2-06-07,4,344843
HSTA-04-02,4,344844
HSU1-11-05,4,344845
HSU2-04-09,5,344846
EXEP-01-01,2,344786
HCAL-04-01,2,344787
HCAL-03-04,2,344788
HSTA-04-08,3,344789
HCAL-03-09,3,344790
HCAL-05-09,3,344791
H1S2-07-25,3,344792
HSU1-04-15,3,344793
HCAL-05-13,3,344794
EXEP-01-01,3,344795
EXEP-01-01,3,344796
HCAL-09-10,3,344797
H1S2-07-20,3,344798
HCAL-08-09,4,344799
HSTA-03-13,4,344800
HCAL-07-10,4,344801
HSTA-04-02,4,344802
EXEP-01-01,4,344803
HSTA-02-07,4,344804
HCAL-07-04,4,344805
HCAL-07-04,5,344806
H1S2-07-15,2,344807
HCAL-05-08,2,344808
HCAL-09-02,3,344809
EXEP-01-01,3,344810
HCAL-07-08,4,344811
H1S2-07-25,4,344812
HCAL-04-13,4,344813
EXEP-01-01,4,344814
HCAL-09-11,5,344815
HSU1-01-05,2,3468395
H1S2-02-02,2,3468396
HCAL-01-04,2,3468397
HSU1-09-01,3,3468398
HSU1-09-01,3,3468399
H1S2-03-07,3,3468400
HSU2-01-02,3,3468401
H1S2-01-09,3,3468402
H1S2-04-12,3,3468403
HSU1-02-01,3,3468404
H1S2-06-07,3,3468405
HCAL-02-01,3,3468406
HSU1-09-09,3,3468407
HSU1-10-05,4,3468408
H1S2-05-17,4,3468409
H1S2-02-14,4,3468410
H1S2-02-14,4,3468411
HSU2-01-06,4,3468412
HCAL-02-16,4,3468413
H1S2-04-23,4,3468414
HSU2-02-06,5,3468415
HSU2-01-02,2,3468416
HSU1-08-03,2,3468417
HSU2-02-05,3,3468418
HCAL-02-04,3,3468419
HSU1-01-01,4,3468422
HSU1-01-14,4,3468423
HSU1-10-10,4,3468424
HSU1-08-07,4,3468425
HSU2-02-06,5,3468426
H1S2-02-01,2,3468354
HSU1-02-03,2,3468355
HSU2-01-02,2,3468356
HSU1-10-04,3,3468357
HSU1-09-01,3,3468358
H1S2-06-11,3,3468359
HSU2-01-02,3,3468360
H1S2-02-01,3,3468361
H1S2-03-16,3,3468362
H1S2-05-24,3,3468363
H1S2-04-08,3,3468364
H1S2-02-14,3,3468365
HSU1-01-14,3,3468366
HSU1-10-08,4,3468367
H1S2-04-10,4,3468368
HCAL-01-18,4,3468369
HSU1-01-01,4,3468370
HSU1-11-11,4,3468371
HCAL-01-17,4,3468372
HCAL-02-16,4,3468373
HSU1-10-08,5,3468374
H1S2-04-10,2,3468375
HCAL-01-08,2,3468376
HCAL-02-04,3,3468377
H1S2-03-22,3,3468378
HSU1-02-06,4,3468379
HSU1-01-13,4,3468380
HSU2-01-13,4,3468381
HSU1-08-03,4,3468382
HSU2-02-06,5,3468383
H1S1-04-02,2,337989
H1S1-01-01,2,337990
H1S1-02-06,2,337991
H1S1-08-10,3,337992
H1S1-01-09,3,337993
H1S1-03-11,3,337994
H1S1-03-03,3,337995
H1S1-08-08,3,337996
H1S1-07-01,3,337997
H1S1-06-02,3,337998
H1S1-07-12,3,337999
H1S1-01-07,3,338000
H1S1-07-05,3,338001
H1S1-04-02,4,338002
H1S1-06-04,4,338003
H1S1-06-08,4,338004
EXEP-01-01,4,338005
H1S1-04-06,4,338006
H1S1-05-08,4,338007
H1S1-06-10,4,338008
H1S1-08-22,5,338009
H1S1-04-02,2,338010
H1S1-01-04,2,338011
H1S1-08-20,3,338012
H1S1-05-08,3,338013
H1S1-02-07,4,338014
H1S1-06-06,4,338015
EXEP-01-01,4,338016
H1S1-01-07,4,338017
H1S1-02-12,5,338018
HSU1-01-05,2,268128
H1S2-02-01,2,268129
HCAL-01-04,2,268130
H1S2-04-16,3,268131
HSU1-08-09,3,268132
H1S2-06-07,3,268133
HSU2-01-02,3,268134
H1S1-05-08,3,268135
HSTA-02-05,3,268136
HSU1-10-04,3,268137
H1S2-07-25,3,268138
HCAL-01-02,3,268139
HSU1-02-02,3,268140
H1S2-05-15,4,268141
H1S2-02-15,4,268142
HCAL-02-04,4,268143
HSU1-01-09,4,268144
HCAL-02-16,4,268145
H1S2-03-03,4,268146
HSTA-01-04,4,268147
HSU2-01-16,5,268148
HSU2-01-06,2,268149
HSU1-08-07,2,268150
H1S2-03-21,3,268151
HSU1-11-05,3,268152
H1S2-04-07,4,268153
HSU1-10-09,4,268154
HCAL-01-18,4,268155
HSU2-02-06,4,268156
HSTA-02-03,5,268157
HCAL-03-04,2,268098
HSU1-06-05,2,268099
HCAL-09-02,2,268100
EXEP-01-01,3,268101
HCAL-04-15,3,268102
HSU1-03-11,3,268103
H1S2-07-25,3,268104
HCAL-05-11,3,268105
HSU1-06-18,3,268106
HCAL-10-04,3,268107
HCAL-06-01,3,268108
H1S2-07-21,3,268109
HCAL-05-13,3,268110
EXEP-01-01,4,268111
HCAL-08-09,4,268112
HCAL-04-04,4,268113
HSU1-04-16,4,268114
HSTA-02-09,4,268115
EXEP-01-01,4,268116
HCAL-09-03,4,268117
HCAL-04-13,5,268118
HSTA-01-04,2,268119
HCAL-05-01,2,268120
HCAL-05-09,3,268121
EXEP-01-01,3,268122
HSTA-02-03,4,268123
HCAL-10-11,4,268124
HSTA-01-07,4,268125
HSU1-04-06,4,268126
HSU2-03-08,5,268127
HSU1-01-05,2,266709
H1S2-02-02,2,266710
HCAL-01-04,2,266711
HSU1-11-02,3,266712
H1S1-08-13,1,6106487
HSU1-08-05,3,5309524
HSU1-02-06,4,5306029
HSU1-04-13,3,5573482
HSU1-09-07,3,6065363
M2S1-07-18,4,5369565
M2S1-02-15,3,5370330
M2S1-01-01,2,5367660
M3S1-09-01,4,4984011
M3S1-10-02,2,4986994
M2S1-04-03,3,5368748
HSTA-03-15,5,5187285
HSTA-07-05,4,5160950
HSTA-05-05,3,5167123
M3S1-10-07,4,6037942
M2S1-04-14,4,5369129
HSU1-03-15,4,5163395
M2S1-04-13,3,5369168
HSU1-05-06,2,5163484
HSU1-06-21,3,5163920
HSU1-06-21,4,5160642
H1S1-12-11,3,4984921
H1S1-05-05,3,4979062
M2S1-05-06,3,5372064
M2S1-01-13,3,5368419
M2S1-02-07,3,5368423
M3S1-12-06,4,4988415
HSTA-05-09,4,5187763
H1S1-06-10,4,4979649
M3S1-09-05,3,4977357
M3S1-03-01,3,4986781
M2S1-05-06,3,5372702
M2S1-02-16,5,5367541
H1S1-01-08,1,4981859
H1S1-09-08,3,4979476
M1S1-07-14,4,5410243
HSTA-01-07,4,5171863
HSTA-02-08,3,5172668
HSTA-04-11,3,5167301
HSTA-05-05,3,5167030
HSTA-06-09,4,5166159
HSU1-04-03,4,5162684
HSU1-08-07,4,5306651
HSU1-06-22,4,5160391
HSU1-07-09,3,5849859
HSU1-11-05,3,5827451
HSU2-03-02,,
HSU2-04-02,,
HSU2-05-09,,
HCAL-03-02,,
H1S2-02-07,,
HCAL-02-18,,
HSU2-08-08,,
HSU2-06-11,,
H1S2-06-02,,
HCAL-08-02,,
H1S2-03-29,,
HSU2-09-09,,
HSU2-05-14,,
HSU2-05-02,,
H1S2-05-13,,
H1S2-03-27,,
HSU2-03-03,,
HSU2-05-19,,
H1S2-07-04,,
H1S2-05-18,,
HCAL-04-12,,
HCAL-07-05,,
HCAL-01-09,,
H1S2-03-17,,
H1S2-03-23,,
HSU2-05-03,,
HSU2-05-08,,
HCAL-08-03,,
HCAL-06-05,,
H1S2-07-27,,
HSU2-06-02,,
H1S2-05-01,,
H1S2-07-07,,
H1S2-03-12,,
HCAL-03-06,,
HSU2-01-03,,
H1S2-05-05,,
HCAL-02-02,,
HSU2-05-13,,
H1S2-05-20,,
HCAL-06-02,,
HSU2-05-15,,
H1S2-05-06,,
HCAL-09-07,,
H1S2-03-11,,
HCAL-01-06,,
H1S2-06-01,,
HCAL-04-08,,
HSU2-02-10,,
HSU2-07-12,,
HSU2-03-20,,
HCAL-03-05,,
HSU2-07-07,,
HSU2-05-11,,
H1S2-05-11,,
HSU2-06-12,,
HCAL-01-13,,
HSU2-08-09,,
HSU2-04-14,,
H1S2-06-05,,
HCAL-04-16,,
HSU2-06-14,,
H1S2-01-02,,
HSU2-08-16,,
H1S2-07-22,,
H1S2-02-10,,
HCAL-02-07,,
HSU2-09-10,,
HSU2-09-13,,
H1S2-03-15,,
H1S2-01-07,,
H1S2-07-14,,
HCAL-04-05,,
H1S2-04-05,,
HSU2-07-08,,
H1S2-03-04,,
H1S2-07-05,,
H1S2-07-08,,
H1S2-02-03,,
HSU2-03-10,,
HCAL-01-03,,
H1S2-03-24,,
H1S2-07-24,,
HSU2-08-11,,
HSU2-04-15,,
H1S2-03-28,,
HSU2-07-11,,
H1S2-03-13,,
HSU2-03-15,,
HSU2-02-08,,
HSU2-08-15,,
H1S2-07-09,,
H1S2-06-12,,
H1S2-03-20,,
HCAL-09-05,,
H1S2-02-13,,
HCAL-04-11,,
HCAL-02-14,,
H1S2-02-04,,
HCAL-05-07,,
HCAL-07-01,,
HSU2-06-15,,
HSU2-01-14,,
HCAL-04-06,,
H1S2-05-02,,
HSU2-01-15,,
HCAL-02-12,,
H1S2-05-25,,
HCAL-10-05,,
H1S2-06-04,,
H1S2-04-21,,
HSU2-09-05,,
HSU2-09-07,,
H1S2-03-02,,
HCAL-01-11,,
HSU2-06-13,,
HSU2-05-20,,
HCAL-01-10,,
HSU2-02-13,,
HSU2-04-07,,
H1S2-05-03,,
HCAL-03-01,,
H1S2-03-01,,
HSU2-03-21,,
HCAL-02-13,,
H1S2-03-10,,
HSU2-05-18,,
H1S2-05-09,,
HSU2-04-11,,
HSU2-06-16,,
HSU2-07-03,,
H1S2-05-04,,
HSU2-04-04,,
H1S2-04-06,,
HCAL-02-05,,
HSU2-02-07,,
H1S2-03-18,,
HCAL-04-07,,
H1S2-03-26,,
HCAL-01-05,,
H1S2-06-06,,
HCAL-04-14,,
H1S2-07-03,,
HCAL-10-03,,
HCAL-02-06,,
H1S2-05-10,,
HSU2-04-13,,
H1S2-07-06,,
HCAL-02-03,,
H1S2-07-16,,
H1S2-03-19,,
H1S2-05-08,,
HSU2-08-03,,
HSU2-06-09,,
H1S2-04-20,,
HSU2-01-09,,
HSU2-01-05,,
H1S2-01-01,,
H1S2-04-24,,
H1S2-06-08,,
H1S2-02-06,,
HSU2-01-10,,
HSU2-05-12,,
HCAL-09-13,,
HSU2-08-05,,
HSU2-08-14,,
H1S2-07-12,,
H1S2-05-07,,
HCAL-10-10,,
HCAL-02-17,,
H1S2-03-14,,
HCAL-08-01,,
HSU2-07-09,,
H1S2-01-04,,
qtid,difficulty,qbase_question_id
M3S1-01-01,1,38781
M3S1-01-01,1,38782
M3S1-01-01,1,38783
M3S1-01-01,3,38784
M3S1-01-01,3,38785
M3S1-01-01,3,38786
M3S1-01-01,3,38787
M3S1-01-01,3,38788
M3S1-01-01,3,38789
M3S1-01-01,3,38790
M3S1-01-01,1,38792
M3S1-01-01,1,38793
M3S1-01-01,1,38794
M3S1-01-01,3,38795
M3S1-01-01,3,38796
M3S1-01-01,3,52150
M3S1-01-01,1,52151
M3S1-01-01,3,52152
M3S1-01-01,3,52153
M3S1-01-01,1,1663910
M3S1-01-01,1,1663911
M3S1-01-01,1,1663912
M3S1-01-01,2,1663913
M3S1-01-01,1,1663914
M3S1-01-01,1,1663915
M3S1-01-01,1,1663916
M3S1-01-01,1,1663917
M3S1-01-01,2,1663918
M3S1-01-01,1,1663919
M3S1-01-01,1,1663920
M3S1-01-01,1,1663921
M3S1-01-01,1,1663922
M3S1-01-01,1,1663923
M3S1-01-01,1,1663924
M3S1-01-01,2,1663925
M3S1-01-01,2,1663926
M3S1-01-01,2,1663927
M3S1-01-01,2,1663928
M3S1-01-01,1,1663929
M3S1-01-01,1,1663930
M3S1-01-01,1,1663931
M3S1-01-01,1,1663932
M3S1-01-01,1,1663933
M3S1-01-01,1,1663934
M3S1-01-01,1,1663935
M3S1-01-01,1,1663936
M3S1-01-01,1,1663937
M3S1-01-01,3,52154
M3S1-01-01,1,52155
M3S1-01-01,3,52156
M3S1-01-01,1,1663938
M3S1-01-01,1,1663939
M3S1-01-01,1,1663940
M3S1-01-01,1,1663941
M3S1-01-01,1,1663942
M3S1-01-01,1,1663943
M3S1-01-01,1,1663944
M3S1-01-01,1,1663945
M3S1-01-01,1,1663954
M3S1-01-01,1,1663955
M3S1-01-01,1,1663956
M3S1-01-01,1,1663959
M3S1-01-01,1,1663960
M3S1-01-01,1,1663961
M3S1-01-01,1,1663962
M3S1-01-01,1,1663963
M3S1-01-01,1,1663964
M3S1-01-01,1,1663965
M3S1-01-01,1,1663966
M3S1-01-01,1,1664039
M3S1-01-01,1,1664041
M3S1-01-01,2,1664043
M3S1-01-01,1,1664045
M3S1-01-01,2,1664048
M3S1-01-02,3,38800
M3S1-01-02,3,38801
M3S1-01-02,3,38802
M3S1-01-02,3,52158
M3S1-01-02,1,52159
M3S1-01-02,1,52160
M3S1-01-02,3,52161
M3S1-01-02,1,1663946
M3S1-01-02,1,1663947
M3S1-01-02,1,1663948
M3S1-01-02,1,1663949
M3S1-01-02,1,1663950
M3S1-01-02,1,1663951
M3S1-01-02,1,1663952
M3S1-01-02,1,1663953
M3S1-01-03,3,38803
M3S1-01-03,3,38804
M3S1-01-03,3,796808
M3S1-01-03,3,796809
M3S1-01-03,3,796810
M3S1-01-03,3,796811
M3S1-01-03,1,796812
M3S1-01-03,3,796813
M3S1-01-03,3,52184
M3S1-01-03,1,52162
M3S1-01-03,2,52163
M3S1-01-03,3,52164
M3S1-01-03,1,1664005
M3S1-01-03,1,1664007
M3S1-01-03,1,1664009
M3S1-01-03,1,1664011
M3S1-01-03,2,1664012
M3S1-01-03,1,1664014
M3S1-01-03,2,1664015
M3S1-01-03,1,1664017
M3S1-01-03,2,1664018
M3S1-01-03,1,1664020
M3S1-01-03,1,1664022
M3S1-01-03,1,1664023
M3S1-01-03,1,1664026
M3S1-01-03,1,1664027
M3S1-01-03,1,1664029
M3S1-01-03,1,1664031
M3S1-01-03,1,1664032
M3S1-01-03,1,1664034
M3S1-01-03,1,1664035
M3S1-01-03,3,1664037
M3S1-01-04,3,796814
M3S1-01-04,1,796815
M3S1-01-04,3,796816
M3S1-01-04,3,796817
M3S1-01-04,3,796818
M3S1-01-04,3,796819
M3S1-01-04,2,1664050
M3S1-01-04,2,1664052
M3S1-01-04,2,1664054
M3S1-01-04,2,1664056
M3S1-01-04,1,1664058
M3S1-01-04,2,1664092
M3S1-01-04,2,1664094
M3S1-01-04,2,1664098
M3S1-01-04,2,1664100
M3S1-01-04,2,1664102
M3S1-01-04,2,1664106
M3S1-01-04,2,1664109
M3S1-01-04,2,1664111
M3S1-01-04,2,1664113
M3S1-01-04,3,52165
M3S1-01-04,1,52166
M3S1-01-04,1,52167
M3S1-01-04,3,52168
M3S1-01-04,3,52169
M3S1-01-04,3,52170
M3S1-01-04,3,52171
M3S1-01-04,4,52172
M3S1-01-05,3,796820
M3S1-01-05,1,796821
M3S1-01-05,3,796822
M3S1-01-05,3,796823
M3S1-01-05,3,796824
M3S1-01-05,5,796825
M3S1-01-05,3,796826
M3S1-01-05,3,796827
M3S1-01-05,3,796828
M3S1-01-05,5,796829
M3S1-01-05,5,38805
M3S1-01-05,3,38806
M3S1-01-05,3,38807
M3S1-01-05,3,38808
M3S1-01-05,3,38809
M3S1-01-05,5,38810
M3S1-01-05,5,38811
M3S1-01-05,3,52173
M3S1-01-05,1,52174
M3S1-01-05,1,52175
M3S1-01-05,3,52176
M3S1-01-05,3,52177
M3S1-01-05,3,52178
M3S1-01-05,4,52179
M3S1-01-05,5,52180
M3S1-01-05,3,90801
M3S1-01-05,2,90800
M3S1-01-05,3,52183
M3S1-01-05,5,52185
M3S1-01-05,1,1664062
M3S1-01-05,1,1664064
M3S1-01-05,1,1664067
M3S1-01-05,1,1664069
M3S1-01-05,1,1664072
M3S1-01-05,1,1664073
M3S1-01-05,1,1664074
M3S1-01-05,1,1664075
M3S1-01-05,1,1664076
M3S1-01-05,2,1664078
M3S1-01-05,1,1664079
M3S1-01-05,1,1664080
M3S1-01-05,1,1664081
M3S1-01-05,1,1664082
M3S1-01-05,1,1664083
M3S1-01-05,1,1664085
M3S1-01-05,1,1664087
M3S1-01-05,1,1664089
M3S1-01-05,2,1664116
M3S1-01-05,2,1664117
M3S1-01-05,2,1664118
M3S1-01-05,2,1664119
M3S1-01-05,2,1664236
M3S1-01-05,2,1664237
M3S1-01-05,2,1664238
M3S1-01-05,2,1664239
M3S1-01-05,2,1664240
M3S1-01-05,2,1664241
M3S1-01-05,3,1664242
M3S1-01-05,3,1664243
M3S1-01-06,3,38812
M3S1-01-06,1,38813
M3S1-01-06,3,38814
M3S1-01-06,3,38830
M3S1-01-06,5,38831
M3S1-01-06,5,38832
M3S1-01-06,4,38837
M3S1-01-06,3,38838
M3S1-01-06,5,38839
M3S1-01-06,5,38840
M3S1-01-06,3,52186
M3S1-01-06,3,52187
M3S1-01-06,3,52188
M3S1-01-06,4,52189
M3S1-01-07,3,38833
M3S1-01-07,3,38834
M3S1-01-07,5,38835
M3S1-01-07,5,38836
M3S1-01-07,3,52190
M3S1-01-07,3,52191
M3S1-01-07,3,52192
M3S1-01-07,4,52193
M3S1-01-08,1,38841
M3S1-01-08,1,38842
M3S1-01-08,3,38843
M3S1-01-08,3,38844
M3S1-01-08,3,38845
M3S1-01-08,3,38846
M3S1-01-08,3,52194
M3S1-01-08,3,52195
M3S1-01-08,3,52196
M3S1-01-08,4,52227
M3S1-01-08,3,52197
M3S1-01-08,3,52198
M3S1-01-08,4,52199
M3S1-01-08,5,52200
M3S1-01-09,1,38847
M3S1-01-09,1,38848
M3S1-01-09,3,38849
M3S1-01-09,3,38850
M3S1-01-09,3,38851
M3S1-01-09,5,38852
M3S1-01-09,3,52201
M3S1-01-09,3,52202
M3S1-01-09,3,52203
M3S1-01-09,3,52204
M3S1-01-09,1,1664262
M3S1-01-09,1,1664263
M3S1-01-09,1,1664264
M3S1-01-09,1,1664265
M3S1-01-09,1,1664266
M3S1-01-09,1,1664267
M3S1-01-09,1,1664268
M3S1-01-09,1,1664269
M3S1-01-09,1,1664270
M3S1-01-09,1,1664271
M3S1-01-09,1,1664272
M3S1-01-09,1,1664273
M3S1-01-09,2,1664274
M3S1-01-09,2,1664275
M3S1-01-10,1,38857
M3S1-01-10,3,38858
M3S1-01-10,3,38859
M3S1-01-10,3,38860
M3S1-01-10,3,38861
M3S1-01-10,5,38862
M3S1-01-10,3,52212
M3S1-01-10,3,52229
M3S1-01-10,4,52231
M3S1-01-10,4,52232
M3S1-01-10,3,1664276
M3S1-01-10,2,1664277
M3S1-01-10,2,1664278
M3S1-01-10,2,1664279
M3S1-01-10,2,1664280
M3S1-01-10,3,1664281
M3S1-01-10,3,1664282
M3S1-01-10,2,1664283
M3S1-01-10,2,1664284
M3S1-02-01,3,38896
M3S1-02-01,3,38897
M3S1-02-01,3,38898
M3S1-02-01,5,38899
M3S1-02-01,5,38900
M3S1-02-01,3,52234
M3S1-02-01,3,52236
M3S1-02-01,3,52238
M3S1-02-01,3,52239
M3S1-02-01,1,1664342
M3S1-02-01,1,1664344
M3S1-02-01,1,1664345
M3S1-02-01,1,1664347
M3S1-02-01,1,1664349
M3S1-02-01,1,1664351
M3S1-02-01,1,1664352
M3S1-02-01,1,1664355
M3S1-02-01,1,1664357
M3S1-02-01,1,1664358
M3S1-02-01,2,1664423
M3S1-02-01,1,1664424
M3S1-02-01,1,1664425
M3S1-02-01,1,1664426
M3S1-02-01,1,1687433
M3S1-02-01,1,1664455
M3S1-02-01,1,1664456
M3S1-02-01,1,1664457
M3S1-02-01,1,1664458
M3S1-02-01,1,1664459
M3S1-02-01,1,1664460
M3S1-02-01,1,1664461
M3S1-02-01,1,1664462
M3S1-02-01,1,1664463
M3S1-02-01,1,1664464
M3S1-02-01,1,1664465
M3S1-02-01,1,1664466
M3S1-02-02,1,38901
M3S1-02-02,1,38902
M3S1-02-02,3,38903
M3S1-02-02,3,38904
M3S1-02-03,2,38905
M3S1-02-03,1,38906
M3S1-02-03,3,38907
M3S1-02-04,3,38797
M3S1-02-04,3,38798
M3S1-02-04,5,38799
M3S1-02-04,4,52157
M3S1-02-05,3,38911
M3S1-02-05,1,38912
M3S1-02-05,1,38913
M3S1-02-05,1,38914
M3S1-02-05,3,38915
M3S1-02-05,5,38916
M3S1-02-05,3,38917
M3S1-02-05,3,38918
M3S1-02-05,5,38919
M3S1-02-05,5,38920
M3S1-02-05,3,52241
M3S1-02-05,3,52243
M3S1-02-05,3,52244
M3S1-02-05,3,52285
M3S1-02-05,3,52248
M3S1-02-05,3,52250
M3S1-02-05,3,52251
M3S1-02-05,4,52253
M3S1-02-05,1,1664467
M3S1-02-05,1,1664468
M3S1-02-05,1,1664470
M3S1-02-05,1,1664469
M3S1-02-05,1,1664471
M3S1-02-05,1,1664472
M3S1-02-05,1,1664473
M3S1-02-05,1,1664474
M3S1-02-05,5,38945
M3S1-02-06,3,38921
M3S1-02-06,3,38922
M3S1-02-06,3,38923
M3S1-02-06,3,38924
M3S1-02-06,5,38925
M3S1-02-06,1,38936
M3S1-02-06,1,38937
M3S1-02-06,1,38938
M3S1-02-06,3,38939
M3S1-02-06,5,38940
M3S1-02-06,3,52255
M3S1-02-06,3,52260
M3S1-02-06,3,52262
M3S1-02-06,2,52263
M3S1-02-06,1,52265
M3S1-02-06,3,52266
M3S1-02-06,3,52268
M3S1-02-06,3,52269
M3S1-02-06,3,52271
M3S1-02-06,3,52272
M3S1-02-06,1,1664475
M3S1-02-06,1,1664476
M3S1-02-06,1,1664477
M3S1-02-06,1,1664478
M3S1-02-06,1,1664479
M3S1-02-06,1,1664480
M3S1-02-06,1,1687316
M3S1-02-06,2,1664484
M3S1-02-06,2,38941
M3S1-02-06,1,38942
M3S1-02-06,3,38943
M3S1-02-06,3,38944
M3S1-02-07,2,38863
M3S1-02-07,1,38864
M3S1-02-07,3,38865
M3S1-02-07,3,38866
M3S1-02-07,5,38867
M3S1-02-08,3,38926
M3S1-02-08,3,38927
M3S1-02-08,3,38928
M3S1-02-08,3,38929
M3S1-02-08,5,38930
M3S1-02-08,3,38931
M3S1-02-08,3,38932
M3S1-02-08,3,38933
M3S1-02-08,3,38934
M3S1-02-08,5,38935
M3S1-02-08,3,52274
M3S1-02-08,1,52276
M3S1-02-08,3,52286
M3S1-02-08,3,52288
M3S1-02-08,3,52289
M3S1-02-08,3,52290
M3S1-02-08,3,52292
M3S1-02-08,3,52297
M3S1-03-01,1,38968
M3S1-03-01,1,38969
M3S1-03-01,1,38970
M3S1-03-01,3,38971
M3S1-03-01,3,38972
M3S1-03-01,5,38973
M3S1-03-01,3,38984
M3S1-03-01,3,38985
M3S1-03-01,3,38986
M3S1-03-01,3,38987
M3S1-03-01,3,38988
M3S1-03-01,5,38989
M3S1-03-01,2,134826
M3S1-03-01,2,134827
M3S1-03-01,2,134828
M3S1-03-01,3,134830
M3S1-03-01,2,134836
M3S1-03-01,2,134838
M3S1-03-01,3,134839
M3S1-03-01,3,134841
M3S1-03-01,1,1664577
M3S1-03-01,1,1664578
M3S1-03-01,1,1664579
M3S1-03-01,1,1664580
M3S1-03-01,1,1664581
M3S1-03-01,1,1664573
M3S1-03-01,1,1664574
M3S1-03-01,1,1664575
M3S1-03-01,1,1664576
M3S1-03-01,1,1664582
M3S1-03-01,1,1664585
M3S1-03-01,1,1664629
M3S1-03-01,1,1664630
M3S1-03-01,1,1664631
M3S1-03-01,1,1664632
M3S1-03-01,1,1664633
M3S1-03-01,1,1664634
M3S1-03-01,1,1664635
M3S1-03-01,1,1664636
M3S1-03-01,1,1664637
M3S1-03-01,1,1664638
M3S1-03-01,1,1664639
M3S1-03-01,1,1664640
M3S1-03-01,1,1664641
M3S1-03-02,3,38974
M3S1-03-02,1,38975
M3S1-03-02,3,38976
M3S1-03-02,3,38977
M3S1-03-02,3,38978
M3S1-03-02,5,3591020
M3S1-03-02,5,3591021
M3S1-03-02,1,38980
M3S1-03-02,3,38981
M3S1-03-02,3,38982
M3S1-03-02,5,38983
M3S1-03-02,3,38990
M3S1-03-02,1,38991
M3S1-03-02,3,38992
M3S1-03-02,3,38993
M3S1-03-02,3,38994
M3S1-03-02,3,38995
M3S1-03-02,1,134831
M3S1-03-02,1,134832
M3S1-03-02,3,134833
M3S1-03-02,3,134835
M3S1-03-02,1,134843
M3S1-03-02,1,134844
M3S1-03-02,3,134845
M3S1-03-02,3,134846
M3S1-03-02,1,1664642
M3S1-03-02,1,1664643
M3S1-03-02,1,1664644
M3S1-03-02,1,1664645
M3S1-03-02,1,1664646
M3S1-03-02,1,1664647
M3S1-03-02,1,1664659
M3S1-03-02,1,1664660
M3S1-03-02,1,1664661
M3S1-03-02,1,1664662
M3S1-03-02,1,1664663
M3S1-03-02,1,1664664
M3S1-03-02,1,1664665
M3S1-03-02,1,1664666
M3S1-03-02,1,1664667
M3S1-03-02,1,1664668
M3S1-03-02,1,1664669
M3S1-03-02,1,1664670
M3S1-03-02,1,1664671
M3S1-03-02,1,1664672
M3S1-03-02,2,1664673
M3S1-03-03,3,39007
M3S1-03-03,1,39008
M3S1-03-03,3,39011
M3S1-03-03,3,39012
M3S1-03-03,3,39013
M3S1-03-03,3,39014
M3S1-03-03,3,134851
M3S1-03-03,3,134852
M3S1-03-03,3,134853
M3S1-03-03,3,134854
M3S1-03-03,1,1664674
M3S1-03-03,1,1664675
M3S1-03-03,1,1664676
M3S1-03-03,1,1664677
M3S1-03-03,1,1664678
M3S1-03-03,1,1664679
M3S1-03-03,1,1664680
M3S1-03-03,1,1664681
M3S1-03-03,1,1664682
M3S1-03-03,1,1664683
M3S1-03-03,1,1664684
M3S1-03-03,1,1664685
M3S1-03-03,1,1664686
M3S1-03-03,1,1664687
M3S1-03-03,1,1664688
M3S1-03-03,1,1664690
M3S1-03-03,1,1664691
M3S1-03-03,1,1664692
M3S1-03-03,1,1664694
M3S1-03-03,1,1664696
M3S1-03-03,1,1664697
M3S1-03-03,1,1664699
M3S1-03-03,1,1664700
M3S1-03-03,1,1664701
M3S1-03-04,1,38908
M3S1-03-04,1,38909
M3S1-03-04,1,38910
M3S1-03-04,3,38996
M3S1-03-04,1,38997
M3S1-03-04,3,38998
M3S1-03-04,3,38999
M3S1-03-04,5,39000
M3S1-03-04,1,1664725
M3S1-03-04,1,1664726
M3S1-03-05,1,1664733
M3S1-03-05,1,1664734
M3S1-03-05,1,1664735
M3S1-03-05,2,1699006
M3S1-03-05,1,1664736
M3S1-03-05,1,1664737
M3S1-03-05,1,1664738
M3S1-03-05,1,1664739
M3S1-03-05,1,1664740
M3S1-03-05,1,1664741
M3S1-03-06,3,39001
M3S1-03-06,3,39002
M3S1-03-06,3,39003
M3S1-03-06,3,39004
M3S1-03-06,3,39005
M3S1-03-06,5,39006
M3S1-03-06,3,134847
M3S1-03-06,3,134848
M3S1-03-06,3,134849
M3S1-03-06,3,134850
M3S1-03-07,3,39021
M3S1-03-07,3,39022
M3S1-03-07,3,39023
M3S1-03-07,5,39024
M3S1-03-07,5,39025
M3S1-03-07,5,39026
M3S1-03-07,3,134860
M3S1-03-07,3,134861
M3S1-03-07,3,134863
M3S1-03-07,3,134877
M3S1-04-01,3,39047
M3S1-04-01,1,39048
M3S1-04-01,3,39049
M3S1-04-01,3,39050
M3S1-04-01,3,39051
M3S1-04-01,5,39052
M3S1-04-01,3,39053
M3S1-04-01,1,39054
M3S1-04-01,3,39055
M3S1-04-01,5,39056
M3S1-04-01,5,39057
M3S1-04-01,3,39058
M3S1-04-01,1,39059
M3S1-04-01,3,39060
M3S1-04-01,3,39061
M3S1-04-01,3,39062
M3S1-04-01,5,39063
M3S1-04-01,3,134878
M3S1-04-01,3,134880
M3S1-04-01,3,134907
M3S1-04-01,4,134908
M3S1-04-01,3,134883
M3S1-04-01,3,134884
M3S1-04-01,3,134886
M3S1-04-01,4,134887
M3S1-04-01,1,1664756
M3S1-04-01,1,1664757
M3S1-04-01,1,1664758
M3S1-04-01,1,1664759
M3S1-04-01,1,1664760
M3S1-04-01,1,1664761
M3S1-04-01,1,1664762
M3S1-04-01,1,1664763
M3S1-04-01,1,1664764
M3S1-04-01,1,1664765
M3S1-04-01,1,1664766
M3S1-04-01,1,1664767
M3S1-04-01,1,1664768
M3S1-04-01,1,1664769
M3S1-04-01,1,1664770
M3S1-04-02,3,39064
M3S1-04-02,1,39065
M3S1-04-02,3,39066
M3S1-04-02,3,39067
M3S1-04-02,3,134888
M3S1-04-02,2,134889
M3S1-04-02,3,134891
M3S1-04-02,3,134892
M3S1-04-02,1,1664818
M3S1-04-02,1,1664819
M3S1-04-02,1,1664820
M3S1-04-02,1,1664821
M3S1-04-02,1,1664822
M3S1-04-02,1,1664823
M3S1-04-02,1,1664825
M3S1-04-02,1,1664827
M3S1-04-02,1,1664829
M3S1-04-02,1,1664830
M3S1-04-02,1,1664832
M3S1-04-03,2,39068
M3S1-04-03,1,39077
M3S1-04-03,3,39078
M3S1-04-03,5,39079
M3S1-04-03,3,134893
M3S1-04-03,1,134896
M3S1-04-03,3,134898
M3S1-04-03,3,134904
M3S1-04-03,1,1664833
M3S1-04-03,1,1664836
M3S1-04-03,1,1664837
M3S1-04-03,1,1664839
M3S1-04-03,1,1664840
M3S1-04-03,1,1664843
M3S1-04-03,1,1664853
M3S1-04-04,3,39086
M3S1-04-04,3,39087
M3S1-04-04,3,39088
M3S1-04-04,3,39089
M3S1-04-04,3,39090
M3S1-04-04,5,39091
M3S1-04-04,1,134933
M3S1-04-04,1,134934
M3S1-04-04,3,134935
M3S1-04-04,3,134937
M3S1-04-04,3,134939
M3S1-04-04,3,134940
M3S1-04-04,4,134942
M3S1-04-04,4,134943
M3S1-04-04,1,1664854
M3S1-04-04,1,1664855
M3S1-04-04,1,1664856
M3S1-04-04,1,1664857
M3S1-04-04,1,1664858
M3S1-04-04,1,1664859
M3S1-04-04,1,1664860
M3S1-04-04,1,1664861
M3S1-04-04,1,1664862
M3S1-04-04,1,1664863
M3S1-04-04,1,1664864
M3S1-04-04,1,1664865
M3S1-04-04,1,1664866
M3S1-04-04,1,1664867
M3S1-04-04,1,1664868
M3S1-04-04,1,1664869
M3S1-04-04,1,1664870
M3S1-04-04,1,1664871
M3S1-04-04,1,1664872
M3S1-04-04,1,1664873
M3S1-04-04,1,1664876
M3S1-04-05,3,39098
M3S1-04-05,1,39099
M3S1-04-05,1,39100
M3S1-04-05,3,39101
M3S1-04-05,3,39102
M3S1-04-05,3,39103
M3S1-04-05,3,134945
M3S1-04-05,1,134946
M3S1-04-05,3,134947
M3S1-04-05,4,134948
M3S1-04-05,1,1664877
M3S1-04-05,1,1664878
M3S1-04-05,1,1664880
M3S1-04-05,1,1664881
M3S1-04-05,1,1664882
M3S1-04-05,1,1664884
M3S1-04-05,1,1664886
M3S1-04-05,1,1664887
M3S1-04-05,1,1664889
M3S1-04-05,1,1664891
M3S1-04-05,1,1664893
M3S1-04-05,2,1664895
M3S1-04-05,2,1664897
M3S1-04-05,2,1664899
M3S1-04-05,2,1664901
M3S1-04-05,3,1664903
M3S1-04-06,2,134951
M3S1-04-06,3,134952
M3S1-04-06,4,134954
M3S1-04-06,5,134956
M3S1-04-07,1,39141
M3S1-04-07,1,39142
M3S1-04-07,3,39143
M3S1-04-07,3,39161
M3S1-04-07,3,39163
M3S1-04-07,5,39165
M3S1-04-07,3,134964
M3S1-04-07,3,134966
M3S1-04-07,3,134967
M3S1-04-07,3,134969
M3S1-04-08,3,39080
M3S1-04-08,1,39081
M3S1-04-08,3,39082
M3S1-04-08,3,39083
M3S1-04-08,5,39084
M3S1-04-08,5,39085
M3S1-04-08,3,134910
M3S1-04-08,3,134911
M3S1-04-08,3,134913
M3S1-04-08,4,134914
M3S1-04-09,3,39092
M3S1-04-09,3,39093
M3S1-04-09,3,39094
M3S1-04-09,3,3591243
M3S1-04-09,3,3591245
M3S1-04-09,5,39096
M3S1-04-09,5,39097
M3S1-04-09,3,134915
M3S1-04-09,3,134917
M3S1-04-09,3,134918
M3S1-04-09,4,134919
M3S1-04-11,3,39167
M3S1-04-11,3,39169
M3S1-04-11,3,39171
M3S1-04-11,3,39172
M3S1-04-11,3,39174
M3S1-04-11,5,39176
M3S1-04-11,3,134927
M3S1-04-11,3,134928
M3S1-04-11,4,134930
M3S1-04-11,4,134931
M3S1-04-12,3,39177
M3S1-04-12,3,39178
M3S1-04-12,3,39180
M3S1-04-12,3,39181
M3S1-04-12,5,39182
M3S1-04-12,5,39183
M3S1-04-13,1,39110
M3S1-04-13,3,39111
M3S1-04-13,3,39112
M3S1-04-13,3,39113
M3S1-04-13,5,39114
M3S1-04-13,5,39115
M3S1-04-13,3,134977
M3S1-04-13,3,134980
M3S1-04-13,3,134983
M3S1-04-13,4,134984
M3S1-04-13,1,1664497
M3S1-04-13,1,1664498
M3S1-04-13,2,1664499
M3S1-05-01,1,39282
M3S1-05-01,3,39285
M3S1-05-01,1,1665014
M3S1-05-01,1,1665015
M3S1-05-01,1,1665016
M3S1-05-01,1,1665017
M3S1-05-02,1,39287
M3S1-05-02,1,39290
M3S1-05-02,3,39291
M3S1-05-02,3,39293
M3S1-05-02,3,39295
M3S1-05-02,5,39297
M3S1-05-02,1,135181
M3S1-05-02,1,1665023
M3S1-05-02,1,1665025
M3S1-05-02,1,1665026
M3S1-05-02,1,1665027
M3S1-05-02,1,1665028
M3S1-05-02,1,1665029
M3S1-05-02,1,1665030
M3S1-05-02,1,1665031
M3S1-05-02,1,1665032
M3S1-05-02,2,1665033
M3S1-05-02,2,1665034
M3S1-05-02,2,1665035
M3S1-05-02,2,1665036
M3S1-05-02,2,1665037
M3S1-05-02,2,1665038
M3S1-05-03,1,195754
M3S1-05-03,1,195756
M3S1-05-03,3,195757
M3S1-05-03,3,195808
M3S1-05-03,3,195810
M3S1-05-03,5,195813
M3S1-05-03,1,135187
M3S1-05-03,2,135189
M3S1-05-03,3,135190
M3S1-05-03,4,135192
M3S1-05-03,1,1665063
M3S1-05-03,1,1665064
M3S1-05-03,1,1665065
M3S1-05-03,1,1665066
M3S1-05-03,1,1665067
M3S1-05-03,1,1665068
M3S1-05-03,1,1665069
M3S1-05-03,1,1665070
M3S1-05-03,1,1665071
M3S1-05-03,1,1665072
M3S1-05-03,1,1665073
M3S1-05-03,1,1665074
M3S1-05-03,1,1665075
M3S1-05-03,1,1665076
M3S1-05-03,1,1665077
M3S1-05-03,1,1665078
M3S1-05-03,1,1665079
M3S1-05-03,1,1665080
M3S1-05-03,1,1665081
M3S1-05-03,1,1665082
M3S1-05-03,1,1661221
M3S1-05-04,3,39298
M3S1-05-04,1,39299
M3S1-05-04,3,39300
M3S1-05-04,3,39301
M3S1-05-04,5,39302
M3S1-05-04,2,135194
M3S1-05-04,2,135195
M3S1-05-04,2,135197
M3S1-05-04,3,135199
M3S1-05-04,1,1665039
M3S1-05-04,1,1665040
M3S1-05-04,1,1665041
M3S1-05-04,1,1665042
M3S1-05-04,1,1665043
M3S1-05-04,1,1665044
M3S1-05-04,1,1665045
M3S1-05-04,1,1665046
M3S1-05-04,1,1665047
M3S1-05-04,1,1665048
M3S1-05-04,1,1665049
M3S1-05-04,1,1665050
M3S1-05-04,1,1665051
M3S1-05-04,1,1665052
M3S1-05-05,1,39304
M3S1-05-05,1,39306
M3S1-05-05,3,39308
M3S1-05-05,3,39310
M3S1-05-05,3,39312
M3S1-05-05,5,39314
M3S1-05-05,1,135201
M3S1-05-05,2,135202
M3S1-05-05,3,135205
M3S1-05-05,3,135206
M3S1-05-05,1,1665053
M3S1-05-05,1,1665054
M3S1-05-05,1,1665055
M3S1-05-05,1,1665056
M3S1-05-05,1,1665057
M3S1-05-05,1,1665058
M3S1-05-05,1,1665059
M3S1-05-05,1,1665060
M3S1-05-05,1,1665061
M3S1-05-05,1,1665062
M3S1-05-06,2,39316
M3S1-05-06,3,195746
M3S1-05-06,3,195747
M3S1-05-06,5,195749
M3S1-05-06,5,195751
M3S1-05-06,3,135207
M3S1-05-06,3,135208
M3S1-05-06,3,135209
M3S1-05-06,3,135211
M3S1-05-06,2,1665127
M3S1-05-06,2,1665128
M3S1-05-07,3,195814
M3S1-05-07,1,195817
M3S1-05-07,3,195818
M3S1-05-07,3,195820
M3S1-05-07,5,195827
M3S1-05-07,5,195840
M3S1-05-07,3,135212
M3S1-05-07,3,135214
M3S1-05-07,3,135216
M3S1-05-07,4,135217
M3S1-05-07,1,1665083
M3S1-05-07,1,1665084
M3S1-05-07,1,1665085
M3S1-05-07,1,1665086
M3S1-05-07,1,1665087
M3S1-05-07,1,1665088
M3S1-05-07,1,1665089
M3S1-05-07,1,1665090
M3S1-05-07,1,1665091
M3S1-05-07,1,1665092
M3S1-05-07,1,1665093
M3S1-05-07,1,1665094
M3S1-05-07,1,1665095
M3S1-05-07,1,1665096
M3S1-05-07,1,1665097
M3S1-05-07,1,1665098
M3S1-05-07,1,1665099
M3S1-05-07,1,1665100
M3S1-05-07,1,1665101
M3S1-05-07,1,1665102
M3S1-05-07,1,1665103
M3S1-05-07,1,1665119
M3S1-05-07,1,1665120
M3S1-05-07,1,1665121
M3S1-05-07,1,1665122
M3S1-05-08,3,195841
M3S1-05-08,1,195842
M3S1-05-08,3,195843
M3S1-05-08,3,195844
M3S1-05-08,3,195845
M3S1-05-08,3,195846
M3S1-05-08,1,195847
M3S1-05-08,3,195848
M3S1-05-08,3,195849
M3S1-05-08,1,135219
M3S1-05-08,1,135220
M3S1-05-08,3,135222
M3S1-05-08,3,135224
M3S1-05-08,1,1665104
M3S1-05-08,1,1665105
M3S1-05-08,1,1665106
M3S1-05-08,1,1665107
M3S1-05-08,1,1665108
M3S1-05-08,1,1665112
M3S1-05-08,1,1665113
M3S1-05-08,1,1665114
M3S1-05-08,1,1665115
M3S1-05-08,1,1665116
M3S1-05-08,1,1665117
M3S1-05-08,1,1665118
M3S1-05-08,1,1665123
M3S1-05-08,1,1665124
M3S1-05-08,1,1665125
M3S1-05-08,1,1665126
M3S1-05-09,1,195854
M3S1-05-09,1,195856
M3S1-05-09,3,195858
M3S1-05-09,5,195860
M3S1-05-09,5,195862
M3S1-05-09,1,135225
M3S1-05-09,1,135226
M3S1-05-09,3,135228
M3S1-05-09,3,135229
M3S1-05-10,4,135231
M3S1-05-10,4,135232
M3S1-05-10,4,135234
M3S1-05-10,5,195864
M3S1-05-10,5,195866
M3S1-05-10,5,1665132
M3S1-05-11,3,195867
M3S1-05-11,3,195868
M3S1-05-11,3,195869
M3S1-05-11,5,195870
M3S1-05-11,3,1665133
M3S1-05-11,3,1665134
M3S1-06-01,1,195850
M3S1-06-01,1,195851
M3S1-06-01,3,195852
M3S1-06-01,2,195915
M3S1-06-01,1,195917
M3S1-06-01,3,195918
M3S1-06-01,3,195919
M3S1-06-01,3,195920
M3S1-06-01,3,195921
M3S1-06-01,1,135180
M3S1-06-01,3,135183
M3S1-06-01,3,135185
M3S1-06-02,3,195922
M3S1-06-02,3,195923
M3S1-06-02,3,195924
M3S1-06-02,5,195925
M3S1-06-02,5,195926
M3S1-06-02,3,195927
M3S1-06-02,3,195928
M3S1-06-02,3,195929
M3S1-06-02,5,195930
M3S1-06-02,5,195931
M3S1-06-02,3,195932
M3S1-06-02,3,195933
M3S1-06-02,5,195934
M3S1-06-02,5,195935
M3S1-06-02,3,135240
M3S1-06-02,4,135263
M3S1-06-02,4,135269
M3S1-06-02,5,135273
M3S1-06-02,1,1665176
M3S1-06-02,1,1665177
M3S1-06-02,1,1665178
M3S1-06-02,1,1665179
M3S1-06-02,3,1665180
M3S1-06-02,3,1665181
M3S1-06-02,3,1665182
M3S1-06-02,3,1665183
M3S1-06-02,3,1665184
M3S1-06-02,3,1665185
M3S1-06-03,3,195936
M3S1-06-03,3,195937
M3S1-06-03,3,195938
M3S1-06-03,5,195939
M3S1-06-03,5,195940
M3S1-06-03,3,135264
M3S1-06-03,4,135266
M3S1-06-03,4,135274
M3S1-06-03,4,135277
M3S1-06-04,3,195941
M3S1-06-04,1,195942
M3S1-06-04,3,195943
M3S1-06-04,5,195944
M3S1-06-04,5,195945
M3S1-06-04,5,90827
M3S1-06-04,1,1665186
M3S1-06-04,1,1665187
M3S1-06-04,2,1665188
M3S1-06-04,2,1665189
M3S1-06-04,2,1665190
M3S1-06-04,2,1665191
M3S1-06-04,2,1665192
M3S1-06-04,2,1665193
M3S1-06-04,2,1665194
M3S1-06-04,2,1665195
M3S1-06-04,2,1665196
M3S1-06-04,2,1665197
M3S1-06-05,2,195946
M3S1-06-05,3,195947
M3S1-06-05,3,195948
M3S1-06-05,3,195949
M3S1-06-05,5,195950
M3S1-06-05,5,195951
M3S1-06-05,3,135235
M3S1-06-05,3,135237
M3S1-06-05,3,135238
M3S1-06-05,3,135239
M3S1-06-05,2,1665198
M3S1-06-05,2,1665199
M3S1-06-05,2,1665200
M3S1-06-05,2,1665201
M3S1-06-05,2,1665202
M3S1-06-05,2,1665203
M3S1-06-06,3,195952
M3S1-06-06,3,195953
M3S1-06-06,5,195954
M3S1-06-06,5,195955
M3S1-06-06,5,195956
M3S1-06-06,3,135279
M3S1-06-06,3,135282
M3S1-06-06,4,135285
M3S1-06-06,5,135287
M3S1-06-07,3,195957
M3S1-06-07,3,195958
M3S1-06-07,3,195959
M3S1-06-07,3,195960
M3S1-06-07,3,195961
M3S1-06-07,5,195962
M3S1-06-07,3,135288
M3S1-06-07,2,135291
M3S1-06-07,4,135293
M3S1-06-07,4,135295
M3S1-06-07,1,1665204
M3S1-06-07,1,1665205
M3S1-06-07,1,1665206
M3S1-06-07,1,1665207
M3S1-06-07,1,1665208
M3S1-06-07,1,1665209
M3S1-06-07,1,1665210
M3S1-06-07,1,1665211
M3S1-06-07,1,1665212
M3S1-06-07,1,1665213
M3S1-06-07,1,1665214
M3S1-06-07,1,1665215
M3S1-06-07,1,1665216
M3S1-06-07,1,1665217
M3S1-06-07,1,1665218
M3S1-06-07,1,1665219
M3S1-06-07,1,1665220
M3S1-06-07,1,1665221
M3S1-06-07,1,1665222
M3S1-06-07,1,1665223
M3S1-06-08,3,195963
M3S1-06-08,1,39444
M3S1-06-08,3,195964
M3S1-06-08,5,195965
M3S1-06-08,5,195966
M3S1-06-08,5,195967
M3S1-06-08,2,195968
M3S1-06-08,3,195969
M3S1-06-08,3,195970
M3S1-06-08,3,195971
M3S1-06-08,3,195972
M3S1-06-08,5,195973
M3S1-06-08,4,135297
M3S1-06-08,3,135298
M3S1-06-08,4,135301
M3S1-06-08,4,135304
M3S1-06-08,1,1665224
M3S1-06-08,1,1665225
M3S1-06-08,1,1665226
M3S1-06-08,1,1665227
M3S1-06-08,1,1665228
M3S1-06-08,1,1665229
M3S1-06-08,1,1665230
M3S1-06-08,1,1665231
M3S1-06-08,1,1665232
M3S1-06-08,1,1665233
M3S1-06-08,2,1665234
M3S1-06-08,2,1665235
M3S1-06-08,1,1665236
M3S1-06-08,1,1665237
M3S1-06-08,1,1665238
M3S1-06-09,3,195871
M3S1-06-09,3,195872
M3S1-06-09,3,195873
M3S1-06-09,3,195874
M3S1-06-09,5,195875
M3S1-06-09,5,195876
M3S1-06-09,3,195974
M3S1-06-09,5,195975
M3S1-06-09,5,195976
M3S1-06-09,2,135306
M3S1-06-09,3,135308
M3S1-06-09,3,135310
M3S1-06-09,3,135312
M3S1-07-01,1,196015
M3S1-07-01,1,196016
M3S1-07-01,3,196017
M3S1-07-01,3,196018
M3S1-07-01,1,53093
M3S1-07-01,1,53094
M3S1-07-01,3,53095
M3S1-07-01,3,53096
M3S1-07-02,1,196019
M3S1-07-02,1,196020
M3S1-07-02,1,196021
M3S1-07-02,3,196022
M3S1-07-02,3,196023
M3S1-07-02,1,53097
M3S1-07-02,1,53098
M3S1-07-02,1,53099
M3S1-07-02,2,53100
M3S1-07-02,1,1665342
M3S1-07-02,1,1665344
M3S1-07-02,1,1665346
M3S1-07-02,1,1665349
M3S1-07-02,1,1665351
M3S1-07-02,1,1665353
M3S1-07-02,1,1665355
M3S1-07-02,1,1665357
M3S1-07-02,1,1665358
M3S1-07-02,1,1665360
M3S1-07-02,1,1665362
M3S1-07-02,1,1665363
M3S1-07-03,1,196034
M3S1-07-03,1,196035
M3S1-07-03,1,196036
M3S1-07-03,3,196037
M3S1-07-03,3,196038
M3S1-07-04,1,196039
M3S1-07-04,3,196040
M3S1-07-04,3,196041
M3S1-07-04,5,196042
M3S1-07-04,2,196043
M3S1-07-04,3,196044
M3S1-07-04,3,196045
M3S1-07-04,3,196046
M3S1-07-04,3,196047
M3S1-07-04,2,53109
M3S1-07-04,1,53110
M3S1-07-04,3,53111
M3S1-07-04,3,53112
M3S1-07-04,1,1665365
M3S1-07-04,1,1665366
M3S1-07-04,1,1665367
M3S1-07-04,1,1665368
M3S1-07-04,1,1665369
M3S1-07-04,1,1665371
M3S1-07-04,1,1665372
M3S1-07-04,1,1665373
M3S1-07-04,1,1665374
M3S1-07-04,1,1665376
M3S1-07-04,1,1665377
M3S1-07-04,1,1665379
M3S1-07-04,1,1665380
M3S1-07-04,1,1665381
M3S1-07-04,1,1665382
M3S1-07-04,2,1665383
M3S1-07-04,1,1665437
M3S1-07-04,1,1665438
M3S1-07-04,1,1665439
M3S1-07-04,1,1665440
M3S1-07-04,1,1665441
M3S1-07-04,1,1665442
M3S1-07-04,1,1665443
M3S1-07-04,1,1665444
M3S1-07-05,2,196061
M3S1-07-05,3,196058
M3S1-07-05,3,196059
M3S1-07-05,5,196060
M3S1-07-05,1,196062
M3S1-07-05,1,196063
M3S1-07-05,3,196064
M3S1-07-05,3,196065
M3S1-07-05,5,196066
M3S1-07-05,5,196067
M3S1-07-05,2,53121
M3S1-07-05,2,53122
M3S1-07-05,2,53123
M3S1-07-05,3,53124
M3S1-07-05,2,53125
M3S1-07-05,3,53126
M3S1-07-05,4,53127
M3S1-07-05,4,53128
M3S1-07-05,1,1665385
M3S1-07-05,1,1665386
M3S1-07-05,1,1665388
M3S1-07-05,1,1665390
M3S1-07-05,1,1665391
M3S1-07-05,1,1665393
M3S1-07-05,1,1665394
M3S1-07-05,1,1665395
M3S1-07-05,1,1665396
M3S1-07-05,1,1665398
M3S1-07-05,1,1665399
M3S1-07-05,1,1665401
M3S1-07-05,1,1665402
M3S1-07-05,1,1665404
M3S1-07-05,1,1665405
M3S1-07-05,1,1665407
M3S1-07-05,1,1665408
M3S1-07-05,1,1665445
M3S1-07-05,1,1665446
M3S1-07-05,1,1665447
M3S1-07-05,1,1665448
M3S1-07-06,2,196024
M3S1-07-06,3,196025
M3S1-07-06,3,196026
M3S1-07-06,3,196027
M3S1-07-06,2,53101
M3S1-07-06,2,53102
M3S1-07-06,3,53103
M3S1-07-06,3,53104
M3S1-07-06,3,53113
M3S1-07-06,3,53114
M3S1-07-06,3,53115
M3S1-07-06,4,53116
M3S1-07-06,3,196048
M3S1-07-06,3,196049
M3S1-07-06,3,196050
M3S1-07-06,5,196051
M3S1-07-07,2,196028
M3S1-07-07,1,196029
M3S1-07-07,3,196030
M3S1-07-07,3,196031
M3S1-07-07,5,196032
M3S1-07-07,5,196033
M3S1-07-07,2,53105
M3S1-07-07,2,53106
M3S1-07-07,4,53107
M3S1-07-07,4,53108
M3S1-07-08,3,196053
M3S1-07-08,3,196054
M3S1-07-08,3,196055
M3S1-07-08,3,196056
M3S1-07-08,5,196057
M3S1-07-08,3,196068
M3S1-07-08,3,196069
M3S1-07-08,3,196070
M3S1-07-08,3,196071
M3S1-07-08,5,196072
M3S1-07-08,5,196073
M3S1-07-08,2,53117
M3S1-07-08,2,53118
M3S1-07-08,3,53119
M3S1-07-08,3,53120
M3S1-07-09,3,196074
M3S1-07-09,3,196075
M3S1-07-09,3,196076
M3S1-07-09,3,196077
M3S1-07-09,5,196078
M3S1-07-09,3,53129
M3S1-07-09,2,53130
M3S1-07-09,2,53131
M3S1-07-09,2,53132
M3S1-07-09,1,1665410
M3S1-07-09,1,1665411
M3S1-07-09,1,1665412
M3S1-07-09,1,1665413
M3S1-07-09,1,1665414
M3S1-07-09,1,1665415
M3S1-07-09,1,1665416
M3S1-07-09,1,1665417
M3S1-07-09,1,1665418
M3S1-07-09,1,1665419
M3S1-07-09,1,1665420
M3S1-07-09,1,1665421
M3S1-07-09,1,1665422
M3S1-07-09,1,1665423
M3S1-07-09,1,1665424
M3S1-07-09,1,1665425
M3S1-07-09,1,1665426
M3S1-07-09,1,1665427
M3S1-07-09,1,1665428
M3S1-07-09,1,1665449
M3S1-07-09,1,1665450
M3S1-07-09,1,1665451
M3S1-07-09,1,1665452
M3S1-07-09,1,1665453
M3S1-07-09,1,1665454
M3S1-07-10,3,196079
M3S1-07-10,1,196080
M3S1-07-10,3,196081
M3S1-07-11,3,196082
M3S1-07-11,1,196083
M3S1-07-11,3,196084
M3S1-07-11,3,196085
M3S1-07-11,3,53133
M3S1-07-11,3,53134
M3S1-07-11,3,53135
M3S1-07-11,3,53136
M3S1-08-01,2,196123
M3S1-08-01,3,196124
M3S1-08-01,3,196125
M3S1-08-01,3,196126
M3S1-08-01,5,196127
M3S1-08-01,2,53186
M3S1-08-01,2,53187
M3S1-08-01,3,53188
M3S1-08-01,4,53189
M3S1-08-01,1,1665547
M3S1-08-01,1,1665548
M3S1-08-01,1,1665549
M3S1-08-01,1,1665550
M3S1-08-01,1,1665551
M3S1-08-01,1,1665552
M3S1-08-01,1,1665553
M3S1-08-01,1,1665554
M3S1-08-01,1,1665555
M3S1-08-01,1,1665579
M3S1-08-01,2,53190
M3S1-08-01,3,53192
M3S1-08-01,3,53193
M3S1-08-01,1,1665591
M3S1-08-01,1,1665592
M3S1-08-01,1,1665593
M3S1-08-02,1,196128
M3S1-08-02,1,196129
M3S1-08-02,3,196130
M3S1-08-02,5,196131
M3S1-08-02,3,196132
M3S1-08-02,3,196133
M3S1-08-02,3,196134
M3S1-08-02,3,196135
M3S1-08-02,5,196136
M3S1-08-02,2,53194
M3S1-08-02,2,53195
M3S1-08-02,3,53196
M3S1-08-02,4,53197
M3S1-08-02,2,53198
M3S1-08-02,3,53199
M3S1-08-02,3,53200
M3S1-08-02,3,53201
M3S1-08-02,1,1665581
M3S1-08-02,1,1665584
M3S1-08-02,1,1665585
M3S1-08-02,1,1665586
M3S1-08-02,1,1665588
M3S1-08-02,1,1665589
M3S1-08-03,2,196137
M3S1-08-03,3,196138
M3S1-08-03,3,196139
M3S1-08-03,5,196140
M3S1-08-03,5,196141
M3S1-08-03,5,196142
M3S1-08-03,2,53202
M3S1-08-03,3,53203
M3S1-08-03,3,53204
M3S1-08-03,4,53205
M3S1-08-03,1,1665595
M3S1-08-03,1,1665596
M3S1-08-03,1,1665597
M3S1-08-03,1,1665598
M3S1-08-04,1,196143
M3S1-08-04,1,196144
M3S1-08-04,3,196145
M3S1-08-04,3,196146
M3S1-08-04,2,53206
M3S1-08-04,2,53207
M3S1-08-04,3,53208
M3S1-08-04,3,53209
M3S1-08-04,2,1665601
M3S1-08-05,3,196147
M3S1-08-05,3,196148
M3S1-08-05,3,196149
M3S1-08-05,3,196150
M3S1-08-05,3,196151
M3S1-08-05,5,196152
M3S1-08-05,3,196153
M3S1-08-05,3,196154
M3S1-08-05,3,196155
M3S1-08-05,2,53210
M3S1-08-05,2,53211
M3S1-08-05,3,53212
M3S1-08-05,4,53213
M3S1-08-06,3,196156
M3S1-08-06,3,196157
M3S1-08-06,3,196158
M3S1-08-06,3,196159
M3S1-08-06,5,196160
M3S1-08-07,1,196161
M3S1-08-07,1,196162
M3S1-08-07,3,196163
M3S1-08-07,3,196164
M3S1-08-07,3,196165
M3S1-08-07,5,196166
M3S1-08-07,3,53191
M3S1-08-07,1,1665602
M3S1-08-07,1,1665605
M3S1-08-07,1,1665606
M3S1-08-08,3,196167
M3S1-08-08,3,196168
M3S1-08-08,3,196169
M3S1-08-08,5,196170
M3S1-08-08,5,196171
M3S1-08-08,5,196172
M3S1-08-08,3,196173
M3S1-08-08,3,196174
M3S1-08-08,3,196175
M3S1-08-08,3,196176
M3S1-08-08,3,196177
M3S1-08-08,5,196178
M3S1-08-08,3,53214
M3S1-08-08,3,53215
M3S1-08-08,3,53216
M3S1-08-08,3,53217
M3S1-08-08,3,53218
M3S1-08-08,3,53219
M3S1-08-08,4,53220
M3S1-08-08,4,53221
M3S1-08-08,3,53226
M3S1-08-08,3,53227
M3S1-08-08,3,53228
M3S1-08-08,4,53229
M3S1-08-09,3,196179
M3S1-08-09,3,196180
M3S1-08-09,3,196181
M3S1-08-09,5,196182
M3S1-08-09,5,196183
M3S1-08-09,3,53222
M3S1-08-09,3,53223
M3S1-08-09,4,53224
M3S1-08-09,4,53225
M3S1-08-10,2,196206
M3S1-08-10,3,196207
M3S1-08-10,5,196208
M3S1-08-10,5,196209
M3S1-08-10,2,53230
M3S1-08-10,2,53231
M3S1-08-10,3,53232
M3S1-08-10,3,53233
M3S1-08-11,4,196216
M3S1-08-11,3,196217
M3S1-09-01,3,196218
M3S1-09-01,3,196219
M3S1-09-01,3,196220
M3S1-09-01,5,196221
M3S1-09-01,5,196222
M3S1-09-01,3,53234
M3S1-09-01,3,53235
M3S1-09-01,3,53236
M3S1-09-01,3,53237
M3S1-09-01,3,1665627
M3S1-09-01,3,1665707
M3S1-09-02,3,196223
M3S1-09-02,3,196224
M3S1-09-02,5,196225
M3S1-09-03,3,196226
M3S1-09-03,3,196227
M3S1-09-03,3,196228
M3S1-09-03,3,53241
M3S1-09-03,2,1665632
M3S1-09-03,3,1665636
M3S1-09-04,3,196229
M3S1-09-04,3,196230
M3S1-09-04,3,196231
M3S1-09-04,3,53238
M3S1-09-04,3,53239
M3S1-09-04,3,53240
M3S1-09-04,3,1665638
M3S1-09-04,3,1665708
M3S1-09-04,3,1665709
M3S1-09-05,3,196232
M3S1-09-05,3,196233
M3S1-09-05,5,196234
M3S1-09-05,5,196235
M3S1-09-05,3,53242
M3S1-09-05,3,53243
M3S1-09-05,3,53244
M3S1-09-05,3,53245
M3S1-09-05,3,1665639
M3S1-09-06,3,196236
M3S1-09-06,3,196237
M3S1-09-06,3,3591445
M3S1-09-06,3,3591447
M3S1-09-06,5,196239
M3S1-09-06,3,53262
M3S1-09-06,3,53263
M3S1-09-06,3,53264
M3S1-09-06,3,53265
M3S1-09-06,3,1665711
M3S1-09-07,3,196240
M3S1-09-07,3,196241
M3S1-09-07,3,196242
M3S1-09-07,5,196243
M3S1-09-07,5,196244
M3S1-09-07,3,53247
M3S1-09-07,3,53255
M3S1-09-07,4,53256
M3S1-09-07,5,53257
M3S1-09-08,3,196245
M3S1-09-08,3,196246
M3S1-09-08,5,196247
M3S1-09-08,5,196248
M3S1-09-08,3,53254
M3S1-09-09,3,196249
M3S1-09-09,3,196250
M3S1-09-09,5,196251
M3S1-09-09,3,53258
M3S1-09-09,3,53259
M3S1-09-09,4,53260
M3S1-09-09,4,53261
M3S1-09-10,3,196252
M3S1-09-10,3,196253
M3S1-09-10,3,196254
M3S1-09-11,4,196257
M3S1-09-11,3,196258
M3S1-09-11,5,196259
M3S1-09-11,3,53250
M3S1-09-11,3,53251
M3S1-09-11,3,1665706
M3S1-09-11,3,1665718
M3S1-10-01,1,196297
M3S1-10-01,1,196298
M3S1-10-01,3,196299
M3S1-10-01,1,176754
M3S1-10-01,1,176756
M3S1-10-01,2,176758
M3S1-10-01,1,1665782
M3S1-10-01,1,1665788
M3S1-10-01,1,1665789
M3S1-10-01,1,1665891
M3S1-10-01,1,1665892
M3S1-10-01,1,1665894
M3S1-10-01,1,1665896
M3S1-10-01,1,1665898
M3S1-10-01,1,1665899
M3S1-10-01,1,1665902
M3S1-10-01,1,1665903
M3S1-10-01,1,1665906
M3S1-10-01,1,1665907
M3S1-10-01,1,1665909
M3S1-10-02,2,196305
M3S1-10-02,3,196306
M3S1-10-03,2,196308
M3S1-10-03,1,196315
M3S1-10-03,1,196316
M3S1-10-03,3,196317
M3S1-10-03,3,196318
M3S1-10-03,5,196319
M3S1-10-03,2,176759
M3S1-10-03,3,176761
M3S1-10-03,3,176763
M3S1-10-03,3,176764
M3S1-10-04,1,196333
M3S1-10-04,1,196335
M3S1-10-04,3,196337
M3S1-10-04,3,196340
M3S1-10-04,3,196342
M3S1-10-04,1,176766
M3S1-10-04,1,176767
M3S1-10-04,3,176769
M3S1-10-04,3,176771
M3S1-10-04,3,176779
M3S1-10-04,3,176781
M3S1-10-04,3,176782
M3S1-10-04,3,196320
M3S1-10-04,3,196321
M3S1-10-04,1,1666000
M3S1-10-04,1,1666004
M3S1-10-04,1,1666007
M3S1-10-04,1,1666008
M3S1-10-04,1,1665919
M3S1-10-04,1,1665922
M3S1-10-04,1,1665998
M3S1-10-05,1,196344
M3S1-10-05,1,196349
M3S1-10-05,3,196351
M3S1-10-05,5,196354
M3S1-10-05,1,176773
M3S1-10-05,2,176775
M3S1-10-05,3,196331
M3S1-10-05,1,1666010
M3S1-10-05,1,1666011
M3S1-10-06,3,196356
M3S1-10-06,3,196358
M3S1-10-06,3,196359
M3S1-10-06,5,196361
M3S1-10-06,3,197793
M3S1-10-06,1,176778
M3S1-10-06,3,176784
M3S1-10-06,3,176786
M3S1-10-06,3,176787
M3S1-10-06,4,176790
M3S1-10-07,3,196362
M3S1-10-07,1,196364
M3S1-10-07,3,196366
M3S1-10-07,5,196367
M3S1-10-07,3,176791
M3S1-10-07,1,176793
M3S1-10-07,3,176795
M3S1-10-07,3,176797
M3S1-10-07,3,176800
M3S1-10-07,4,176801
M3S1-10-07,2,176803
M3S1-10-07,3,176805
M3S1-10-07,3,176806
M3S1-10-07,4,176807
M3S1-10-07,3,176808
M3S1-10-07,3,176809
M3S1-10-07,3,176810
M3S1-10-07,1,1666059
M3S1-10-07,1,1666070
M3S1-10-07,1,1666073
M3S1-10-07,1,1666076
M3S1-10-07,1,1666078
M3S1-10-07,1,1666082
M3S1-10-07,1,1666085
M3S1-10-07,1,1666087
M3S1-10-07,1,1666089
M3S1-10-07,1,1666090
M3S1-10-07,1,1666093
M3S1-10-07,1,1666096
M3S1-10-07,1,1666348
M3S1-10-07,1,1666349
M3S1-10-08,1,54656
M3S1-10-08,1,54657
M3S1-10-08,3,54658
M3S1-10-08,1,54659
M3S1-10-08,1,54660
M3S1-10-08,1,54661
M3S1-10-08,2,54662
M3S1-10-08,2,54663
M3S1-10-08,3,54664
M3S1-10-08,3,54665
M3S1-10-08,4,54666
M3S1-10-08,3,54667
M3S1-10-08,3,54668
M3S1-10-08,3,54669
M3S1-10-08,1,1666230
M3S1-10-08,1,1666241
M3S1-10-08,1,1666245
M3S1-10-08,1,1666247
M3S1-10-08,1,1666249
M3S1-10-08,1,1666251
M3S1-10-08,1,1666252
M3S1-10-08,1,1666254
M3S1-10-08,1,1666255
M3S1-10-08,1,1666256
M3S1-10-08,1,1666258
M3S1-10-08,1,1666259
M3S1-10-08,1,1666351
M3S1-10-08,2,196369
M3S1-10-08,3,196376
M3S1-10-09,2,196377
M3S1-10-09,1,196379
M3S1-10-09,3,196381
M3S1-10-09,3,196382
M3S1-10-09,5,196383
M3S1-10-09,5,196385
M3S1-10-09,1,54682
M3S1-10-09,2,54683
M3S1-10-09,3,54684
M3S1-10-09,1,1666263
M3S1-10-09,1,1666268
M3S1-10-09,1,1666271
M3S1-10-09,1,1666274
M3S1-10-09,1,1666282
M3S1-10-09,1,1666283
M3S1-10-09,1,1666286
M3S1-10-09,1,1666289
M3S1-10-09,1,1666290
M3S1-10-09,1,1666292
M3S1-10-09,1,1666294
M3S1-10-09,1,1666296
M3S1-10-09,1,1666352
M3S1-10-09,1,1666353
M3S1-10-09,3,196371
M3S1-10-09,3,54680
M3S1-10-09,3,54685
M3S1-10-09,3,54686
M3S1-10-09,3,54687
M3S1-10-09,4,54688
M3S1-10-10,3,54693
M3S1-10-10,4,54694
M3S1-10-10,3,196373
M3S1-10-10,3,196375
M3S1-10-11,3,196386
M3S1-10-11,1,196388
M3S1-10-11,3,196389
M3S1-10-11,3,196391
M3S1-10-11,3,196392
M3S1-10-11,5,196394
M3S1-10-11,1,54675
M3S1-10-11,1,54676
M3S1-10-11,4,54674
M3S1-10-11,4,54677
M3S1-10-11,3,54678
M3S1-10-11,4,54681
M3S1-10-12,2,196398
M3S1-10-12,3,196400
M3S1-10-12,3,196401
M3S1-10-12,3,196403
M3S1-10-12,5,196408
M3S1-10-12,3,54689
M3S1-10-12,3,54690
M3S1-10-12,4,54691
M3S1-10-12,4,54692
M3S1-10-13,3,196410
M3S1-10-13,3,196412
M3S1-10-13,3,196414
M3S1-10-13,5,196416
M3S1-10-13,5,196417
M3S1-10-13,3,176811
M3S1-10-13,3,54653
M3S1-10-13,3,54654
M3S1-10-13,4,54655
M3S1-10-13,3,54670
M3S1-10-13,3,54671
M3S1-10-13,3,54672
M3S1-10-13,4,54673
M3S1-10-13,1,54695
M3S1-10-13,3,54696
M3S1-10-13,4,54697
M3S1-10-13,4,54698
M3S1-10-14,3,196418
M3S1-10-14,3,196420
M3S1-10-14,3,196422
M3S1-10-14,3,196424
M3S1-10-14,5,196425
M3S1-10-14,3,54699
M3S1-10-14,3,54700
M3S1-10-14,4,54701
M3S1-10-14,1,1666479
M3S1-10-14,1,1666480
M3S1-10-14,1,1666483
M3S1-10-14,1,1666484
M3S1-10-14,1,1666485
M3S1-10-14,1,1666486
M3S1-11-01,3,196488
M3S1-11-01,1,196490
M3S1-11-01,3,196492
M3S1-11-01,2,54748
M3S1-11-01,2,54749
M3S1-11-01,3,54750
M3S1-11-01,1,1666564
M3S1-11-01,1,1666566
M3S1-11-01,1,1666568
M3S1-11-01,1,1666569
M3S1-11-02,3,196495
M3S1-11-02,1,196498
M3S1-11-02,3,196500
M3S1-11-02,3,196516
M3S1-11-02,5,196518
M3S1-11-02,5,196520
M3S1-11-02,3,54751
M3S1-11-02,2,54752
M3S1-11-02,3,54753
M3S1-11-02,4,54754
M3S1-11-02,2,54755
M3S1-11-02,2,54756
M3S1-11-02,3,54757
M3S1-11-02,2,1666572
M3S1-11-02,2,1666576
M3S1-11-03,3,54758
M3S1-11-03,3,54759
M3S1-11-03,3,54760
M3S1-11-03,4,54761
M3S1-11-03,3,196567
M3S1-11-03,3,196569
M3S1-11-03,3,196570
M3S1-11-03,3,196571
M3S1-11-04,3,196573
M3S1-11-04,3,196574
M3S1-11-04,3,196575
M3S1-11-04,3,196576
M3S1-11-04,5,196577
M3S1-11-04,3,54763
M3S1-11-04,4,54764
M3S1-11-05,3,196578
M3S1-11-05,3,196579
M3S1-11-05,3,196580
M3S1-11-05,3,196581
M3S1-11-05,3,54762
M3S1-11-06,3,196533
M3S1-11-06,3,196535
M3S1-11-06,3,196537
M3S1-11-06,3,196538
M3S1-11-06,3,54765
M3S1-11-06,3,54766
M3S1-11-06,3,54767
M3S1-11-06,4,54768
M3S1-11-07,3,196546
M3S1-11-07,3,196548
M3S1-11-07,3,196549
M3S1-11-07,3,54773
M3S1-11-07,3,54774
M3S1-11-07,3,54775
M3S1-11-07,4,54776
M3S1-11-07,5,196572
M3S1-11-08,2,196540
M3S1-11-08,3,196542
M3S1-11-08,3,196544
M3S1-11-09,3,196587
M3S1-11-09,1,196589
M3S1-11-09,3,196590
M3S1-11-09,3,196592
M3S1-11-09,5,196594
M3S1-11-09,5,196596
M3S1-11-09,3,54777
M3S1-11-09,3,54778
M3S1-11-09,3,54779
M3S1-11-09,4,54780
M3S1-11-09,2,1666594
M3S1-11-09,2,1666596
M3S1-11-09,2,1666598
M3S1-11-09,2,1666599
M3S1-11-09,2,1666601
M3S1-11-09,2,1666602
M3S1-11-10,3,196582
M3S1-11-10,3,196583
M3S1-11-10,5,196584
M3S1-11-10,5,196585
M3S1-11-10,5,196586
M3S1-11-10,3,54769
M3S1-11-10,3,54770
M3S1-11-10,4,54771
M3S1-11-10,4,54772
M3S1-12-01,3,196651
M3S1-12-01,1,196653
M3S1-12-01,3,196662
M3S1-12-01,3,196663
M3S1-12-01,3,196665
M3S1-12-01,5,196667
M3S1-12-01,3,54781
M3S1-12-01,3,54782
M3S1-12-01,4,54783
M3S1-12-01,4,54784
M3S1-12-02,3,196668
M3S1-12-02,1,196670
M3S1-12-02,3,196672
M3S1-12-02,3,196673
M3S1-12-02,5,196675
M3S1-12-02,3,54785
M3S1-12-02,3,54786
M3S1-12-02,3,54787
M3S1-12-02,4,54788
M3S1-12-03,1,196677
M3S1-12-03,1,196678
M3S1-12-03,3,196680
M3S1-12-03,3,196682
M3S1-12-03,5,196683
M3S1-12-03,5,196685
M3S1-12-03,3,54789
M3S1-12-03,3,54790
M3S1-12-03,4,54791
M3S1-12-03,5,54792
M3S1-12-03,2,1666587
M3S1-12-03,2,1666588
M3S1-12-03,2,1666590
M3S1-12-03,2,1666593
M3S1-12-04,3,196687
M3S1-12-04,1,196688
M3S1-12-04,1,196689
M3S1-12-04,3,196691
M3S1-12-04,3,196692
M3S1-12-04,5,196693
M3S1-12-04,3,54793
M3S1-12-04,3,54794
M3S1-12-04,3,54795
M3S1-12-04,4,54796
M3S1-12-05,2,196694
M3S1-12-05,1,196695
M3S1-12-05,1,196696
M3S1-12-05,3,196698
M3S1-12-05,3,196700
M3S1-12-05,2,196702
M3S1-12-05,3,196704
M3S1-12-05,3,196706
M3S1-12-05,3,196708
M3S1-12-05,5,196709
M3S1-12-05,2,54797
M3S1-12-05,2,54798
M3S1-12-05,3,54799
M3S1-12-05,3,54800
M3S1-12-05,1,1666622
M3S1-12-05,1,1666623
M3S1-12-05,1,1666625
M3S1-12-05,1,1666627
M3S1-12-05,1,1666628
M3S1-12-05,1,1666630
M3S1-12-05,1,1666631
M3S1-12-05,1,1666632
M3S1-12-05,1,1666634
M3S1-12-05,1,1666635
M3S1-12-05,1,1666636
M3S1-12-06,1,196710
M3S1-12-06,1,196712
M3S1-12-06,3,196713
M3S1-12-06,3,196714
M3S1-12-06,5,196715
M3S1-12-06,5,196716
M3S1-12-06,3,196718
M3S1-12-06,3,196720
M3S1-12-06,3,196721
M3S1-12-06,3,196723
M3S1-12-06,3,196725
M3S1-12-06,3,54801
M3S1-12-06,3,54802
M3S1-12-06,1,1666637
M3S1-12-07,3,196733
M3S1-12-07,3,196734
M3S1-12-07,3,196735
M3S1-12-07,5,196737
M3S1-12-07,3,54805
M3S1-12-07,4,54806
M3S1-12-07,4,54807
M3S1-12-07,4,54808
M3S1-12-08,2,54809
M3S1-12-08,2,54810
M3S1-12-08,3,54811
M3S1-12-08,4,54812
M3S1-12-08,3,196739
M3S1-12-08,3,196740
M3S1-12-08,5,196741
M3S1-12-08,2,1666644
M3S1-12-09,3,196743
M3S1-12-09,3,196744
M3S1-12-09,3,39317
M3S1-12-09,3,39318
M3S1-12-09,5,39319
M3S1-12-09,5,39320
M3S1-12-09,3,39321
M3S1-12-09,3,39322
M3S1-12-09,3,39323
M3S1-12-09,5,39324
M3S1-12-09,3,54813
M3S1-12-09,2,54814
M3S1-12-09,3,54815
M3S1-12-09,3,54816
M3S1-12-10,4,54823
M3S1-12-10,5,54824
M3S1-12-10,4,39328
M3S1-12-10,5,39330
M3S1-12-10,5,39331
M3S1-12-11,3,39332
M3S1-12-11,3,39333
M3S1-12-11,3,39334
M3S1-12-11,5,39335
M3S1-12-11,5,39336
M3S1-12-11,3,54817
M3S1-12-11,2,54818
M3S1-12-11,3,54819
M3S1-12-11,3,54820
M3S1-12-11,3,1666652
H1S1-01-01,1,1674756
H1S1-01-01,1,1674757
H1S1-01-01,3,1674758
H1S1-01-01,3,1674760
H1S1-01-01,3,1674761
H1S1-01-01,3,1696383
H1S1-01-01,2,1696385
H1S1-01-01,3,1696388
H1S1-01-01,2,2907838
H1S1-01-01,2,2907839
H1S1-01-01,4,2907840
H1S1-01-02,1,1674762
H1S1-01-02,1,1674763
H1S1-01-02,3,1674765
H1S1-01-02,5,1674766
H1S1-01-02,5,1674767
H1S1-01-02,3,1674769
H1S1-01-02,1,1674770
H1S1-01-02,3,1674771
H1S1-01-02,5,1674773
H1S1-01-02,3,1696392
H1S1-01-02,3,1675347
H1S1-01-02,2,1696400
H1S1-01-02,2,1696402
H1S1-01-02,3,1696403
H1S1-01-02,3,1696404
H1S1-01-02,3,1696405
H1S1-01-02,3,1696406
H1S1-01-02,4,1696407
H1S1-01-02,3,2907841
H1S1-01-02,3,2907842
H1S1-01-02,4,2907843
H1S1-01-02,4,2907844
H1S1-01-02,3,2907845
H1S1-01-02,3,2907851
H1S1-01-02,3,2907852
H1S1-01-03,2,1674774
H1S1-01-03,3,1674775
H1S1-01-03,3,1674777
H1S1-01-03,3,1696420
H1S1-01-03,2,1696423
H1S1-01-03,2,1696427
H1S1-01-03,2,2907853
H1S1-01-03,3,2907854
H1S1-01-03,3,2907855
H1S1-01-04,3,1674779
H1S1-01-04,1,1674780
H1S1-01-04,3,1674782
H1S1-01-04,3,1674784
H1S1-01-04,5,1674785
H1S1-01-04,3,1696429
H1S1-01-04,3,1696431
H1S1-01-04,4,1696440
H1S1-01-04,3,1696441
H1S1-01-04,3,1696444
H1S1-01-04,3,1696447
H1S1-01-04,4,1696448
H1S1-01-04,3,2907856
H1S1-01-04,3,2907857
H1S1-01-04,3,2907858
H1S1-01-04,5,2907859
H1S1-01-04,4,2907868
H1S1-01-04,3,2907869
H1S1-01-04,5,2907870
H1S1-01-04,5,2907871
H1S1-01-05,3,1674787
H1S1-01-05,3,1674788
H1S1-01-05,5,1674789
H1S1-01-05,3,1696451
H1S1-01-05,3,1696454
H1S1-01-05,4,1696457
H1S1-01-06,3,1674790
H1S1-01-06,3,1674791
H1S1-01-06,5,1674792
H1S1-01-06,5,1674793
H1S1-01-06,3,1696459
H1S1-01-06,3,1696460
H1S1-01-06,4,1696462
H1S1-01-06,4,1696465
H1S1-01-06,3,1696490
H1S1-01-06,4,1696491
H1S1-01-06,4,1696492
H1S1-01-06,3,2907864
H1S1-01-06,3,2907865
H1S1-01-06,3,2907866
H1S1-01-06,5,2907867
H1S1-01-07,3,1696483
H1S1-01-07,3,1696487
H1S1-01-07,4,1696489
H1S1-01-07,3,2907872
H1S1-01-07,4,2907873
H1S1-01-07,5,2907874
H1S1-01-08,3,1674801
H1S1-01-08,1,1674802
H1S1-01-08,3,1674803
H1S1-01-08,3,1674804
H1S1-01-08,3,1674805
H1S1-01-08,3,1674806
H1S1-01-08,3,1674807
H1S1-01-08,5,1674808
H1S1-01-08,3,1674809
H1S1-01-08,3,1674810
H1S1-01-08,3,1696468
H1S1-01-08,3,1696470
H1S1-01-08,3,1696472
H1S1-01-08,3,2907875
H1S1-01-08,3,2907876
H1S1-01-08,3,2907877
H1S1-01-08,5,2907878
H1S1-01-08,3,2907879
H1S1-01-08,3,2907880
H1S1-01-09,3,1696475
H1S1-01-09,3,1696478
H1S1-01-09,4,1696481
H1S1-01-09,3,2907881
H1S1-01-05,5,2907861
H1S1-01-05,3,2907862
H1S1-01-05,5,2907863
H1S1-01-09,3,2907882
H1S1-01-09,3,2907883
H1S1-02-01,2,1674873
H1S1-02-01,1,1674874
H1S1-02-01,3,1674875
H1S1-02-01,5,1674876
H1S1-02-01,2,1728360
H1S1-02-01,3,1728361
H1S1-02-01,3,1728362
H1S1-02-01,3,2908598
H1S1-02-01,3,2908600
H1S1-02-01,3,2908601
H1S1-02-01,3,2908603
H1S1-02-02,3,1674877
H1S1-02-02,1,1674878
H1S1-02-02,3,1674879
H1S1-02-02,3,1674880
H1S1-02-02,3,1728363
H1S1-02-02,3,1728364
H1S1-02-02,4,1728365
H1S1-02-02,3,2908605
H1S1-02-02,3,2908606
H1S1-02-02,3,2908608
H1S1-02-03,3,1674881
H1S1-02-03,3,1674882
H1S1-02-03,3,1728366
H1S1-02-03,3,1728367
H1S1-02-03,3,1728368
H1S1-02-03,3,1728369
H1S1-02-03,3,1728370
H1S1-02-03,3,1728371
H1S1-02-03,3,2908592
H1S1-02-03,3,2908593
H1S1-02-03,3,2908595
H1S1-02-03,4,2908596
H1S1-02-04,3,1674883
H1S1-02-04,3,1674884
H1S1-02-04,5,1674885
H1S1-02-04,3,1728372
H1S1-02-04,3,1728373
H1S1-02-04,4,1728374
H1S1-02-04,3,2908610
H1S1-02-04,3,2908612
H1S1-02-04,3,2908614
H1S1-02-05,3,1674886
H1S1-02-05,3,1674887
H1S1-02-05,3,1674888
H1S1-02-05,3,1728375
H1S1-02-05,3,1728376
H1S1-02-05,3,1728377
H1S1-02-05,3,2908616
H1S1-02-05,3,2908617
H1S1-02-05,3,2908619
H1S1-02-06,3,1674889
H1S1-02-06,1,1674890
H1S1-02-06,3,1674891
H1S1-02-06,3,1674892
H1S1-02-06,1,1674893
H1S1-02-06,3,1674894
H1S1-02-06,3,1674895
H1S1-02-06,3,1728378
H1S1-02-06,2,1728379
H1S1-02-06,3,1728380
H1S1-02-06,3,1728381
H1S1-02-06,2,1728382
H1S1-02-06,3,1728383
H1S1-02-06,2,2908629
H1S1-02-06,3,2908631
H1S1-02-06,3,2908633
H1S1-02-06,3,2908635
H1S1-02-07,3,1674896
H1S1-02-07,3,1674897
H1S1-02-07,3,1674898
H1S1-02-07,5,1674899
H1S1-02-07,3,1728384
H1S1-02-07,3,1728385
H1S1-02-07,4,1728386
H1S1-02-07,3,2908639
H1S1-02-08,3,1674900
H1S1-02-08,3,1674901
H1S1-02-08,5,1674902
H1S1-02-08,3,1728387
H1S1-02-08,4,1728388
H1S1-02-08,4,1728389
H1S1-02-08,4,2908640
H1S1-02-08,5,2908642
H1S1-02-09,3,1674903
H1S1-02-09,3,1674904
H1S1-02-09,3,1674905
H1S1-02-09,3,1728390
H1S1-02-09,2,1728391
H1S1-02-09,4,1728392
H1S1-02-09,2,2908648
HSU1-01-01,2,2492296
H1S1-02-09,3,2908653
H1S1-02-10,3,1674906
H1S1-02-10,3,1674907
H1S1-02-10,3,1674908
H1S1-02-10,3,1728393
H1S1-02-10,4,1728394
H1S1-02-10,4,1728395
H1S1-02-10,3,2908658
H1S1-02-10,1,2908659
H1S1-02-10,3,2908661
H1S1-02-11,3,1674913
H1S1-02-11,1,1674914
H1S1-02-11,3,1674915
H1S1-02-11,3,1674916
H1S1-02-11,5,1674917
H1S1-02-11,3,1728396
H1S1-02-11,3,1728397
H1S1-02-11,3,1728398
H1S1-02-11,3,2908668
H1S1-02-12,3,1674918
H1S1-02-12,3,1674919
H1S1-02-12,5,1674920
H1S1-02-12,3,1728399
H1S1-02-12,4,1728400
H1S1-02-12,4,1728401
H1S1-02-12,3,2908669
H1S1-02-12,3,2908674
H1S1-02-13,3,1674909
H1S1-02-13,3,1674910
H1S1-02-13,3,1674911
H1S1-02-13,5,1674912
H1S1-02-13,4,1728402
H1S1-02-13,4,1728403
H1S1-02-13,4,1728404
H1S1-02-13,3,2908663
H1S1-02-13,3,2908665
H1S1-02-13,5,2908666
H1S1-02-14,3,1674921
HSU1-01-01,5,3367897
HSU1-01-03,3,3367905
H1S1-02-14,3,1674923
H1S1-02-14,3,1674924
H1S1-02-14,3,1674925
HSU1-01-04,3,2927346
H1S1-02-14,5,1674928
H1S1-02-14,3,1728405
H1S1-02-14,3,1728406
H1S1-02-14,4,1728407
H1S1-02-14,3,2908621
H1S1-02-14,3,2908623
H1S1-02-14,3,2908625
H1S1-03-01,1,1674929
H1S1-03-01,3,1674931
H1S1-03-01,3,1674933
H1S1-03-01,3,1674934
H1S1-03-01,1,1873020
HSU1-01-05,3,2927349
HSU1-01-05,5,3367914
H1S1-03-01,3,1873024
H1S1-03-01,2,1873026
HSU1-01-07,3,2927368
HSU1-01-08,1,3367936
HSU1-01-10,5,2740149
HSU1-01-10,3,3367951
HSU1-01-11,3,2927401
HSU1-01-12,3,2522543
H1S1-03-01,3,1873041
H1S1-03-01,2,1873042
H1S1-03-01,2,1873043
H1S1-03-01,3,1873044
H1S1-03-01,2,1873045
HSU1-01-12,3,3367960
HSU1-01-13,3,3367963
H1S1-03-01,3,1873050
H1S1-03-01,3,2908729
H1S1-03-01,2,2908731
H1S1-03-01,3,2908733
H1S1-03-01,3,2908735
H1S1-03-01,3,2908737
H1S1-03-01,3,2908739
H1S1-03-01,5,2908741
H1S1-03-02,3,1674935
H1S1-03-02,3,1674936
H1S1-03-02,3,1674937
H1S1-03-02,3,1873056
HSU1-01-14,3,2740570
HSU1-02-01,3,2524423
HSU1-02-01,3,2927610
H1S1-03-02,3,1873069
H1S1-03-02,3,2908743
H1S1-03-02,3,2908745
H1S1-03-02,3,2908747
H1S1-03-03,3,1674938
H1S1-03-03,1,1674939
H1S1-03-03,3,1674941
H1S1-03-03,5,1674942
H1S1-03-03,3,1873051
HSU1-01-01,3,2492298
HSU1-01-02,3,2740117
HSU1-01-03,5,3367906
H1S1-03-03,3,1873055
H1S1-03-03,3,2908749
H1S1-03-03,3,2908751
H1S1-03-03,3,2908753
H1S1-03-03,3,2908755
H1S1-03-04,3,1674943
H1S1-03-04,1,1674944
H1S1-03-04,3,1674946
H1S1-03-04,3,1873072
H1S1-03-04,3,1873075
H1S1-03-04,3,1873097
H1S1-03-04,3,1873098
H1S1-03-04,3,1873099
H1S1-03-04,3,1873100
H1S1-03-04,4,1873101
H1S1-03-04,3,2908757
H1S1-03-04,3,2908758
H1S1-03-04,5,2908760
H1S1-03-05,3,1674947
H1S1-03-05,3,1674949
H1S1-03-05,5,1674950
H1S1-03-05,3,1873136
H1S1-03-05,3,1873137
H1S1-03-05,4,1873138
H1S1-03-05,3,2908771
H1S1-03-05,3,2908773
H1S1-03-06,1,1674952
H1S1-03-06,1,1674953
H1S1-03-06,3,1674954
H1S1-03-06,3,1674955
H1S1-03-06,5,1674956
H1S1-03-06,1,1873102
HSU1-01-04,2,3367907
HSU1-01-05,2,2927350
HSU1-01-05,1,3367916
HSU1-01-07,3,2927375
H1S1-03-06,1,1682049
H1S1-03-06,1,2908762
H1S1-03-06,1,2908763
H1S1-03-06,1,2908766
H1S1-03-06,3,2908768
H1S1-03-07,3,1674957
H1S1-03-07,3,1674959
H1S1-03-07,3,1873139
H1S1-03-07,3,1873140
H1S1-03-07,3,1873141
H1S1-03-07,3,2908769
H1S1-03-08,3,1674960
H1S1-03-08,3,1674961
H1S1-03-08,3,1674963
H1S1-03-08,3,1873142
H1S1-03-08,3,1873143
H1S1-03-08,4,1873144
H1S1-03-09,3,1674964
H1S1-03-09,3,1674965
H1S1-03-09,5,1674966
H1S1-03-09,4,1873156
H1S1-03-09,4,1873157
H1S1-03-09,4,1873158
H1S1-03-09,4,2908787
H1S1-03-09,4,2908789
H1S1-03-09,4,2908791
H1S1-03-10,3,1873152
H1S1-03-10,3,1873154
H1S1-03-10,4,1873155
H1S1-03-10,3,2908774
H1S1-03-10,3,2908776
H1S1-03-10,3,2908777
H1S1-03-10,5,2908778
H1S1-03-11,3,1674971
H1S1-03-11,3,1674972
H1S1-03-11,3,1674973
H1S1-03-11,5,1674974
H1S1-03-11,3,1873145
H1S1-03-11,3,1873146
H1S1-03-11,3,1873147
H1S1-03-11,3,1873148
H1S1-03-11,3,1873149
H1S1-03-11,4,1873150
H1S1-03-11,4,1873151
H1S1-03-11,3,2908780
H1S1-03-11,3,2908782
H1S1-03-11,3,2908784
H1S1-03-11,5,2908785
H1S1-04-01,1,1675409
H1S1-04-01,1,1675410
H1S1-04-01,1,1873270
H1S1-04-01,2,1873271
H1S1-04-01,2,1873272
H1S1-04-01,2,2909523
H1S1-04-01,3,2909524
H1S1-04-02,1,1675411
H1S1-04-02,1,1675412
H1S1-04-02,3,1675413
H1S1-04-02,3,1675414
H1S1-04-02,1,1675415
H1S1-04-02,3,1675416
H1S1-04-02,5,1675417
H1S1-04-02,3,1873273
H1S1-04-02,1,1873274
H1S1-04-02,2,1873275
H1S1-04-02,3,1873276
H1S1-04-02,3,1873286
H1S1-04-02,3,1873287
H1S1-04-02,3,1873290
H1S1-04-02,4,1873291
H1S1-04-02,3,2909537
H1S1-04-02,3,2909538
H1S1-04-02,3,2909539
H1S1-04-02,5,2909540
H1S1-04-02,1,2909525
H1S1-04-02,1,2909526
H1S1-04-02,1,2909527
H1S1-04-02,2,2909528
H1S1-04-04,3,1873277
H1S1-04-04,2,1873278
H1S1-04-04,3,1873279
H1S1-04-04,4,1873280
H1S1-04-04,3,2909529
H1S1-04-04,3,2909530
H1S1-04-04,3,2909531
H1S1-04-04,5,2909532
H1S1-04-03,2,1675424
H1S1-04-03,3,1675425
H1S1-04-03,3,1675451
H1S1-04-03,3,1675452
H1S1-04-03,5,1675453
H1S1-04-03,3,1873281
HSU1-01-08,3,3367938
HSU1-01-10,2,2927388
H1S1-04-03,3,1873284
H1S1-04-03,3,1873285
H1S1-04-03,2,2909533
H1S1-04-03,2,2909534
H1S1-04-03,3,2909535
H1S1-04-03,3,2909536
H1S1-04-05,3,1675454
H1S1-04-05,1,1675455
H1S1-04-05,3,1675456
H1S1-04-05,3,1675457
H1S1-04-05,5,1675458
H1S1-04-05,3,1675459
H1S1-04-05,3,1675460
H1S1-04-05,3,1675461
H1S1-04-05,3,1675462
H1S1-04-05,5,1675463
H1S1-04-05,3,1873328
H1S1-04-05,3,1873330
H1S1-04-05,3,1873331
H1S1-04-05,4,1873332
H1S1-04-05,2,1873333
H1S1-04-05,3,1873334
H1S1-04-05,4,1873335
H1S1-04-05,3,2909541
H1S1-04-05,3,2909542
H1S1-04-05,3,2909543
H1S1-04-05,3,2909544
H1S1-04-05,4,2909545
H1S1-04-05,5,2909546
H1S1-04-06,3,1675464
H1S1-04-06,3,1675465
H1S1-04-06,3,1675466
H1S1-04-06,3,1675467
H1S1-04-06,3,1873292
H1S1-04-06,3,1873293
H1S1-04-06,3,1873294
H1S1-04-06,3,2909547
H1S1-04-06,3,2909548
H1S1-04-06,3,2909549
H1S1-04-06,3,2909550
H1S1-04-07,3,1675468
H1S1-04-07,3,1675469
H1S1-04-07,5,1675470
H1S1-04-07,5,1675471
H1S1-04-07,3,1873295
H1S1-04-07,2,1873296
H1S1-04-07,3,1873297
H1S1-04-07,3,1873298
H1S1-04-07,2,2909551
H1S1-04-07,3,2909552
H1S1-04-07,4,2909553
H1S1-04-07,4,2909554
H1S1-04-08,1,1675472
H1S1-04-08,1,1675473
H1S1-04-08,3,1675474
H1S1-04-08,3,1675475
H1S1-04-08,3,1873300
H1S1-04-08,3,1873322
H1S1-04-08,3,1873323
H1S1-04-08,4,1873316
H1S1-04-08,1,2909555
H1S1-04-08,3,2909556
H1S1-04-08,3,2909557
H1S1-04-08,5,2909558
H1S1-04-09,1,1675476
H1S1-04-09,3,1675477
H1S1-04-09,5,1675478
H1S1-04-09,2,1675479
H1S1-04-09,3,1675480
H1S1-04-09,5,1675481
H1S1-04-09,2,1873317
H1S1-04-09,2,1873318
H1S1-04-09,3,1873319
H1S1-04-09,3,1873320
H1S1-04-09,4,1873321
H1S1-04-09,3,1873324
H1S1-04-09,3,1873325
H1S1-04-09,3,1873326
H1S1-04-09,3,1873327
H1S1-04-09,2,2909559
H1S1-04-09,3,2909560
H1S1-04-09,3,2909561
H1S1-04-09,3,2909562
H1S1-04-09,3,2909563
H1S1-04-09,3,2909564
H1S1-04-09,4,2909565
H1S1-05-01,1,1675561
H1S1-05-01,1,1675562
H1S1-05-01,3,1675563
H1S1-05-01,3,1675564
H1S1-05-01,1,1876996
H1S1-05-01,1,1876998
H1S1-05-01,3,1877000
H1S1-05-01,2,1877007
H1S1-05-01,3,1877009
H1S1-05-01,1,2909671
H1S1-05-01,1,2909673
H1S1-05-01,3,2909674
H1S1-05-01,5,2909676
H1S1-05-02,1,1675565
H1S1-05-02,1,1675566
H1S1-05-02,3,1675567
H1S1-05-02,3,1675568
H1S1-05-02,3,1675569
H1S1-05-02,1,1877002
H1S1-05-02,3,1877004
H1S1-05-02,3,1877005
H1S1-05-02,3,1877011
H1S1-05-02,3,1877014
H1S1-05-02,3,2909678
H1S1-05-02,3,2909680
H1S1-05-02,5,2909681
H1S1-05-03,3,1675570
H1S1-05-03,3,1675571
H1S1-05-03,3,1675572
H1S1-05-03,5,1675573
H1S1-05-03,4,1877015
H1S1-05-03,4,1877041
H1S1-05-03,4,1877049
H1S1-05-03,4,1877052
H1S1-05-03,3,2909683
H1S1-05-03,3,2909685
H1S1-05-03,3,2909687
H1S1-05-03,4,2909689
H1S1-05-03,3,2909691
H1S1-05-03,3,2909693
H1S1-05-03,3,2909695
H1S1-05-04,3,2005455
H1S1-05-04,3,2005456
H1S1-05-04,4,2005457
H1S1-05-04,3,2909697
H1S1-05-04,3,2909702
H1S1-05-04,4,2909704
H1S1-05-05,2,1675574
H1S1-05-05,3,1675575
H1S1-05-05,3,1675576
H1S1-05-05,3,1675577
H1S1-05-05,5,1675578
H1S1-05-05,1,1675579
H1S1-05-05,1,1675580
H1S1-05-05,3,1675581
H1S1-05-05,5,1675582
H1S1-05-05,3,2005458
H1S1-05-05,2,2005459
H1S1-05-05,3,2005461
H1S1-05-05,3,2005462
H1S1-05-05,3,2005463
H1S1-05-05,3,2005464
H1S1-05-05,3,2005465
H1S1-05-05,4,2005466
H1S1-05-05,4,2005467
H1S1-05-05,3,2005468
H1S1-05-05,3,2005469
H1S1-05-05,3,2005470
H1S1-05-05,2,2909705
H1S1-05-05,2,2909707
H1S1-05-05,3,2909709
H1S1-05-05,3,2909711
H1S1-05-05,3,2909712
HSU1-01-01,2,2740112
H1S1-05-05,4,2909716
H1S1-05-06,3,1675583
H1S1-05-06,1,1675584
H1S1-05-06,3,1675585
H1S1-05-06,3,2005471
H1S1-05-06,3,2005473
H1S1-05-07,2,1675586
H1S1-05-07,3,1675587
H1S1-05-07,3,1675588
H1S1-05-07,3,2005476
H1S1-05-07,3,2005478
H1S1-05-08,3,2005479
H1S1-05-08,3,2005480
H1S1-05-08,3,2005482
H1S1-05-08,3,2005481
H1S1-05-08,3,2005483
H1S1-05-08,2,2005484
H1S1-05-08,3,2005485
H1S1-05-08,4,2005486
H1S1-05-08,1,2909825
H1S1-05-08,3,2909826
H1S1-05-08,3,2909827
H1S1-05-08,5,2909828
H1S1-05-08,3,2909829
H1S1-05-08,3,2909830
H1S1-05-08,3,2909831
H1S1-05-08,3,2909832
H1S1-05-08,1,1675590
H1S1-05-08,3,1675591
H1S1-05-08,3,1675592
H1S1-05-08,5,1675593
H1S1-05-08,3,1675594
H1S1-05-08,3,1675595
H1S1-05-08,3,1675596
H1S1-05-08,3,1675597
H1S1-05-08,5,1675598
H1S1-05-08,2,1675589
H1S1-05-09,3,1675599
H1S1-05-09,3,1675600
H1S1-05-09,3,1675601
H1S1-05-09,3,1675602
H1S1-05-09,5,1675603
H1S1-05-09,5,1675604
H1S1-05-09,3,1675605
H1S1-05-09,3,1675606
H1S1-05-09,3,1675607
H1S1-05-09,3,1675608
H1S1-05-09,3,1675609
H1S1-05-09,1,1675610
H1S1-05-09,3,1675611
H1S1-05-09,3,1675612
H1S1-05-09,3,2005487
H1S1-05-09,3,2005488
H1S1-05-09,3,2005489
H1S1-05-09,3,2005491
H1S1-05-09,3,2005513
H1S1-05-09,2,2005514
H1S1-05-09,3,2005515
H1S1-05-09,3,2005516
H1S1-05-09,3,2005517
H1S1-05-09,3,2005518
H1S1-05-09,3,2909833
H1S1-05-09,3,2909834
H1S1-05-09,3,2909835
H1S1-05-09,3,2909836
H1S1-05-10,3,1675616
H1S1-05-10,3,1675617
H1S1-05-10,3,1675618
H1S1-05-10,5,1675619
H1S1-05-10,4,2005496
H1S1-05-10,3,2005501
H1S1-05-10,4,2005504
H1S1-05-10,3,2909837
H1S1-05-10,3,2909838
H1S1-05-10,3,2909839
H1S1-05-10,3,2909848
H1S1-05-10,3,2909849
H1S1-05-10,3,2909850
H1S1-05-10,3,2909851
H1S1-05-11,3,1675613
H1S1-05-11,3,1675614
H1S1-05-11,5,1675615
H1S1-05-11,3,2005505
H1S1-05-11,3,2005506
H1S1-05-12,3,1675620
H1S1-05-12,3,1675621
H1S1-05-12,3,1675622
H1S1-05-12,3,2005507
H1S1-05-12,3,2909852
H1S1-05-12,3,2909853
H1S1-05-12,3,2909854
H1S1-05-13,3,2005510
H1S1-05-13,3,2005511
H1S1-05-13,3,2005512
H1S1-05-13,3,2909840
H1S1-05-13,3,2909841
H1S1-05-13,3,2909842
H1S1-05-13,3,2909843
H1S1-05-14,3,2005519
H1S1-05-14,3,2005520
H1S1-05-14,3,2005521
H1S1-05-14,3,2909844
H1S1-05-14,3,2909845
H1S1-05-14,3,2909846
H1S1-05-14,4,2909847
H1S1-05-15,3,2005524
H1S1-05-15,4,2005525
H1S1-06-01,3,1675712
H1S1-06-01,3,1675713
H1S1-06-01,3,1675714
H1S1-06-01,3,1675715
H1S1-06-01,2,1675721
H1S1-06-01,1,1675722
H1S1-06-01,3,1675723
H1S1-06-01,3,1675724
H1S1-06-01,5,1675725
H1S1-06-01,2,2028460
H1S1-06-01,3,2028462
H1S1-06-01,3,2028466
H1S1-06-01,3,2028664
H1S1-06-01,3,2028665
H1S1-06-01,3,2028666
H1S1-06-01,2,2909946
H1S1-06-01,3,2909947
H1S1-06-01,3,2909948
H1S1-06-01,3,2909949
H1S1-06-01,2,2909957
H1S1-06-01,2,2909958
H1S1-06-01,3,2909959
H1S1-06-01,2,2909960
H1S1-06-01,2,2909961
H1S1-06-01,3,2909962
H1S1-06-02,3,1675716
H1S1-06-02,3,1675717
H1S1-06-02,3,1675718
H1S1-06-02,3,1675719
H1S1-06-02,5,1675720
H1S1-06-02,3,1675726
H1S1-06-02,3,1675727
H1S1-06-02,3,1675728
H1S1-06-02,3,1675729
H1S1-06-02,3,2028474
H1S1-06-02,3,2028479
H1S1-06-02,3,2028482
H1S1-06-02,3,2909943
H1S1-06-02,3,2909944
H1S1-06-02,3,2909945
H1S1-06-02,3,2909950
H1S1-06-02,3,2909951
H1S1-06-02,3,2909952
H1S1-06-02,3,2909953
H1S1-06-03,1,1675730
H1S1-06-03,1,1675731
H1S1-06-03,3,1675732
H1S1-06-03,3,1675736
H1S1-06-03,5,1675737
H1S1-06-03,3,2028667
H1S1-06-03,3,2028668
H1S1-06-03,3,2028669
H1S1-06-03,4,2028670
H1S1-06-04,3,2028671
H1S1-06-04,3,2028672
H1S1-06-04,3,2028673
H1S1-06-04,3,2909963
H1S1-06-04,4,2909964
H1S1-06-04,4,2909965
H1S1-06-05,3,2028674
H1S1-06-05,2,2028677
H1S1-06-05,3,2028678
H1S1-06-05,3,2028679
H1S1-06-05,3,2028680
H1S1-06-05,3,2028681
H1S1-06-05,3,2028682
H1S1-06-05,3,2028683
H1S1-06-05,3,2028684
H1S1-06-05,3,2028685
H1S1-06-05,4,2028686
H1S1-06-05,4,2028687
H1S1-06-05,4,2028688
H1S1-06-05,2,2909989
H1S1-06-05,3,2909990
H1S1-06-05,3,2909991
H1S1-06-05,3,2909992
H1S1-06-05,2,2909996
H1S1-06-05,3,2909997
H1S1-06-05,3,2909998
H1S1-06-06,2,1675743
H1S1-06-06,1,1675744
H1S1-06-06,3,1675745
H1S1-06-06,5,1675746
H1S1-06-06,5,1675747
H1S1-06-06,3,2028689
H1S1-06-06,3,2028690
H1S1-06-06,4,2061619
H1S1-06-06,4,2061622
H1S1-06-06,3,2909993
H1S1-06-06,3,2909994
H1S1-06-06,5,2909995
H1S1-06-06,3,2909999
H1S1-06-06,3,2910000
H1S1-06-06,5,2910001
H1S1-06-07,4,2061807
H1S1-06-07,3,2061810
H1S1-06-07,3,2061812
H1S1-06-07,4,2061816
H1S1-06-07,3,2910002
H1S1-06-07,3,2910003
H1S1-06-07,5,2910004
H1S1-06-08,3,1675755
H1S1-06-08,3,1675756
H1S1-06-08,3,1675757
H1S1-06-08,3,1675758
H1S1-06-08,5,1675759
H1S1-06-08,3,2061686
H1S1-06-08,4,2061687
H1S1-06-08,3,2910005
H1S1-06-08,4,2910006
H1S1-06-08,3,2910007
H1S1-06-09,3,1675752
H1S1-06-09,3,1675753
H1S1-06-09,3,1675754
H1S1-06-09,3,2061625
H1S1-06-09,3,2061628
H1S1-06-09,3,2910011
H1S1-06-09,3,2910012
H1S1-06-09,3,2910013
H1S1-06-10,3,1675760
H1S1-06-10,1,1675761
H1S1-06-10,3,1675762
H1S1-06-10,3,1675763
H1S1-06-10,3,1675764
H1S1-06-10,5,1675765
H1S1-06-10,3,2061818
H1S1-06-10,3,2061821
H1S1-06-10,3,2061824
H1S1-06-10,4,2061835
H1S1-06-10,4,2061836
H1S1-03-04,4,2005522
H1S1-03-04,4,2005523
H1S1-06-02,3,2028649
H1S1-06-02,3,2028653
H1S1-06-02,3,2028656
H1S1-06-03,4,2028660
H1S1-06-01,3,2028661
H1S1-06-01,3,2028662
H1S1-06-01,3,2028663
H1S1-06-03,1,2909954
H1S1-06-03,3,2909955
H1S1-06-03,4,2909956
H1S1-06-06,3,2061827
H1S1-06-06,3,2061831
H1S1-06-06,3,2061833
H1S1-06-06,3,2061834
H1S1-06-10,4,2061842
H1S1-06-10,1,2910014
H1S1-06-10,3,2910015
H1S1-06-10,3,2910016
H1S1-06-10,3,2910017
H1S1-06-10,4,2910018
H1S1-06-10,3,2910019
H1S1-06-10,3,2910020
H1S1-06-10,3,2910021
H1S1-07-01,2,1675892
H1S1-07-01,3,1675893
H1S1-07-01,3,1675894
H1S1-07-01,3,1675895
H1S1-07-01,3,2062006
M1S1-06-10,1,1610217
M1S1-06-14,2,3629141
H1S1-07-01,3,2062039
H1S1-07-01,3,2910052
H1S1-07-01,3,2910053
H1S1-07-01,3,2910054
H1S1-07-02,3,1675896
H1S1-07-02,3,1675897
H1S1-07-02,5,1675898
H1S1-07-02,3,2062042
H1S1-07-02,3,2062045
H1S1-07-02,3,2062048
H1S1-07-02,3,2062051
H1S1-07-02,3,2910061
H1S1-07-02,3,2910062
H1S1-07-02,3,2910063
H1S1-07-02,5,2910064
H1S1-07-03,3,1675899
H1S1-07-03,3,1675900
H1S1-07-03,3,1675901
H1S1-07-03,3,1675902
H1S1-07-03,3,2062052
H1S1-07-03,3,2062053
H1S1-07-03,3,2062054
H1S1-07-03,3,2062587
H1S1-07-03,3,2062590
H1S1-07-03,3,2910065
H1S1-07-03,3,2910066
H1S1-07-03,3,2910067
H1S1-07-04,3,1675903
H1S1-07-04,3,1675904
H1S1-07-04,3,2062055
H1S1-07-04,3,2062057
H1S1-07-04,3,2062062
H1S1-07-04,3,2910068
H1S1-07-04,3,2910069
H1S1-07-04,4,2910070
H1S1-07-05,3,1675905
H1S1-07-05,3,1675906
H1S1-07-05,3,1675907
H1S1-07-05,5,1675908
H1S1-07-05,2,2062067
H1S1-07-05,2,2062070
H1S1-07-05,3,2062074
H1S1-07-05,3,2062075
H1S1-07-05,3,2910055
H1S1-07-05,3,2910056
H1S1-07-05,3,2910057
H1S1-07-06,3,1675909
H1S1-07-06,3,1675910
H1S1-07-06,3,1675911
H1S1-07-06,5,1675912
H1S1-07-06,4,2062077
H1S1-07-06,3,2062088
H1S1-07-06,3,2062089
H1S1-07-06,4,2062090
H1S1-07-06,3,2910058
H1S1-07-06,3,2910059
H1S1-07-06,3,2910060
H1S1-07-07,3,1675913
H1S1-07-07,3,1675914
H1S1-07-07,3,1675915
H1S1-07-07,3,1675916
H1S1-07-07,3,2062091
H1S1-07-07,3,2062092
H1S1-07-07,3,2062093
H1S1-07-07,3,2062094
H1S1-07-07,3,2910076
H1S1-07-07,3,2910077
H1S1-07-07,3,2910078
H1S1-07-07,3,2910079
H1S1-07-07,3,2910080
H1S1-07-07,4,2910081
H1S1-07-08,3,2062095
H1S1-07-08,3,2062096
H1S1-07-08,3,2062097
H1S1-07-08,3,2910086
H1S1-07-08,3,2910087
H1S1-07-08,3,2910088
H1S1-07-09,3,1675920
H1S1-07-09,1,1675921
H1S1-07-09,3,1675922
H1S1-07-09,3,1675923
H1S1-07-09,3,1675924
H1S1-07-09,3,2062157
H1S1-07-09,2,2062159
H1S1-07-09,3,2062162
H1S1-07-09,3,2062164
H1S1-07-09,2,2910082
H1S1-07-09,3,2910083
H1S1-07-09,3,2910084
H1S1-07-09,3,2910085
H1S1-07-10,3,1675925
H1S1-07-10,1,1675926
H1S1-07-10,3,1675927
H1S1-07-10,3,1675928
H1S1-07-10,5,1676048
H1S1-07-10,1,2062169
H1S1-07-10,3,2062170
H1S1-07-10,3,2062171
H1S1-07-10,3,2062172
H1S1-07-10,3,2062173
H1S1-07-10,3,2062174
H1S1-07-10,3,2910089
H1S1-07-10,1,2910090
H1S1-07-10,1,2910091
H1S1-07-10,2,2910092
H1S1-07-10,3,2910093
H1S1-07-10,4,2910094
H1S1-07-10,4,2910095
H1S1-07-11,3,1676049
H1S1-07-11,3,1676050
H1S1-07-11,3,1676051
H1S1-07-11,5,1676052
H1S1-07-11,3,2910071
H1S1-07-11,3,2910072
H1S1-07-11,3,2910073
H1S1-07-11,3,2910074
H1S1-07-11,3,2910075
H1S1-07-12,3,1676053
H1S1-07-12,1,1676054
H1S1-07-12,3,1676055
H1S1-07-12,3,1676056
H1S1-07-12,3,2062175
H1S1-07-12,3,2062179
H1S1-07-12,3,2062185
H1S1-07-12,2,2910260
H1S1-07-12,3,2910261
H1S1-07-12,3,2910262
H1S1-07-13,3,1676057
H1S1-07-13,3,1676058
H1S1-07-13,3,1676059
H1S1-07-13,3,2062186
H1S1-07-13,3,2062187
H1S1-07-13,3,2062188
H1S1-07-13,3,2062189
H1S1-07-13,3,2910263
H1S1-07-13,3,2910264
H1S1-07-13,3,2910265
H1S1-07-14,3,1676060
H1S1-07-14,3,1676061
H1S1-07-14,3,2062219
H1S1-07-14,4,2062222
H1S1-07-14,3,2910266
H1S1-07-14,3,2910267
H1S1-07-14,3,2910268
H1S1-07-15,3,1676062
H1S1-07-15,3,1676063
H1S1-07-15,3,1676064
H1S1-07-15,2,2062190
H1S1-07-15,2,2062191
H1S1-07-15,3,2062192
H1S1-07-15,2,2910269
H1S1-07-15,3,2910270
H1S1-07-15,3,2910271
H1S1-07-16,3,1676065
H1S1-07-16,3,1676066
H1S1-07-16,3,1676067
H1S1-07-16,3,2062193
H1S1-07-16,3,2062194
H1S1-07-16,3,2062195
H1S1-07-16,3,2910272
H1S1-07-16,3,2910273
H1S1-07-16,3,2910274
H1S1-07-17,3,2062196
H1S1-07-17,2,2062197
H1S1-07-17,3,2062198
H1S1-07-18,3,2062199
H1S1-07-18,3,2062200
H1S1-07-18,3,2062201
H1S1-07-18,3,2062224
H1S1-07-18,3,2062584
H1S1-07-18,1,2910275
H1S1-07-18,1,2910276
H1S1-07-18,2,2910277
H1S1-07-18,2,2910278
H1S1-07-19,3,2062204
H1S1-07-19,3,2062205
H1S1-07-19,4,2062207
H1S1-07-19,1,2910279
H1S1-07-19,2,2910280
H1S1-07-19,2,2910281
H1S1-07-19,3,2910282
H1S1-07-21,3,2062208
HSU1-01-01,1,2740114
H1S1-07-20,3,2910283
H1S1-07-20,2,2910284
HSU1-01-02,3,2740119
H1S1-08-01,3,1676121
H1S1-08-01,3,1676122
H1S1-08-01,5,1676207
H1S1-08-01,3,1676208
H1S1-08-01,1,1676209
H1S1-08-01,3,1676210
H1S1-08-01,3,1676211
H1S1-08-01,3,1676212
H1S1-08-02,3,1676213
H1S1-08-02,3,1676214
H1S1-08-02,3,1676215
H1S1-08-02,3,1676216
H1S1-08-02,3,2091202
H1S1-08-02,3,2091203
H1S1-08-02,3,2091211
H1S1-08-02,3,2091204
H1S1-08-02,3,2091207
H1S1-08-02,3,2091209
H1S1-08-02,3,2091210
H1S1-08-02,3,2091212
H1S1-08-02,3,2910322
H1S1-08-02,3,2910323
H1S1-08-02,3,2910324
H1S1-08-03,3,1676217
H1S1-08-03,3,1676218
H1S1-08-03,3,1676219
H1S1-08-03,3,1676220
H1S1-08-03,3,2091213
H1S1-08-03,3,2091214
H1S1-08-03,3,2091215
H1S1-08-03,3,2091216
H1S1-08-03,3,2910328
H1S1-08-03,3,2910329
H1S1-08-03,3,2910330
H1S1-08-04,3,1676224
H1S1-08-04,1,1676225
H1S1-08-04,3,1676226
H1S1-08-04,3,1676227
H1S1-08-04,5,1676228
H1S1-08-04,3,2091217
H1S1-08-04,3,2091218
H1S1-08-04,3,2091219
H1S1-08-04,3,2091220
H1S1-08-04,3,2910331
H1S1-08-04,3,2910332
H1S1-08-04,3,2910333
HSU1-01-04,2,2522898
H1S1-08-05,3,2091227
H1S1-08-05,3,2091228
H1S1-08-05,3,2091229
H1S1-08-05,3,2091230
H1S1-08-06,3,2091224
H1S1-08-06,3,2091225
H1S1-08-06,3,2091242
H1S1-08-06,3,2091241
H1S1-08-07,3,2091231
H1S1-08-07,3,2091232
H1S1-08-07,3,2091233
H1S1-08-07,3,2091234
H1S1-08-07,3,2091235
H1S1-08-07,3,2091243
H1S1-08-07,3,2091244
H1S1-08-07,3,2910335
H1S1-08-07,3,2910336
H1S1-08-07,3,2910337
H1S1-08-08,3,1676241
H1S1-08-08,3,1676242
H1S1-08-08,3,1676243
H1S1-08-08,3,1676244
H1S1-08-08,3,1676245
H1S1-08-08,3,1676246
H1S1-08-08,3,1676247
H1S1-08-08,3,1676248
H1S1-08-08,3,1676249
H1S1-08-08,5,1676250
H1S1-08-08,3,2091245
HSU1-01-04,3,3367908
HSU1-01-05,3,2927355
HSU1-01-05,3,3367917
HSU1-01-07,3,3367924
H1S1-08-08,3,2091250
H1S1-08-08,3,2091251
H1S1-08-08,3,2091252
H1S1-08-08,3,2091253
H1S1-08-08,2,2910338
H1S1-08-08,3,2910339
H1S1-08-08,3,2910340
H1S1-08-08,3,2910341
H1S1-08-08,3,2910342
H1S1-08-08,3,2910343
H1S1-08-08,3,2910344
H1S1-08-08,2,2910345
H1S1-08-08,2,2910346
H1S1-08-08,2,2910347
H1S1-08-09,3,1676251
H1S1-08-09,3,1676252
H1S1-08-09,3,1676253
H1S1-08-09,3,2091254
H1S1-08-09,3,2091255
H1S1-08-09,3,2091256
H1S1-08-10,2,1676575
H1S1-08-10,3,1676576
H1S1-08-10,3,1676577
H1S1-08-10,3,1676578
H1S1-08-10,3,1676579
H1S1-08-10,2,2091257
HSU1-01-09,3,2927384
HSU1-01-10,2,2927392
HSU1-01-11,2,2522534
HSU1-01-11,3,2927407
HSU1-01-12,2,2740157
HSU1-01-12,3,3367961
H1S1-08-10,3,2091266
H1S1-08-10,3,2091267
H1S1-08-10,2,2910374
H1S1-08-10,2,2910375
H1S1-08-10,2,2910376
H1S1-08-10,3,2910377
HSU1-01-13,1,3367964
H1S1-08-11,3,1676580
H1S1-08-11,3,1676581
H1S1-08-11,5,1676582
H1S1-08-11,3,2091269
HSU1-01-14,4,2740573
H1S1-08-11,3,2091287
H1S1-08-11,3,2910380
H1S1-08-11,3,2910381
H1S1-08-11,3,2910382
H1S1-08-11,3,2910383
H1S1-08-12,3,1676583
H1S1-08-12,1,1676584
H1S1-08-12,3,1676585
H1S1-08-12,3,1676933
H1S1-08-12,3,2091288
H1S1-08-12,3,2091289
H1S1-08-12,3,2091291
H1S1-08-12,3,2091293
H1S1-08-12,3,2091295
H1S1-08-12,3,2091297
H1S1-08-12,3,2091301
H1S1-08-12,3,2091303
H1S1-08-12,1,2910390
H1S1-08-12,3,2910391
H1S1-08-12,3,2910392
H1S1-08-13,3,1676572
H1S1-08-13,3,1676573
H1S1-08-13,3,1676574
H1S1-08-13,3,1676956
H1S1-08-13,1,1676957
H1S1-08-13,3,1676958
H1S1-08-13,5,1676959
H1S1-08-13,3,1676960
H1S1-08-13,1,1676961
H1S1-08-13,3,1676962
H1S1-08-13,5,1676963
H1S1-08-13,3,2091374
H1S1-08-13,2,2091377
H1S1-07-18,3,2910285
H1S1-08-05,4,2910334
H1S1-08-13,3,2091380
H1S1-08-13,3,2091381
H1S1-08-13,3,2091417
H1S1-08-13,1,2091419
H1S1-08-13,3,2091421
H1S1-08-13,3,2091423
H1S1-08-13,1,2910384
H1S1-08-13,1,2910385
H1S1-08-13,1,2910386
H1S1-08-13,3,2910393
H1S1-08-13,3,2910394
H1S1-08-13,3,2910395
H1S1-08-14,3,1676947
H1S1-08-14,3,1676948
H1S1-08-14,3,1676949
H1S1-08-14,5,1676950
H1S1-08-14,3,2091304
H1S1-08-14,3,2091305
H1S1-08-14,4,2091306
H1S1-08-14,4,2091307
H1S1-08-14,3,2910396
H1S1-08-14,4,2910397
H1S1-08-14,3,2910398
HSU1-01-01,3,2740115
H1S1-08-16,4,1676938
H1S1-08-16,5,1676939
H1S1-08-16,5,1676940
H1S1-08-16,3,1676941
H1S1-08-16,3,1676942
H1S1-08-16,5,1676943
H1S1-08-16,3,1676944
H1S1-08-16,3,1676945
H1S1-08-16,5,1676946
H1S1-08-16,3,1676951
H1S1-08-16,3,1676952
H1S1-08-16,5,1676953
H1S1-08-16,3,2091308
H1S1-08-16,3,2091309
H1S1-08-16,3,2091310
H1S1-08-16,3,2091312
H1S1-08-16,4,2091318
H1S1-08-16,3,2091367
H1S1-08-16,3,2091370
H1S1-08-17,3,1676934
H1S1-08-17,3,1676935
H1S1-08-17,3,1676936
H1S1-08-17,3,1676937
H1S1-08-17,3,2091382
H1S1-08-17,3,2091383
H1S1-08-17,4,2091384
H1S1-08-17,4,2091385
H1S1-08-15,3,1676954
H1S1-08-15,3,1676955
H1S1-08-15,3,2091559
H1S1-08-15,3,2091562
H1S1-08-15,4,2091565
H1S1-08-15,3,2910400
H1S1-08-15,3,2910401
H1S1-08-15,3,2910402
H1S1-08-18,3,1676964
H1S1-08-18,5,1676965
H1S1-08-19,3,1676966
H1S1-08-19,3,1676967
H1S1-08-19,3,1676968
H1S1-08-19,1,2910387
H1S1-08-19,3,2910388
H1S1-08-19,3,2910389
H1S1-08-20,1,1676969
H1S1-08-20,1,1676970
H1S1-08-20,3,1676971
H1S1-08-20,3,1676972
H1S1-08-20,3,1676973
H1S1-08-20,3,1676974
H1S1-08-20,3,1676975
H1S1-08-20,2,2091387
H1S1-08-20,3,2091388
H1S1-08-20,4,2091389
H1S1-08-20,1,2910403
H1S1-08-20,3,2910404
H1S1-08-20,3,2910405
H1S1-08-20,3,2910406
H1S1-08-21,3,1676976
H1S1-08-21,3,1676977
H1S1-08-21,5,1676978
H1S1-08-21,5,1676979
H1S1-08-21,3,2091392
H1S1-08-21,3,2091395
H1S1-08-21,3,2091397
H1S1-08-21,3,2091399
H1S1-08-21,3,2910407
H1S1-08-21,3,2910408
H1S1-08-21,3,2910409
H1S1-08-22,3,1676980
H1S1-08-22,3,1676981
H1S1-08-22,5,1676982
H1S1-08-22,3,2091568
H1S1-08-22,3,2091571
H1S1-08-22,3,2091573
H1S1-08-23,3,2091402
H1S1-08-23,3,2091404
H1S1-08-23,3,2091411
H1S1-08-23,4,2091415
H1S1-08-24,3,1676990
H1S1-08-24,3,1676991
H1S1-08-24,3,1676992
H1S1-08-24,3,1676993
H1S1-08-24,3,1676994
H1S1-08-24,3,1676995
H1S1-08-24,3,1676996
H1S1-08-24,3,1676997
H1S1-08-24,3,1676998
H1S1-08-24,3,1676999
H1S1-08-24,4,2091546
H1S1-08-24,3,2091550
H1S1-08-24,4,2091553
H1S1-08-24,4,2091556
H1S1-08-24,3,2910414
H1S1-08-24,3,2910415
H1S1-08-24,2,2910416
H1S1-08-24,2,2910417
H1S1-08-24,3,2910418
H1S1-08-24,2,2910419
H1S1-08-24,4,2910420
H1S1-08-25,4,1676983
H1S1-08-25,3,1676984
H1S1-08-25,3,1676985
H1S1-08-25,4,2091426
H1S1-08-25,2,2091430
H1S1-08-25,3,2091433
H1S1-08-25,4,2091544
H1S1-08-25,3,2910410
H1S1-08-25,3,2910412
H1S1-08-25,3,2910413
H1S1-09-01,3,1677059
H1S1-09-01,3,1677060
H1S1-09-01,3,1677061
H1S1-09-01,3,2091763
H1S1-09-01,3,2091766
H1S1-09-01,3,2910457
H1S1-09-01,3,2910458
H1S1-09-01,4,2910459
H1S1-09-01,5,2910460
H1S1-09-02,2,1677062
H1S1-09-02,1,1677063
H1S1-09-02,3,1677064
H1S1-09-02,5,1677065
H1S1-09-02,2,2091781
H1S1-09-02,2,2091783
H1S1-09-02,3,2091785
H1S1-09-02,3,2091786
H1S1-09-02,2,2910464
H1S1-09-02,2,2910465
H1S1-09-02,4,2910466
H1S1-09-02,3,2910467
H1S1-09-02,3,2910468
H1S1-09-02,4,2910470
H1S1-09-03,2,1677071
H1S1-09-03,1,1677072
H1S1-09-03,3,1677073
HSU1-01-02,3,2740122
H1S1-09-03,3,2091787
H1S1-09-03,3,2091788
H1S1-09-03,3,2091789
H1S1-09-03,4,2091790
H1S1-09-03,2,2910461
H1S1-09-03,3,2910462
H1S1-09-03,4,2910463
H1S1-09-04,2,1677068
H1S1-09-04,3,1677069
H1S1-09-04,3,1677070
H1S1-09-04,3,2091816
H1S1-09-04,3,2091817
H1S1-09-04,4,2091818
H1S1-09-04,3,2910471
H1S1-09-04,3,2910472
H1S1-09-04,4,2910473
H1S1-09-04,2,2910521
H1S1-09-04,2,2910522
H1S1-09-04,2,2910523
H1S1-09-05,3,1677066
H1S1-09-05,3,1677067
H1S1-09-05,3,2091793
H1S1-08-16,3,2910399
H1S1-09-05,3,2091791
H1S1-09-05,3,2091792
H1S1-09-05,4,2091794
H1S1-09-06,3,1677076
H1S1-09-06,3,1677077
H1S1-09-06,3,1677078
H1S1-09-06,3,2910474
H1S1-09-06,3,2910475
H1S1-09-07,2,1677079
H1S1-09-07,1,1677080
H1S1-09-07,3,1677081
H1S1-09-07,3,1677082
H1S1-09-07,3,2091795
H1S1-09-07,2,2091796
H1S1-09-07,3,2091797
H1S1-09-07,3,2091798
H1S1-09-07,1,2910497
H1S1-09-07,1,2910498
H1S1-09-07,2,2910499
H1S1-09-07,3,2910500
H1S1-09-07,3,2910501
H1S1-09-07,3,2910502
H1S1-09-07,3,2910504
H1S1-09-08,3,1677083
H1S1-09-08,3,1677084
H1S1-09-08,3,1677085
H1S1-09-08,3,1677086
H1S1-09-08,3,1677087
H1S1-09-08,3,1677088
H1S1-09-08,5,1677089
H1S1-09-08,3,2091799
H1S1-09-08,3,2091800
H1S1-09-08,3,2091801
H1S1-09-08,4,2091802
H1S1-09-08,3,2091803
H1S1-09-08,3,2091804
H1S1-09-08,4,2910505
H1S1-09-08,3,2910506
H1S1-09-08,3,2910507
H1S1-09-08,3,2910508
H1S1-09-08,3,2910509
H1S1-09-08,4,2910510
H1S1-09-09,1,1677090
H1S1-09-09,1,1677091
H1S1-09-09,3,1677092
H1S1-09-09,3,1677093
H1S1-09-09,5,1677094
H1S1-09-09,1,2091809
H1S1-09-09,3,2091810
H1S1-09-09,3,2091811
H1S1-09-09,3,2910517
H1S1-09-09,1,2910518
H1S1-09-09,3,2910519
H1S1-09-09,5,2910520
H1S1-09-10,3,1677098
H1S1-09-10,3,1677099
H1S1-09-10,3,2091805
H1S1-09-10,3,2091806
H1S1-09-10,3,2091807
H1S1-09-10,3,2910514
H1S1-09-10,3,2910515
H1S1-09-10,3,2910516
H1S1-09-11,1,1677095
H1S1-09-11,3,1677096
H1S1-09-11,3,1677097
H1S1-09-11,1,2091812
H1S1-09-11,2,2091813
H1S1-09-11,2,2091814
H1S1-09-11,3,2091815
H1S1-09-11,2,2910511
H1S1-09-11,2,2910512
H1S1-09-11,3,2910513
H1S1-09-12,3,2091819
H1S1-09-12,3,2091820
H1S1-09-12,4,2091821
H1S1-10-01,3,1677104
H1S1-10-01,3,1677105
H1S1-10-01,3,1677106
H1S1-10-01,3,1677107
H1S1-10-01,3,2668921
H1S1-10-01,3,2668922
H1S1-10-01,3,2668924
H1S1-10-01,3,2668927
H1S1-10-01,3,2910557
H1S1-10-01,3,2910558
H1S1-10-02,3,1677108
H1S1-10-02,3,1677109
H1S1-10-02,3,1677110
H1S1-10-02,3,1677111
H1S1-10-02,3,2668929
H1S1-10-02,2,2668931
H1S1-10-02,3,2668934
H1S1-10-02,3,2668936
H1S1-10-02,3,2668938
H1S1-10-02,2,2910561
H1S1-10-02,3,2910562
H1S1-10-02,3,2910563
H1S1-10-02,3,2910559
H1S1-10-03,3,1677112
H1S1-10-03,3,1677113
H1S1-10-03,3,1677114
H1S1-10-03,3,2668947
H1S1-10-03,3,2668945
H1S1-10-03,3,2668950
H1S1-10-03,3,2668953
H1S1-10-03,3,2910560
H1S1-10-04,3,1677115
H1S1-10-04,3,1677116
H1S1-10-04,3,1677117
H1S1-10-04,3,2670126
H1S1-10-04,3,2670128
H1S1-10-04,3,2670131
H1S1-10-04,3,2910564
H1S1-10-04,3,2910565
H1S1-10-04,3,2910566
H1S1-10-05,3,1677118
H1S1-10-05,3,1677119
H1S1-10-05,3,2670135
H1S1-10-05,3,2670142
H1S1-10-05,3,2670145
H1S1-10-05,4,2670149
H1S1-10-05,3,2910567
H1S1-10-05,3,2910568
H1S1-10-05,3,2910569
H1S1-10-06,3,1677121
H1S1-10-06,3,1677122
H1S1-10-06,5,1677123
H1S1-10-06,3,2670489
H1S1-10-06,3,2670491
H1S1-10-06,3,2670495
H1S1-10-06,3,2910570
H1S1-10-06,3,2910571
H1S1-10-06,3,2910572
H1S1-10-07,3,1677124
H1S1-10-07,3,1677125
H1S1-10-07,5,1677126
H1S1-10-07,3,1677127
H1S1-10-07,3,1677128
H1S1-10-07,3,1677129
H1S1-10-07,3,1677130
H1S1-10-07,3,1677131
H1S1-10-07,3,1677132
H1S1-10-07,1,1677133
H1S1-10-07,3,1677134
H1S1-10-07,3,2684635
H1S1-10-07,3,2684640
H1S1-10-07,3,2684646
H1S1-10-07,3,2684648
H1S1-10-07,3,2684650
H1S1-10-07,4,2684652
H1S1-10-07,3,2685040
H1S1-10-07,3,2685041
H1S1-10-07,3,2685045
H1S1-10-07,4,2685051
H1S1-10-07,2,2910573
H1S1-10-07,2,2910574
H1S1-10-07,3,2910575
H1S1-10-07,3,2910619
H1S1-10-07,3,2910620
H1S1-10-07,3,2910621
H1S1-10-07,3,2910622
H1S1-10-08,3,1677135
H1S1-10-08,1,1677136
H1S1-10-08,3,1677137
H1S1-10-08,3,1677138
H1S1-10-08,3,1677142
H1S1-10-08,3,1677143
H1S1-10-08,3,1677144
H1S1-10-08,3,1677145
H1S1-10-08,3,2670498
H1S1-10-08,1,1988241
H1S1-10-08,3,2670505
H1S1-10-08,3,2684620
H1S1-10-08,1,2910646
H1S1-10-08,2,2910647
H1S1-10-08,2,2910648
H1S1-10-08,5,2910649
H1S1-10-08,3,2910650
H1S1-10-08,2,2910651
H1S1-10-08,3,2910652
H1S1-10-08,3,2910653
H1S1-10-09,3,1677146
H1S1-10-09,3,1677147
H1S1-10-09,3,1677148
H1S1-10-09,5,1677149
H1S1-09-08,3,1677120
H1S1-10-09,3,2684624
H1S1-10-09,3,2684626
H1S1-10-09,3,2684628
H1S1-10-09,3,2910654
H1S1-10-09,3,2910655
H1S1-10-09,4,2910656
H1S1-10-09,4,2910657
H1S1-10-10,3,1677139
H1S1-10-10,3,1677140
H1S1-10-10,3,1677141
H1S1-10-10,3,2685029
H1S1-10-10,3,2685033
H1S1-10-10,3,2685036
H1S1-10-10,4,2685038
H1S1-10-10,3,2910661
H1S1-10-10,3,2910662
H1S1-10-10,3,2910663
H1S1-10-10,3,2910667
H1S1-10-11,3,1677150
H1S1-10-11,1,1677151
H1S1-10-11,3,1677152
H1S1-10-11,3,1677153
H1S1-10-11,3,2684654
H1S1-10-11,3,2684655
H1S1-10-11,2,2910668
H1S1-10-11,2,2910669
H1S1-10-11,3,2910670
H1S1-10-11,3,2910671
H1S1-10-11,3,2910672
HSU1-01-01,2,2927318
HSU1-01-02,3,2927334
H1S1-10-12,3,1677154
H1S1-10-12,3,1677155
H1S1-10-12,3,1677156
H1S1-10-12,5,1677157
H1S1-10-12,3,2684657
H1S1-10-12,4,2684659
H1S1-10-12,3,2685015
H1S1-10-12,3,2685017
H1S1-10-12,4,2685020
H1S1-10-12,4,2685027
H1S1-10-12,3,2910679
H1S1-10-12,3,2910680
H1S1-10-12,3,2910681
H1S1-10-12,4,2910682
H1S1-10-13,2,1677158
H1S1-10-13,3,1677159
H1S1-10-13,3,1677160
H1S1-10-13,5,1677161
H1S1-10-13,2,2684660
H1S1-10-13,2,2684662
H1S1-10-13,3,2684664
H1S1-10-13,3,2684666
H1S1-10-13,2,2910675
H1S1-10-13,3,2910676
H1S1-10-13,3,2910677
H1S1-10-13,3,2910678
H1S1-10-14,3,2685002
H1S1-10-14,3,2685006
H1S1-10-14,3,2685009
H1S1-10-14,3,2910683
H1S1-10-14,3,2910684
H1S1-10-14,3,2910685
H1S1-10-15,3,2684629
H1S1-10-15,4,2684631
H1S1-10-15,3,2910658
H1S1-10-15,3,2910659
H1S1-10-15,3,2910660
H1S1-10-16,3,1677162
H1S1-10-16,3,1677163
H1S1-10-16,3,1677164
H1S1-10-16,3,1677101
H1S1-10-16,3,1677102
H1S1-10-16,3,1677103
H1S1-10-16,3,2910623
H1S1-10-16,3,2910624
H1S1-10-16,3,2910625
H1S1-11-01,3,1677223
H1S1-11-01,3,1677224
H1S1-11-01,3,1677225
H1S1-11-01,5,1677226
H1S1-11-01,3,2720798
H1S1-11-01,3,2720799
H1S1-11-01,3,2720800
H1S1-11-01,3,2910734
H1S1-11-01,3,2910735
H1S1-11-01,3,2910736
H1S1-11-01,3,2910737
H1S1-11-01,3,2910738
H1S1-11-01,3,2910739
H1S1-11-01,3,2720815
H1S1-11-01,3,2720818
H1S1-11-01,3,2910729
H1S1-11-01,1,2910730
H1S1-11-01,2,2910731
H1S1-11-02,3,1677227
H1S1-11-02,1,1677228
H1S1-11-02,3,1677229
H1S1-11-02,3,2720809
H1S1-11-02,3,2720812
H1S1-11-02,3,2910733
H1S1-11-03,3,1677234
H1S1-11-03,3,1677235
H1S1-11-03,5,1677236
H1S1-11-03,3,2910754
H1S1-11-03,3,2910755
H1S1-11-03,3,2910756
H1S1-11-03,3,2720820
H1S1-11-03,4,2720822
H1S1-11-04,3,1677230
H1S1-11-04,1,1677231
H1S1-11-04,3,1677232
H1S1-11-04,3,1677233
H1S1-11-04,3,2720825
H1S1-11-04,3,2720828
H1S1-11-04,3,2720833
H1S1-11-04,3,2720834
H1S1-11-04,3,2910751
H1S1-11-05,3,1677237
H1S1-11-05,3,1677238
H1S1-11-05,3,1677239
H1S1-11-05,3,1677240
H1S1-11-05,5,1677243
H1S1-11-05,3,2721388
H1S1-11-05,2,2720846
H1S1-11-05,3,2721381
H1S1-11-05,4,2720847
H1S1-11-05,2,2720848
H1S1-11-05,2,2720849
H1S1-11-05,3,2720850
H1S1-11-05,4,2720851
H1S1-11-05,2,2910740
H1S1-11-05,3,2910741
H1S1-11-05,3,2910742
H1S1-11-05,2,2910743
H1S1-11-05,2,2910744
H1S1-11-05,2,2910745
H1S1-11-05,3,2910746
H1S1-11-06,3,1677244
H1S1-11-06,3,1677245
H1S1-11-06,3,1677246
H1S1-11-06,5,1677247
H1S1-11-06,3,2720852
H1S1-11-06,2,2720853
H1S1-11-06,2,2720854
H1S1-11-06,3,2720855
H1S1-11-06,3,2910747
H1S1-11-06,2,2910748
H1S1-11-06,3,2910749
H1S1-11-07,3,1677248
H1S1-11-07,3,1677249
H1S1-11-07,3,2720835
H1S1-11-07,3,2720837
H1S1-11-07,3,2720840
H1S1-11-07,3,2720842
H1S1-11-08,3,1677263
H1S1-11-08,3,1677264
H1S1-11-08,3,1677265
H1S1-11-08,3,2720856
H1S1-11-08,3,2720857
H1S1-11-08,3,2720858
H1S1-11-08,3,2720859
H1S1-11-08,3,2910757
H1S1-11-08,3,2910758
H1S1-11-08,3,2910759
H1S1-11-09,3,1677257
H1S1-11-09,3,1677258
H1S1-11-09,5,1677259
H1S1-11-09,3,2721397
H1S1-11-09,3,2721407
H1S1-11-09,3,2721410
H1S1-11-09,4,2721518
H1S1-11-09,3,2910760
H1S1-11-09,3,2910762
H1S1-11-11,3,1677266
H1S1-11-11,1,1677267
H1S1-11-11,3,1677268
H1S1-11-11,3,2721524
H1S1-11-11,3,2721525
H1S1-11-11,3,2721526
H1S1-11-11,3,2721527
H1S1-11-11,3,2910797
H1S1-10-12,3,2910673
H1S1-10-12,5,2910674
H1S1-11-14,3,2910761
H1S1-11-11,3,2910798
H1S1-11-11,3,2910799
H1S1-11-11,2,2910791
H1S1-11-11,2,2910795
H1S1-11-12,2,1677274
H1S1-11-12,1,1677275
H1S1-11-12,3,1677276
H1S1-11-12,5,1677277
H1S1-11-12,2,2721528
H1S1-11-12,3,2721531
H1S1-11-12,3,2721532
H1S1-11-12,3,2721534
H1S1-11-12,3,2910800
H1S1-11-12,3,2910801
H1S1-11-12,4,2910802
H1S1-11-12,1,2910790
H1S1-11-12,3,2910793
H1S1-11-13,3,1677282
H1S1-11-13,3,1677283
H1S1-11-13,3,1677284
H1S1-11-13,2,2721576
H1S1-11-13,3,2721577
H1S1-11-13,3,2721578
H1S1-11-13,3,2721579
HSU1-01-01,1,2927320
HSU1-01-02,3,3367898
HSU1-01-04,3,2522899
H1S1-11-13,2,2910792
H1S1-11-13,3,2910794
H1S1-11-13,3,2910796
H1S1-11-14,3,1677260
H1S1-11-14,3,1677261
H1S1-11-14,5,1677262
H1S1-11-14,3,1677269
H1S1-11-14,3,1677270
H1S1-11-14,3,1677271
H1S1-11-14,3,1677272
H1S1-11-14,5,1677273
H1S1-11-14,3,2721584
H1S1-11-14,2,2721580
H1S1-11-14,3,2721581
H1S1-11-14,4,2721582
H1S1-11-14,3,2721610
H1S1-11-14,3,2721613
H1S1-11-14,3,2721616
H1S1-11-14,4,2721619
H1S1-11-10,1,1677285
H1S1-11-10,1,1677286
H1S1-11-10,3,1677287
H1S1-11-10,3,1677288
H1S1-11-10,3,2721583
H1S1-11-10,3,2721585
H1S1-11-10,3,2721586
H1S1-11-10,4,2721587
H1S1-11-15,3,1677278
H1S1-11-15,3,1677279
H1S1-11-15,3,1677280
H1S1-11-15,5,1677281
H1S1-11-15,3,1677303
H1S1-11-15,3,1677304
H1S1-11-15,3,1677306
H1S1-11-15,3,2721602
H1S1-11-15,2,2721603
H1S1-11-15,3,2721605
H1S1-11-15,4,2721607
H1S1-11-15,1,2910817
H1S1-11-15,2,2910818
H1S1-11-15,2,2910819
H1S1-11-15,4,2910820
HSU1-01-04,5,3367909
HSU1-01-05,3,2927357
H1S1-11-15,2,2910823
H1S1-11-15,3,2910824
H1S1-11-16,3,1677289
H1S1-11-16,3,1677290
H1S1-11-16,3,1677291
H1S1-11-16,5,1677292
H1S1-11-16,3,2721593
H1S1-11-16,2,2721594
H1S1-11-16,3,2721595
H1S1-11-16,3,2721596
H1S1-11-16,3,2910806
H1S1-11-16,3,2910807
H1S1-11-16,3,2910808
H1S1-11-16,3,2910809
H1S1-11-17,3,2721588
H1S1-11-17,3,2721589
H1S1-11-17,3,2721590
H1S1-11-17,3,2721592
H1S1-11-17,4,2721591
H1S1-11-17,3,2910810
H1S1-11-17,3,2910811
H1S1-11-17,3,2910812
H1S1-11-17,3,2910813
H1S1-11-18,3,1677298
H1S1-11-18,3,1677299
H1S1-11-18,4,2721597
H1S1-11-18,4,2721598
H1S1-11-18,5,2721599
H1S1-11-18,5,2721600
H1S1-11-18,3,2910814
H1S1-11-18,4,2910815
H1S1-11-18,4,2910816
H1S1-11-19,3,1677251
H1S1-11-19,1,1677252
H1S1-11-19,3,1677253
H1S1-11-19,3,1677254
H1S1-11-19,3,1677255
H1S1-11-19,5,1677256
H1S1-11-19,3,2721623
H1S1-11-19,4,2721624
H1S1-11-19,4,2721625
H1S1-11-19,5,2721626
H1S1-11-19,2,2910763
H1S1-11-19,3,2910764
H1S1-11-19,3,2910765
H1S1-11-19,3,2910766
H1S1-11-19,2,2910767
H1S1-11-19,2,2910768
H1S1-12-01,1,1677372
H1S1-12-01,1,1677373
H1S1-12-01,3,1677374
H1S1-12-01,1,1677375
H1S1-12-01,1,1677376
H1S1-12-01,3,1677377
H1S1-12-01,3,1677378
H1S1-12-01,5,1677379
H1S1-12-01,1,2723482
H1S1-12-01,2,2723514
H1S1-12-01,3,2723488
H1S1-12-01,3,2723492
H1S1-12-01,1,2910852
H1S1-12-01,1,2910853
H1S1-12-01,1,2910854
H1S1-12-01,3,2910855
H1S1-12-02,3,1677380
H1S1-12-02,3,1677381
H1S1-12-02,3,1677382
H1S1-12-02,3,1677383
H1S1-12-02,3,2723500
H1S1-12-02,3,2723502
H1S1-12-02,3,2723515
H1S1-12-02,4,2723518
H1S1-12-02,2,2910856
H1S1-12-02,3,2910857
H1S1-12-02,3,2910858
H1S1-12-02,3,2910859
H1S1-12-03,3,1677384
H1S1-12-03,3,1677385
H1S1-12-03,3,1677386
H1S1-12-03,3,1677387
H1S1-12-03,3,1677389
H1S1-12-03,3,2723522
H1S1-12-03,2,2723523
H1S1-12-03,3,2723571
H1S1-12-03,3,2723573
H1S1-12-03,3,2910860
H1S1-12-03,3,2910861
H1S1-12-03,3,2910862
H1S1-12-03,3,2910863
H1S1-12-03,2,2910864
H1S1-12-03,3,2910865
H1S1-12-03,3,2910866
H1S1-12-03,3,2910867
H1S1-12-04,3,1677390
H1S1-12-04,3,1677391
H1S1-12-04,3,1677392
H1S1-12-04,3,1677393
H1S1-12-04,5,1677394
H1S1-12-04,3,2723575
H1S1-12-04,3,2723577
H1S1-12-04,3,2723580
H1S1-12-04,3,2723582
H1S1-12-05,1,1677395
H1S1-12-05,3,1677396
H1S1-12-05,3,1677397
H1S1-12-05,3,1677398
H1S1-12-05,5,1677399
H1S1-12-05,3,2723583
H1S1-12-05,3,2723584
H1S1-12-05,4,2723585
H1S1-12-05,4,2723586
H1S1-11-10,3,2910803
H1S1-11-10,2,2910804
H1S1-11-10,3,2910805
H1S1-12-05,3,2910897
H1S1-12-06,3,1677400
H1S1-12-06,1,1677401
H1S1-12-06,3,1677402
H1S1-12-06,3,1677403
H1S1-12-06,3,2723587
H1S1-12-06,2,2723588
H1S1-12-06,3,2723589
H1S1-12-06,3,2723590
H1S1-12-06,2,2723602
H1S1-12-06,2,2723603
H1S1-12-06,3,2723604
H1S1-12-06,4,2723605
H1S1-12-06,3,2723606
H1S1-12-06,2,2723607
H1S1-12-06,3,2723608
H1S1-12-06,3,2723609
H1S1-12-06,1,2910890
H1S1-12-06,1,2910891
H1S1-12-06,3,2910898
H1S1-12-07,3,1677404
H1S1-12-07,3,1677406
H1S1-12-07,3,1677405
H1S1-12-07,3,1677407
H1S1-12-07,2,2723591
H1S1-12-07,3,2723594
H1S1-12-07,3,2723595
H1S1-12-07,3,2723596
H1S1-12-07,3,2910892
H1S1-12-07,3,2910893
H1S1-12-07,2,2910899
H1S1-12-07,3,2910900
H1S1-12-08,3,1677408
H1S1-12-08,1,1677409
H1S1-12-08,3,1677410
H1S1-12-08,5,1677411
H1S1-12-08,3,2723597
H1S1-12-08,3,2723598
H1S1-12-08,3,2723600
H1S1-12-08,4,2723601
H1S1-12-09,1,1677420
H1S1-12-09,3,1677421
H1S1-12-09,3,1677422
H1S1-12-09,2,2723611
H1S1-12-09,1,2723613
HSU1-01-01,2,2927330
HSU1-01-02,3,3367900
H1S1-12-09,4,2723617
H1S1-12-09,1,2910901
H1S1-12-09,1,2910902
H1S1-12-09,3,2910903
H1S1-12-09,3,2910904
H1S1-12-10,3,1677423
H1S1-12-10,3,1677424
H1S1-12-10,3,1677425
H1S1-12-10,3,1677426
H1S1-12-10,4,2723618
H1S1-12-10,3,2723619
H1S1-12-10,3,2723621
H1S1-12-10,5,2723620
H1S1-12-10,3,2910905
H1S1-12-10,3,2910906
H1S1-12-10,3,2910907
H1S1-12-11,3,1677412
H1S1-12-11,1,1677413
H1S1-12-11,3,1677414
H1S1-12-11,3,1677415
H1S1-12-11,3,1677416
H1S1-12-11,3,2723622
H1S1-12-11,2,2723623
H1S1-12-11,3,2723627
H1S1-12-11,4,2723692
H1S1-12-12,3,1677417
H1S1-12-12,3,1677418
H1S1-12-12,5,1677419
H1S1-12-12,2,2723641
H1S1-12-12,3,2723642
H1S1-12-12,4,2723643
H1S1-12-12,4,2723694
H1S1-12-12,3,2910908
H1S1-12-12,4,2910909
H1S1-12-12,3,2910910
H1S1-12-12,3,2910911
H1S1-12-13,3,1677427
H1S1-12-13,3,1677428
H1S1-12-13,3,1677429
H1S1-12-13,5,1677430
H1S1-12-13,3,2723693
H1S1-12-13,4,2723636
H1S1-12-13,4,2723639
H1S1-12-13,3,2910894
H1S1-12-13,3,2910895
H1S1-12-13,3,2910896
HSU1-01-04,3,2522900
HSU1-01-05,3,2740123
HSU1-01-05,3,2927359
HSU1-01-05,3,3367918
HSU1-01-07,3,3367927
HSU1-01-09,2,3367939
HSU1-01-10,3,2927393
HSU1-01-11,2,2522536
HSU1-01-11,2,3367952
HSU1-01-12,2,2740158
H1S1-01-05,3,2907860
H1S1-05-07,2,2909714
HSU1-01-12,3,3367962
HSU1-01-13,3,3367965
HSU1-01-14,3,2927451
HSU1-02-01,2,2524424
HSU1-02-01,3,2927611
HSU1-02-02,3,2746903
HSU1-02-02,3,3368603
HSU1-02-03,3,2927626
HSU1-02-03,1,3368610
HSU1-02-04,3,2747327
HSU1-02-04,3,3368616
HSU1-02-05,2,2747336
HSU1-02-05,3,2927649
HSU1-02-05,3,3368624
HSU1-02-06,3,2927655
HSU1-02-07,3,2525639
HSU1-02-08,3,2527229
HSU1-02-08,3,2927661
HSU1-02-08,3,3368957
HSU1-02-10,3,2927678
HSU1-02-10,3,3368631
HSU1-02-11,3,2747352
HSU1-02-11,3,2927700
HSU1-02-12,3,2528033
HSU1-02-12,3,2747362
HSU1-02-12,3,3368963
HSU1-02-13,3,2747375
HSU1-02-13,3,2927702
HSU1-02-13,3,3368968
HSU1-02-14,2,2927689
HSU1-02-15,4,2747372
HSU1-02-16,3,2927696
HSU1-02-17,3,2747382
HSU1-02-18,4,2529166
HSU1-08-01,3,2797949
HSU1-08-02,5,3370079
HSU1-08-03,3,3370083
HSU1-08-04,3,2798360
HSU1-08-04,3,3370090
HSU1-08-05,2,2928682
HSU1-08-06,4,2798375
HSU1-08-06,5,3370097
HSU1-08-07,4,2798412
HSU1-08-07,3,3370101
HSU1-08-08,3,2798418
HSU1-08-08,3,3370105
HSU1-08-09,3,2798421
HSU1-08-09,3,3370109
HSU1-08-09,3,3370118
HSU1-08-11,3,2798425
HSU1-08-11,3,3370123
HSU1-08-12,4,2798435
HSU1-08-12,3,3370127
HSU1-08-13,3,2798439
HSU1-08-13,3,3370132
HSU1-08-14,2,3370134
HSU1-08-15,3,2798845
HSU1-08-15,3,3370141
HSU1-09-01,3,2803002
HSU1-09-01,1,3370152
HSU1-09-02,3,2802998
HSU1-09-02,3,2928722
HSU1-09-02,3,3370160
HSU1-09-03,2,2803029
HSU1-09-03,1,3370165
HSU1-09-04,4,2803038
HSU1-09-04,4,2928742
HSU1-09-05,3,2728691
HSU1-09-05,3,2928746
HSU1-09-06,3,2728706
HSU1-09-06,3,3370188
HSU1-09-08,3,2803455
HSU1-09-08,2,2928757
HSU1-09-08,1,3370193
HSU1-09-09,3,2803475
HSU1-09-09,3,3370208
HSU1-09-11,3,2728717
HSU1-09-11,3,2928769
HSU1-01-01,3,2927332
HSU1-01-02,3,3367901
HSU1-01-04,2,2740560
HSU1-01-05,2,2740128
HSU1-01-05,3,2927361
HSU1-01-06,2,3367919
HSU1-01-07,3,3367929
HSU1-01-09,3,3367940
HSU1-01-10,3,2927395
HSU1-01-11,2,2740151
HSU1-01-11,1,3367953
HSU1-01-12,2,2740160
HSU1-01-13,3,2522544
HSU1-01-13,3,3367966
HSU1-01-14,4,2927455
HSU1-02-01,1,2746897
HSU1-02-01,2,3368598
HSU1-02-02,3,2746905
HSU1-02-02,3,3368604
HSU1-02-03,4,2927627
HSU1-02-03,1,3368611
HSU1-02-04,5,2747330
HSU1-02-04,3,3368617
HSU1-02-05,2,2747337
HSU1-02-05,2,2927671
HSU1-02-06,4,2525637
HSU1-02-06,3,2927657
HSU1-02-07,4,2747322
HSU1-02-08,3,2527231
HSU1-02-08,3,2927663
HSU1-02-09,1,3368625
HSU1-02-10,3,2927679
HSU1-02-10,5,3368941
HSU1-02-11,3,2747353
HSU1-02-11,4,2927701
HSU1-02-12,3,2528050
HSU1-02-12,5,2747364
HSU1-02-12,1,3368964
HSU1-02-13,3,2747376
HSU1-02-13,4,2927703
HSU1-02-13,3,3368969
HSU1-02-14,3,2927690
HSU1-02-15,2,2927692
HSU1-02-16,3,2927697
HSU1-02-17,3,2927710
HSU1-02-18,3,2529174
HSU1-08-01,3,2798406
HSU1-08-03,2,2725820
HSU1-08-03,3,3370084
HSU1-08-04,3,2928677
HSU1-08-04,3,3370091
HSU1-08-05,4,2928683
HSU1-08-06,3,2928684
HSU1-08-07,3,2725835
HSU1-08-07,2,2928688
HSU1-08-07,5,3370102
HSU1-08-08,3,2928691
HSU1-08-08,3,3370106
HSU1-08-09,3,2798422
HSU1-08-09,1,3370110
HSU1-08-10,3,2928699
HSU1-08-11,3,2798427
HSU1-08-11,5,3370124
HSU1-08-12,3,2928705
HSU1-08-12,3,3370128
HSU1-08-13,4,2798840
HSU1-08-13,5,3370133
HSU1-08-14,3,3370136
HSU1-08-15,3,2798847
HSU1-08-15,1,3370145
HSU1-09-01,2,2803003
HSU1-09-01,3,3370154
HSU1-09-02,3,2803005
HSU1-09-02,3,2928723
HSU1-09-02,3,3370162
HSU1-09-03,2,2803032
HSU1-09-03,3,3370166
HSU1-09-04,5,2803040
HSU1-09-04,1,3370167
HSU1-09-05,3,2728696
HSU1-09-05,3,2928748
HSU1-09-06,3,2803443
HSU1-09-07,2,2803439
HSU1-09-08,3,2803459
HSU1-09-08,3,2928760
HSU1-09-08,3,3370196
HSU1-09-09,3,2928762
HSU1-09-09,5,3370209
HSU1-09-11,3,2728718
HSU1-09-11,4,2928770
HSU1-09-11,3,3370222
HSU1-09-12,3,2928775
HSU1-10-01,3,2730375
HSU1-10-01,2,2928833
HSU1-10-01,3,3370295
HSU1-10-02,3,3370301
HSU1-10-03,5,3370310
HSU1-10-04,1,2928838
HSU1-10-04,5,3370319
HSU1-10-05,2,2928847
HSU1-10-05,3,3370323
HSU1-10-06,4,2808296
HSU1-10-07,3,2808313
HSU1-10-07,3,3370328
HSU1-10-08,3,2808307
HSU1-10-08,3,2928866
HSU1-10-08,5,3370341
HSU1-10-09,3,2732505
HSU1-10-09,3,2928856
HSU1-10-09,3,3370351
HSU1-10-10,5,3370362
HSU1-10-11,3,2808322
HSU1-10-11,4,2928874
HSU1-10-11,5,3370380
HSU1-10-12,3,2808331
HSU1-10-12,3,3370381
HSU1-10-13,4,2808723
HSU1-10-14,4,2732929
HSU1-10-14,3,2928890
HSU1-10-15,5,2732930
HSU1-10-15,3,3370391
HSU1-10-16,3,2928905
HSU1-11-01,3,2735572
HSU1-11-01,2,2929016
HSU1-11-01,5,3370458
HSU1-11-02,2,2929023
HSU1-11-02,5,3370462
HSU1-11-03,3,2820031
HSU1-11-03,3,3370464
HSU1-11-04,3,2820036
HSU1-11-04,2,3370467
HSU1-11-05,3,2736066
HSU1-11-05,3,2820438
HSU1-11-05,3,2820455
HSU1-11-05,3,3370475
HSU1-11-07,3,2736087
HSU1-11-07,3,2929042
HSU1-11-07,3,3370481
HSU1-11-08,3,3370485
HSU1-11-09,3,2736101
HSU1-11-09,5,2820477
HSU1-11-09,3,3370489
HSU1-11-09,5,3370493
HSU1-11-10,3,2929051
HSU1-11-11,4,2736970
HSU1-11-11,2,2929053
HSU1-11-11,3,3370499
HSU1-11-12,3,3370502
HSU1-11-13,4,2820497
HSU1-11-13,3,3370505
M1S1-06-08,1,1610212
M1S1-06-07,1,3629022
HSTA-01-01,3,4921498
HSTA-01-02,3,4921920
HSTA-01-03,3,4921508
HSTA-01-04,2,4913526
HSTA-01-05,3,4928873
HSTA-01-05,3,4922069
HSTA-01-06,4,4921935
HSTA-01-07,3,4921559
HSTA-01-08,3,4921553
HSTA-01-09,3,4921940
HSTA-01-11,3,4929072
HSTA-02-01,2,4913554
HSTA-02-02,3,4921583
HSTA-02-03,3,4921584
HSTA-02-05,2,4929666
HSTA-02-05,3,4921609
HSTA-02-06,4,4913642
HSTA-02-07,3,4929682
HSTA-02-07,4,4921613
HSTA-02-09,3,4913633
HSTA-02-09,2,4921999
HSTA-02-10,3,4921616
HSTA-03-01,3,4922024
HSTA-03-02,2,4921666
HSTA-03-03,3,4922031
HSTA-03-04,3,4922092
HSTA-03-05,3,4921670
HSTA-03-07,3,4929801
HSU1-01-01,3,3367892
HSU1-01-02,3,3367902
HSU1-01-04,3,2740561
HSU1-01-05,3,2740131
HSU1-01-05,4,2927364
HSU1-01-06,1,3367920
HSU1-01-07,3,3367931
HSU1-01-09,5,3367941
HSU1-01-10,1,3367899
HSU1-01-11,2,2740152
HSU1-01-11,3,3367954
HSU1-01-12,2,2927409
HSU1-01-13,2,2740161
HSU1-01-13,3,3367968
HSU1-01-14,4,2927457
HSU1-02-01,3,2746899
HSU1-02-01,3,3368601
HSU1-02-02,4,2746906
HSU1-02-03,3,2525223
HSU1-02-03,2,3368605
HSU1-02-03,3,3368612
HSU1-02-04,2,2927629
HSU1-02-04,3,3368618
HSU1-02-05,2,2747339
HSU1-02-05,3,2927672
HSU1-02-06,3,2747319
HSU1-02-06,4,2927659
HSU1-02-07,3,2747334
HSU1-02-08,3,2747343
HSU1-02-08,3,2927665
HSU1-02-09,1,3368626
HSU1-02-10,3,2927680
HSU1-02-11,4,2527233
HSU1-02-11,3,2927667
HSU1-02-11,3,3368958
HSU1-02-12,2,2747355
HSU1-02-12,2,2927676
HSU1-02-12,1,3368965
HSU1-02-13,3,2747377
HSU1-02-13,4,2927704
HSU1-02-14,3,2529132
HSU1-02-14,4,2927691
HSU1-02-15,2,2927693
HSU1-02-16,4,2927698
HSU1-02-17,1,3368970
HSU1-02-18,3,2747384
HSU1-08-02,2,2928675
HSU1-08-03,3,2725821
HSU1-08-03,5,3370085
HSU1-08-04,2,2928678
HSU1-08-04,3,3370093
HSU1-08-06,2,2725831
HSU1-08-06,2,2928685
HSU1-08-07,4,2726470
HSU1-08-07,3,2928689
HSU1-08-08,2,2726472
HSU1-08-08,3,2928692
HSU1-08-08,3,3370107
HSU1-08-09,3,2798424
HSU1-08-09,3,3370111
HSU1-08-10,3,2928700
HSU1-08-11,3,2798428
HSU1-08-12,4,2726480
HSU1-08-12,3,2928706
HSU1-08-12,5,3370129
HSU1-08-13,2,2928709
HSU1-08-14,3,2798841
HSU1-08-14,3,3370138
HSU1-08-15,1,2928712
HSU1-08-15,3,3370146
HSU1-09-01,3,2928716
HSU1-09-02,3,2728671
HSU1-09-02,3,2803009
HSU1-09-02,3,2928724
HSU1-09-02,3,3370163
HSU1-09-03,2,2928726
HSU1-09-04,1,2728684
HSU1-09-04,1,2928732
HSU1-09-04,1,3370170
HSU1-09-05,5,2728697
HSU1-09-05,4,2928750
HSU1-09-06,3,2803447
HSU1-09-07,4,3370189
HSU1-09-08,2,2803462
HSU1-09-08,3,2928761
HSU1-09-08,3,3370197
HSU1-09-09,3,2928763
HSU1-09-10,5,2728723
HSU1-09-11,3,2803477
HSU1-09-11,4,2928772
HSU1-09-11,3,3370224
HSU1-09-12,3,2928776
HSU1-10-01,3,2730376
HSU1-10-01,2,2928834
HSU1-10-01,3,3370296
HSU1-10-02,1,3370303
HSU1-10-04,1,2808285
HSU1-10-04,3,2928840
HSU1-10-05,2,2808301
HSU1-10-05,3,2928849
HSU1-10-05,3,3370324
HSU1-10-06,3,2928841
HSU1-10-07,3,2808314
HSU1-10-07,3,3370330
HSU1-10-08,3,2808309
HSU1-10-08,4,2928868
HSU1-10-08,5,3370343
HSU1-10-09,4,2732511
HSU1-10-09,3,2928857
HSU1-10-10,2,2928886
HSU1-10-10,5,3370366
HSU1-10-11,3,2808325
HSU1-10-11,3,3370371
HSU1-10-12,3,2732921
HSU1-10-12,3,2928877
HSU1-10-12,3,3370383
HSU1-10-13,3,2808724
HSU1-10-14,5,2732931
HSU1-10-14,3,2928891
HSU1-10-15,3,2808729
HSU1-10-16,4,2732934
HSU1-10-16,4,2928908
HSU1-11-01,3,2820009
HSU1-11-01,3,2929018
HSU1-11-02,2,2736031
HSU1-11-02,3,2929025
HSU1-11-03,3,2736036
HSU1-11-03,3,2929027
HSU1-11-03,3,3370465
HSU1-11-04,4,2820037
HSU1-11-04,1,3370470
HSU1-11-05,3,2736072
HSU1-11-05,4,2820441
HSU1-11-05,4,2929058
HSU1-11-05,5,3370476
HSU1-11-07,2,2736089
HSU1-11-07,3,2929044
HSU1-11-07,1,3370482
HSU1-11-08,1,3370486
HSU1-11-09,5,2736107
HSU1-11-09,4,2929061
HSU1-11-09,3,3370490
HSU1-11-10,1,2820480
HSU1-11-10,1,3370494
HSU1-11-11,5,2820485
HSU1-11-11,3,2929054
HSU1-11-11,5,3370500
HSU1-11-12,3,3370503
HSU1-11-13,3,2929056
HSU1-11-13,5,3370506
HSTA-01-01,3,4921500
HSTA-01-02,3,4928849
HSTA-01-03,3,4921509
HSTA-01-04,2,4913527
HSTA-01-05,3,4928875
HSTA-01-05,3,4921547
HSTA-01-06,3,4921548
HSTA-01-07,2,4921937
HSTA-01-08,3,4921554
HSTA-01-10,3,4913550
HSTA-01-11,3,4929073
HSTA-02-01,2,4913555
HSTA-02-03,3,4929651
HSTA-02-03,3,4921585
HSTA-02-05,3,4929667
HSTA-02-05,3,4921610
HSTA-02-06,3,4921630
HSTA-02-07,3,4929683
HSTA-02-07,3,4921990
HSTA-02-09,3,4913634
HSTA-02-09,3,4922000
HSTA-02-10,5,4921617
HSTA-03-01,3,4921652
HSTA-03-02,3,4921667
HSTA-03-03,3,4921668
HSTA-03-04,3,4922093
HSTA-03-06,3,4929795
HSTA-03-07,3,4929802
HSTA-03-07,3,4922042
HSU1-01-01,1,3367893
HSU1-01-03,3,2927336
HSU1-01-04,3,2740566
HSU1-01-05,3,2740132
HSU1-01-05,3,3367910
HSU1-01-06,3,3367921
HSU1-01-08,3,2927377
HSU1-01-10,3,2492307
HSU1-01-10,2,3367942
HSU1-01-11,2,2740154
HSU1-01-11,3,3367955
HSU1-01-12,2,2927410
HSU1-01-13,3,2740163
HSU1-01-13,3,3367970
HSU1-01-14,3,3367979
HSU1-02-01,3,2746900
HSU1-02-01,3,3368602
HSU1-02-02,3,2927612
HSU1-02-03,3,2525225
HSU1-02-03,1,3368606
HSU1-02-03,3,3368613
HSU1-02-04,2,2927631
HSU1-02-04,3,3368619
HSU1-02-05,3,2747342
HSU1-02-05,3,2927673
HSU1-02-06,3,2747321
HSU1-02-06,3,3368942
HSU1-02-07,3,3368948
HSU1-02-08,3,2747347
HSU1-02-08,3,3368951
HSU1-02-09,3,3368627
HSU1-02-10,4,2927681
HSU1-02-11,3,2527235
HSU1-02-11,2,2927668
HSU1-02-11,1,3368959
HSU1-02-12,2,2747356
HSU1-02-12,3,2927677
HSU1-02-12,3,3368966
HSU1-02-13,3,2747378
HSU1-02-13,3,2927705
HSU1-02-14,4,2529142
HSU1-02-15,3,2529136
HSU1-02-15,3,2927694
HSU1-02-17,3,2529159
HSU1-02-17,1,3368971
HSU1-02-18,3,2747385
HSU1-08-02,3,2928676
HSU1-08-03,2,2928672
HSU1-08-04,3,2725822
HSU1-08-04,3,2928679
HSU1-08-04,5,3370094
HSU1-08-06,2,2725833
HSU1-08-06,2,2928686
HSU1-08-07,5,2726471
HSU1-08-07,3,2928690
HSU1-08-08,3,2726475
HSU1-08-08,3,2928693
HSU1-08-09,3,2726477
HSU1-08-09,3,2928695
HSU1-08-09,3,3370113
HSU1-08-10,4,2928701
HSU1-08-11,3,2928702
HSU1-08-12,4,2726481
HSU1-08-12,4,2928707
HSU1-08-13,3,2726483
HSU1-08-13,3,2928710
HSU1-08-14,3,2798842
HSU1-08-14,5,3370139
HSU1-08-15,3,2928713
HSU1-08-15,3,3370147
HSU1-09-01,2,2928717
HSU1-09-02,3,2728672
HSU1-09-02,3,2803021
HSU1-09-02,4,2928725
HSU1-09-03,2,2728678
HSU1-09-03,2,2928727
HSU1-09-04,3,2728687
HSU1-09-04,3,2928735
HSU1-09-04,3,3370172
HSU1-09-05,3,2803043
HSU1-09-05,3,3370179
HSU1-09-06,3,2928779
HSU1-09-07,3,3370191
HSU1-09-08,3,2803465
HSU1-09-08,3,2928765
HSU1-09-08,5,3370199
HSU1-09-09,4,2928764
HSU1-09-10,5,3370211
HSU1-09-11,3,2803478
HSU1-09-11,4,2928773
HSU1-09-12,3,2803484
HSU1-09-12,2,3370226
HSU1-10-01,3,2730378
HSU1-10-01,2,2928835
HSU1-10-01,3,3370298
HSU1-10-02,3,3370304
HSU1-10-04,1,2808286
HSU1-10-04,1,3370311
HSU1-10-05,3,2808303
HSU1-10-05,3,2928851
HSU1-10-05,3,3370326
HSU1-10-06,3,2928842
HSU1-10-07,3,2928860
HSU1-10-07,3,3370331
HSU1-10-08,5,2808310
HSU1-10-08,2,3370335
HSU1-10-08,3,3370353
HSU1-10-09,3,2808316
HSU1-10-09,3,2928859
HSU1-10-10,3,2928887
HSU1-10-11,3,2732914
HSU1-10-11,3,2928869
HSU1-10-11,3,3370374
HSU1-10-12,3,2732922
HSU1-10-12,3,2928879
HSU1-10-12,3,3370385
HSU1-10-13,4,2808726
HSU1-10-14,4,2732933
HSU1-10-14,4,2928892
HSU1-10-15,3,2928893
HSU1-10-16,3,2808733
HSU1-10-16,3,3370395
HSU1-11-01,3,2820012
HSU1-11-01,3,2929021
HSU1-11-02,4,2736034
HSU1-11-02,4,2929026
HSU1-11-03,3,2736039
HSU1-11-03,3,2929029
HSU1-11-03,3,3370466
HSU1-11-04,3,2820431
HSU1-11-04,5,3370471
HSU1-11-05,3,2736078
HSU1-11-05,5,2820442
HSU1-11-05,3,2929059
HSU1-11-06,2,3370477
HSU1-11-07,3,2736096
HSU1-11-07,3,2929046
HSU1-11-07,3,3370483
HSU1-11-08,3,3370487
HSU1-11-09,3,2820471
HSU1-11-09,3,2929062
HSU1-11-09,3,3370491
HSU1-11-10,3,2820483
HSU1-11-10,1,3370495
HSU1-11-11,3,2820488
HSU1-11-11,4,2929055
HSU1-11-12,2,2820492
HSU1-11-13,4,2736971
HSU1-11-13,4,2929057
HSTA-01-01,3,4913514
HSTA-01-01,3,4921501
HSTA-01-02,3,4928850
HSTA-01-03,3,4921511
HSTA-01-04,3,4913528
HSTA-01-05,3,4928876
HSTA-01-06,2,4928880
HSTA-01-06,3,4921549
HSTA-01-07,2,4921938
HSTA-01-08,3,4921936
HSTA-01-10,3,4913551
HSTA-01-11,5,4929074
HSTA-02-02,3,4913556
HSTA-02-03,3,4929653
HSTA-02-03,4,4921588
HSTA-02-05,3,4929668
HSTA-02-05,3,4921986
HSTA-02-06,4,4921631
HSTA-02-07,5,4929684
HSTA-02-07,3,4921991
HSTA-02-09,3,4913635
HSTA-02-10,3,4929706
HSTA-02-10,3,4921994
HSTA-03-01,3,4921654
HSTA-03-03,3,4929780
HSTA-03-04,3,4929785
HSTA-03-04,3,4921669
HSTA-03-06,3,4929796
HSTA-03-07,3,4929803
HSTA-03-07,3,4922043
HSTA-03-08,3,4929812
HSU1-01-01,3,3367894
HSU1-01-03,3,2927339
HSU1-01-04,2,2927341
HSU1-01-05,3,2740137
HSU1-01-05,1,3367911
HSU1-01-06,3,3367922
HSU1-01-08,3,2927379
HSU1-01-10,3,2740143
HSU1-01-10,3,3367943
HSU1-01-11,2,2740155
HSU1-01-11,3,3367956
HSU1-01-12,3,2927413
HSU1-01-13,3,2740558
HSU1-01-14,4,2522902
HSU1-01-14,1,3367981
HSU1-02-01,3,2746902
HSU1-02-02,3,2524428
HSU1-02-02,2,2927614
HSU1-02-03,3,2746909
HSU1-02-03,3,3368607
HSU1-02-04,3,2527192
HSU1-02-04,3,2927637
HSU1-02-04,5,3368620
HSU1-02-05,2,2927638
HSU1-02-05,2,3368621
HSU1-02-06,3,2747331
HSU1-02-06,1,3368944
HSU1-02-07,3,3368949
HSU1-02-08,3,2747348
HSU1-02-08,3,3368953
HSU1-02-10,3,2747328
HSU1-02-10,3,3368628
HSU1-02-11,3,2527583
HSU1-02-11,3,2927669
HSU1-02-11,3,3368960
HSU1-02-12,2,2747358
HSU1-02-12,3,2927682
HSU1-02-13,4,2529151
HSU1-02-13,1,2927685
HSU1-02-13,3,2927706
HSU1-02-14,3,2747365
HSU1-02-15,3,2529147
HSU1-02-15,3,2927695
HSU1-02-17,4,2529161
HSU1-02-17,3,3368972
HSU1-02-18,3,2927709
HSU1-08-02,1,3370072
HSU1-08-03,3,3370080
HSU1-08-04,3,2725829
HSU1-08-04,3,2928680
HSU1-08-05,3,2797965
HSU1-08-06,4,2725834
HSU1-08-06,3,2928687
HSU1-08-07,3,2798378
HSU1-08-07,2,3370098
HSU1-08-08,3,2726476
HSU1-08-08,3,2928694
HSU1-08-09,3,2726478
HSU1-08-09,3,2928696
HSU1-08-09,5,3370115
HSU1-08-10,1,3370119
HSU1-08-11,3,2928703
HSU1-08-12,4,2726482
HSU1-08-12,5,2928708
HSU1-08-13,3,2726491
HSU1-08-13,3,2928711
HSU1-08-14,4,2798843
HSU1-08-15,3,2726495
HSU1-08-15,3,2928714
HSU1-08-15,3,3370149
HSU1-09-01,3,2928718
HSU1-09-02,3,2728674
HSU1-09-02,5,2803023
HSU1-09-02,3,3370155
HSU1-09-03,2,2728680
HSU1-09-03,3,2928729
HSU1-09-04,3,2728688
HSU1-09-04,3,2928736
HSU1-09-04,3,3370173
HSU1-09-05,3,2803046
HSU1-09-05,3,3370181
HSU1-09-06,4,2928780
HSU1-09-08,2,2728708
HSU1-09-08,3,2928752
HSU1-09-08,3,2928766
HSU1-09-08,5,3370201
HSU1-09-09,3,3370203
HSU1-09-10,1,3370214
HSU1-09-11,3,2803480
HSU1-09-11,3,3370217
HSU1-09-12,3,2803487
HSU1-09-12,3,3370227
HSU1-10-01,3,2808279
HSU1-10-01,3,2928836
HSU1-10-01,5,3370300
HSU1-10-02,3,3370305
HSU1-10-04,3,2808289
HSU1-10-04,1,3370313
HSU1-10-05,2,2808305
HSU1-10-05,2,2928852
HSU1-10-05,5,3370327
HSU1-10-06,4,2928844
HSU1-10-07,3,2928861
HSU1-10-07,5,3370334
HSU1-10-08,3,2928853
HSU1-10-08,1,3370337
HSU1-10-08,3,3370354
HSU1-10-09,3,2808317
HSU1-10-09,3,3370345
HSU1-10-10,4,2928888
HSU1-10-11,3,2732917
HSU1-10-11,3,2928870
HSU1-10-11,3,3370375
HSU1-10-12,3,2732924
HSU1-10-12,3,2928881
HSU1-10-12,3,3370386
HSU1-10-13,3,2928897
HSU1-10-14,3,2808728
HSU1-10-14,3,3370388
HSU1-10-15,3,2928894
HSU1-10-16,3,2808734
HSU1-10-16,3,3370397
HSU1-11-01,3,2820014
HSU1-11-01,2,3370451
HSU1-11-02,2,2820018
HSU1-11-02,1,3370459
HSU1-11-03,3,2736042
HSU1-11-03,3,2929031
HSU1-11-04,4,2736045
HSU1-11-04,3,2929035
HSU1-11-04,5,3370472
HSU1-11-05,3,2736081
HSU1-11-05,4,2820444
HSU1-11-05,5,2929060
HSU1-11-06,3,3370478
HSU1-11-07,3,2820458
HSU1-11-07,4,2929048
HSU1-11-07,5,3370484
HSU1-11-08,5,3370488
HSU1-11-09,5,2820474
HSU1-11-09,4,2929063
HSU1-11-09,5,3370492
HSU1-11-10,3,2929050
HSU1-11-10,3,3370496
HSU1-11-11,3,2929052
HSU1-11-11,3,3370498
HSU1-11-12,3,3370501
HSU1-11-13,3,2820494
HSU1-11-13,3,3370504
HSTA-01-01,3,4913515
HSTA-01-01,3,4921502
HSTA-01-02,3,4928854
HSTA-01-03,3,4921921
HSTA-01-04,3,4913529
HSTA-01-05,3,4928878
HSTA-01-06,1,4928882
HSTA-01-06,5,4921550
HSTA-01-07,3,4921939
HSTA-01-08,3,4921942
HSTA-01-10,3,4913552
HSTA-01-11,4,4921561
HSTA-02-02,3,4913557
HSTA-02-03,3,4929655
HSTA-02-04,3,4913566
HSTA-02-05,3,4929669
HSTA-02-05,3,4921987
HSTA-02-06,4,4921622
HSTA-02-07,3,4913618
HSTA-02-07,3,4921992
HSTA-02-09,3,4913636
HSTA-02-10,3,4929707
HSTA-02-10,3,4921995
HSTA-03-02,3,4929775
HSTA-03-03,3,4929781
HSTA-03-04,3,4929786
HSTA-03-05,3,4929790
HSTA-03-06,3,4929797
HSTA-03-07,3,4929804
HSTA-03-07,3,4922044
HSTA-03-08,5,4929813
HSU1-01-01,3,3367895
HSU1-01-03,3,3367903
HSU1-01-04,2,2927343
HSU1-01-05,3,2740140
HSU1-01-05,3,3367912
HSU1-01-06,5,3367923
HSU1-01-08,3,2927381
HSU1-01-10,3,2740146
HSU1-01-10,3,3367944
HSU1-01-11,2,2927398
HSU1-01-11,5,3367957
HSU1-01-12,3,2927416
HSU1-01-13,3,2927418
HSU1-01-14,3,2522903
HSU1-01-14,3,3368537
HSU1-02-01,2,2927607
HSU1-02-02,3,2524430
HSU1-02-02,3,2927615
HSU1-02-03,4,2746911
HSU1-02-03,5,3368608
HSU1-02-04,3,2527199
HSU1-02-04,3,3368614
HSU1-02-05,3,2527212
HSU1-02-05,2,2927639
HSU1-02-05,1,3368622
HSU1-02-06,3,2747333
HSU1-02-06,3,3368946
HSU1-02-07,3,3368950
HSU1-02-08,3,2747349
HSU1-02-08,3,3368954
HSU1-02-10,3,2927674
HSU1-02-10,3,3368629
HSU1-02-11,3,2747324
HSU1-02-11,3,2927670
HSU1-02-11,3,3368961
HSU1-02-12,3,2747359
HSU1-02-12,2,2927683
HSU1-02-13,4,2529152
HSU1-02-13,1,2927686
HSU1-02-13,4,2927707
HSU1-02-14,5,2747369
HSU1-02-15,2,2747366
HSU1-02-16,3,2747370
HSU1-02-17,2,2747379
HSU1-02-17,3,3368973
HSU1-02-18,3,3368975
HSU1-08-01,3,2725817
HSU1-08-02,1,3370074
HSU1-08-03,3,3370081
HSU1-08-04,3,2725830
HSU1-08-04,3,3370086
HSU1-08-05,5,2798363
HSU1-08-06,1,2798369
HSU1-08-06,3,3370095
HSU1-08-07,3,2798383
HSU1-08-07,3,3370099
HSU1-08-08,3,2798413
HSU1-08-08,3,3370103
HSU1-08-09,4,2726479
HSU1-08-09,3,2928697
HSU1-08-09,2,3370116
HSU1-08-10,1,3370120
HSU1-08-11,3,2928704
HSU1-08-12,3,2798430
HSU1-08-12,3,3370125
HSU1-08-13,5,2726492
HSU1-08-13,2,3370130
HSU1-08-14,2,2928777
HSU1-08-15,3,2726497
HSU1-08-15,3,2928715
HSU1-09-01,3,2728669
HSU1-09-01,3,2928719
HSU1-09-02,3,2728675
HSU1-09-02,3,2928720
HSU1-09-02,3,3370157
HSU1-09-03,3,2728681
HSU1-09-03,4,2928730
HSU1-09-04,1,2803033
HSU1-09-04,3,2928738
HSU1-09-04,3,3370175
HSU1-09-05,5,2803047
HSU1-09-05,5,3370182
HSU1-09-06,3,3370184
HSU1-09-08,2,2728711
HSU1-09-08,3,2928754
HSU1-09-08,4,2928767
HSU1-09-09,2,2803468
HSU1-09-09,3,3370204
HSU1-09-10,5,3370216
HSU1-09-11,4,2803481
HSU1-09-11,3,3370219
HSU1-09-12,3,2803489
HSU1-09-12,3,3370228
HSU1-10-01,3,2808282
HSU1-10-01,2,3370292
HSU1-10-02,2,2730384
HSU1-10-03,3,3370306
HSU1-10-04,4,2808290
HSU1-10-04,3,3370315
HSU1-10-05,3,2808306
HSU1-10-05,2,3370321
HSU1-10-06,2,2808292
HSU1-10-07,3,2732501
HSU1-10-07,3,2928862
HSU1-10-08,3,2730828
HSU1-10-08,3,2928854
HSU1-10-08,3,3370338
HSU1-10-08,5,3370356
HSU1-10-09,3,2808318
HSU1-10-09,3,3370347
HSU1-10-10,2,3370358
HSU1-10-11,3,2732918
HSU1-10-11,3,2928872
HSU1-10-11,3,3370376
HSU1-10-12,3,2808327
HSU1-10-12,4,2928883
HSU1-10-13,3,2732925
HSU1-10-13,3,2928898
HSU1-10-14,4,2808731
HSU1-10-14,3,3370389
HSU1-10-15,3,2928895
HSU1-10-16,5,2808736
HSU1-10-16,5,3370399
HSU1-11-01,2,2820016
HSU1-11-01,3,3370453
HSU1-11-02,3,2820019
HSU1-11-02,1,3370460
HSU1-11-03,3,2820025
HSU1-11-03,4,2929033
HSU1-11-04,3,2736048
HSU1-11-04,3,2929038
HSU1-11-05,3,2736059
HSU1-11-05,2,2820435
HSU1-11-05,3,2820445
HSU1-11-05,1,3370473
HSU1-11-06,3,3370479
HSU1-11-07,4,2820467
HSU1-03-01,3,3369039
HSU1-03-01,1,3369041
HSU1-03-01,3,3369042
HSU1-03-01,3,3369043
HSU1-03-01,3,3369044
HSU1-03-02,1,2752003
HSU1-03-02,1,2752004
HSU1-03-02,1,2752007
HSU1-03-02,1,2927767
HSU1-03-02,1,2927768
HSU1-03-02,1,2927769
HSU1-03-02,2,3369045
HSU1-03-02,1,3369046
HSU1-03-02,3,3369047
HSU1-03-03,3,2536148
HSU1-03-03,3,2536149
HSU1-03-03,3,2536151
HSU1-03-03,1,2752009
HSU1-03-03,2,2752010
HSU1-03-03,2,2752014
HSU1-03-03,2,2927770
HSU1-03-03,2,2927771
HSU1-03-03,2,2927772
HSU1-03-03,3,2927773
HSU1-03-03,3,3369048
HSU1-03-03,1,3369049
HSU1-03-03,1,3369050
HSU1-03-03,3,3369051
HSU1-03-03,3,3369052
HSU1-03-03,5,3369053
HSU1-03-03,5,3369054
HSU1-03-04,2,2927774
HSU1-03-04,1,2927775
HSU1-03-04,3,2927776
HSU1-03-04,4,2927777
HSU1-03-04,1,3369055
HSU1-03-04,1,3369056
HSU1-03-04,3,3369057
HSU1-03-04,3,3369058
HSU1-03-04,3,3369059
HSU1-03-04,5,3369060
HSU1-03-05,3,2927778
HSU1-03-05,3,2927779
HSU1-03-05,3,2927780
HSU1-03-05,4,2927781
HSU1-03-05,2,3369061
HSU1-03-05,3,3369062
HSU1-03-05,3,3369063
HSU1-03-05,3,3369064
HSU1-03-06,2,2752453
HSU1-03-06,3,2752455
HSU1-03-06,2,2927782
HSU1-03-06,2,2927783
HSU1-03-06,3,2927784
HSU1-03-06,3,2927785
HSU1-03-07,3,2536157
HSU1-03-07,1,2752015
HSU1-03-07,1,2752017
HSU1-03-07,2,2752020
HSU1-03-07,4,2752021
HSU1-03-07,2,2927786
HSU1-03-07,3,2927787
HSU1-03-07,3,2927788
HSU1-03-07,4,2927789
HSU1-03-07,1,3369065
HSU1-03-07,1,3369066
HSU1-03-07,3,3369067
HSU1-03-07,5,3369068
HSU1-03-08,2,2752023
HSU1-03-08,2,2752026
HSU1-03-08,2,2752027
HSU1-03-08,3,2927794
HSU1-03-08,3,2927795
HSU1-03-08,3,2927796
HSU1-03-08,3,2927797
HSU1-03-08,2,3369071
HSU1-03-08,1,3369072
HSU1-03-08,3,3369073
HSU1-03-08,5,3369074
HSU1-03-09,3,2536158
HSU1-03-09,3,2536159
HSU1-03-09,4,2536160
HSU1-03-09,3,2752031
HSU1-03-09,3,2752032
HSU1-03-09,4,2752035
HSU1-03-09,3,2927790
HSU1-03-09,3,2927791
HSU1-03-09,3,2927792
HSU1-03-09,3,2927793
HSU1-03-09,3,3369075
HSU1-03-09,3,3369076
HSU1-03-09,3,3369077
HSU1-03-10,3,2927798
HSU1-03-10,3,2927799
HSU1-03-10,3,2927800
HSU1-03-10,3,2927801
HSU1-03-10,4,2927802
HSU1-03-10,3,2927803
HSU1-03-10,3,2927804
HSU1-03-10,3,2927805
HSU1-03-10,4,2927806
HSU1-03-10,3,3369078
HSU1-03-10,3,3369079
HSU1-03-10,3,3369080
HSU1-03-10,5,3369081
HSU1-03-11,4,2541328
HSU1-03-11,3,2756702
HSU1-03-11,3,2756705
HSU1-03-11,2,2927807
HSU1-03-11,3,2927811
HSU1-03-11,3,2927812
HSU1-03-11,2,3369082
HSU1-03-11,1,3369083
HSU1-03-11,3,3369084
HSU1-03-11,3,3369085
HSU1-03-12,3,2541329
HSU1-03-12,3,2541338
HSU1-03-12,3,2756706
HSU1-03-12,2,2756718
HSU1-03-12,3,2927813
HSU1-03-12,3,2927817
HSU1-03-12,3,2927818
HSU1-03-12,4,2927819
HSU1-03-12,4,2927820
HSU1-03-12,3,3369086
HSU1-03-12,3,3369087
HSU1-03-12,3,3369088
HSU1-03-12,3,3369089
HSU1-03-12,5,3369090
HSU1-03-13,2,2541335
HSU1-03-13,2,2541337
HSU1-03-13,2,2756710
HSU1-03-13,2,2756712
HSU1-03-13,2,2756716
HSU1-03-13,3,2927821
HSU1-03-13,3,2927822
HSU1-03-13,1,3369097
HSU1-03-13,1,3369098
HSU1-03-13,3,3369099
HSU1-03-14,3,2756708
HSU1-03-14,2,2927827
HSU1-03-14,3,2927831
HSU1-03-14,2,3369091
HSU1-03-14,3,3369092
HSU1-03-15,4,2542058
HSU1-03-15,4,2542059
HSU1-03-15,4,2756719
HSU1-03-15,4,2756722
HSU1-03-15,4,3369100
HSU1-03-15,3,3369120
HSU1-03-15,5,3369125
HSU1-03-15,5,3369129
HSU1-03-16,3,2542068
HSU1-03-16,2,2756724
HSU1-03-16,2,2927834
HSU1-03-16,2,2927835
HSU1-03-16,3,2927836
HSU1-03-16,4,2927838
HSU1-03-16,2,3369132
HSU1-03-16,1,3369137
HSU1-03-16,3,3369140
HSU1-03-16,3,3369142
HSU1-03-16,5,3369145
HSU1-03-16,5,3369146
HSU1-03-17,3,2542070
HSU1-03-17,2,2756727
HSU1-03-17,3,2927840
HSU1-03-17,3,2927845
HSU1-03-17,4,2927846
HSU1-03-17,2,3369147
HSU1-03-17,3,3369149
HSU1-03-18,3,2542072
HSU1-03-18,3,2542074
HSU1-03-18,4,2544320
HSU1-03-18,3,2756736
HSU1-03-18,3,2756752
HSU1-03-18,3,2756753
HSU1-03-18,3,2927848
HSU1-03-18,2,2927850
HSU1-03-18,3,2927851
HSU1-03-18,4,2927853
HSU1-03-18,3,3369153
HSU1-03-18,3,3369156
HSU1-03-18,5,3369160
HSU1-03-19,3,2756730
HSU1-03-19,3,2927855
HSU1-03-19,3,2927860
HSU1-03-19,3,2927861
HSU1-03-20,3,2756733
HSU1-03-20,3,2927862
HSU1-03-20,3,2927864
HSU1-03-20,4,2927867
HSU1-03-20,2,3369162
HSU1-03-20,3,3369166
HSU1-03-21,3,2542083
HSU1-03-21,3,2544322
HSU1-03-21,2,2756756
HSU1-03-21,2,2756759
HSU1-03-21,2,2756761
HSU1-03-21,2,2927868
HSU1-03-21,3,2927871
HSU1-03-21,3,2927872
HSU1-03-21,5,2927873
HSU1-03-21,2,3369168
HSU1-03-21,1,3369171
HSU1-03-21,3,3369172
HSU1-03-21,3,3369174
HSU1-03-21,3,3369178
HSU1-03-21,5,3369182
HSU1-04-01,2,2537981
HSU1-04-01,3,2537983
HSU1-04-01,2,2537984
HSU1-04-01,2,2928024
HSU1-04-01,1,2928026
HSU1-04-01,2,2928028
HSU1-04-01,2,3369270
HSU1-04-01,1,3369271
HSU1-04-01,3,3369272
HSU1-04-01,3,3369273
HSU1-04-01,3,3369274
HSU1-04-01,5,3369275
HSU1-04-02,1,2752037
HSU1-04-02,2,2752038
HSU1-04-02,3,2752041
HSU1-04-02,2,2928029
HSU1-04-02,2,2928031
HSU1-04-02,3,2928034
HSU1-04-02,1,3369276
HSU1-04-02,1,3369277
HSU1-04-02,3,3369278
HSU1-04-02,3,3369279
HSU1-04-03,2,2537981
HSU1-04-03,2,2537983
HSU1-04-03,2,2537984
HSU1-04-03,2,2752043
HSU1-04-03,3,2752046
HSU1-04-03,2,2752446
HSU1-04-03,1,2928038
HSU1-04-03,2,2928040
HSU1-04-03,3,2928041
HSU1-04-03,3,2928042
HSU1-04-03,2,3369280
HSU1-04-03,1,3369281
HSU1-04-03,3,3369282
HSU1-04-03,2,3369284
HSU1-04-03,3,3369285
HSU1-04-03,3,3369286
HSU1-04-03,3,3369287
HSU1-04-04,3,2928043
HSU1-04-04,3,2928046
HSU1-04-04,4,2928047
HSU1-04-04,2,3369300
HSU1-04-04,3,3369301
HSU1-04-04,3,3369302
HSU1-04-04,5,3369303
HSU1-04-05,3,2537999
HSU1-04-05,3,2752451
HSU1-04-05,2,2928048
HSU1-04-05,3,2928051
HSU1-04-05,2,3369294
HSU1-04-05,1,3369295
HSU1-04-05,3,3369296
HSU1-04-05,3,3369298
HSU1-04-05,3,3369299
HSU1-04-06,4,2538000
HSU1-04-06,4,2538006
HSU1-04-06,2,2752456
HSU1-04-06,3,2752458
HSU1-04-06,3,2752459
HSU1-04-06,4,2928052
HSU1-04-06,3,2928053
HSU1-04-06,3,2928054
HSU1-04-06,3,2928055
HSU1-04-06,4,2928056
HSU1-04-06,5,3369283
HSU1-04-06,3,3369288
HSU1-04-06,1,3369289
HSU1-04-06,1,3369290
HSU1-04-06,3,3369291
HSU1-04-06,3,3369292
HSU1-04-06,3,3369293
HSU1-04-06,3,3369297
HSU1-04-07,3,2539094
HSU1-04-07,3,2752461
HSU1-04-07,3,2752467
HSU1-04-07,3,2752469
HSU1-04-07,3,2752470
HSU1-04-07,3,2752472
HSU1-04-07,4,2752473
HSU1-04-07,4,2752477
HSU1-04-07,3,2928057
HSU1-04-07,3,2928058
HSU1-04-07,3,2928059
HSU1-04-07,4,2928062
HSU1-04-07,3,3369304
HSU1-04-07,3,3369305
HSU1-04-07,3,3369306
HSU1-04-07,3,3369308
HSU1-04-08,3,2757189
HSU1-04-08,3,2757191
HSU1-04-08,4,2928070
HSU1-04-08,4,2928072
HSU1-04-08,4,3369312
HSU1-04-08,3,3369313
HSU1-04-09,3,2539096
HSU1-04-09,4,2539098
HSU1-04-09,3,2539100
HSU1-04-09,3,2752478
HSU1-04-09,3,2752482
HSU1-04-09,3,2752483
HSU1-04-09,3,2752485
HSU1-04-09,3,2928063
HSU1-04-09,3,2928064
HSU1-04-09,3,2928065
HSU1-04-09,3,2928066
HSU1-04-09,3,3369309
HSU1-04-09,3,3369310
HSU1-04-09,3,3369311
HSU1-04-10,3,2928067
HSU1-04-10,3,2928068
HSU1-04-10,3,2928069
HSU1-04-10,3,3369307
HSU1-04-10,2,3369314
HSU1-04-10,3,3369315
HSU1-04-11,3,2546485
HSU1-04-11,3,2546487
HSU1-04-11,2,2756762
HSU1-04-11,3,2757173
HSU1-04-11,2,2928073
HSU1-04-11,3,2928079
HSU1-04-11,2,3369316
HSU1-04-11,3,3369317
HSU1-04-11,3,3369318
HSU1-04-12,3,2757175
HSU1-04-12,3,2757178
HSU1-04-12,3,2928082
HSU1-04-12,3,2928091
HSU1-04-12,3,2928098
HSU1-04-12,3,2928100
HSU1-04-12,4,2928101
HSU1-04-12,4,2928102
HSU1-04-12,3,3369321
HSU1-04-12,3,3369322
HSU1-04-12,3,3369323
HSU1-04-12,3,3369324
HSU1-04-12,3,3369325
HSU1-04-12,3,3369326
HSU1-04-12,3,3369327
HSU1-04-12,3,3369328
HSU1-04-13,3,2546496
HSU1-04-13,2,2757181
HSU1-04-13,2,2757182
HSU1-04-13,3,2757187
HSU1-04-13,3,2928092
HSU1-04-13,3,3369329
HSU1-04-13,1,3369330
HSU1-04-13,3,3369331
HSU1-04-13,3,3369332
HSU1-04-14,3,2928096
HSU1-04-14,4,2928097
HSU1-04-14,3,3369319
HSU1-04-14,5,3369320
HSU1-04-15,2,2757199
HSU1-04-15,2,2757203
HSU1-04-15,2,2928104
HSU1-04-15,1,3369333
HSU1-04-15,1,3369334
HSU1-04-15,5,3369337
HSU1-04-16,3,2757207
HSU1-04-16,3,2757208
HSU1-04-16,3,2928113
HSU1-04-16,3,2928114
HSU1-04-16,3,2928115
HSU1-04-16,3,2928116
HSU1-04-16,3,3369340
HSU1-04-16,1,3369341
HSU1-04-16,3,3369342
HSU1-04-16,5,3369343
HSU1-04-17,3,2546506
HSU1-04-17,4,2546855
HSU1-04-17,3,2757211
HSU1-04-17,3,2757213
HSU1-04-17,3,2757216
HSU1-04-17,3,2928117
HSU1-04-17,4,3369344
HSU1-04-17,3,3369345
HSU1-04-17,3,3369346
HSU1-04-18,4,2546857
HSU1-04-18,3,2928120
HSU1-04-18,3,2928121
HSU1-04-18,3,3369335
HSU1-04-18,3,3369336
HSU1-04-19,3,2546504
HSU1-04-19,3,2757219
HSU1-04-19,3,2757220
HSU1-04-19,5,2757223
HSU1-04-19,3,2928112
HSU1-04-19,3,3369338
HSU1-04-19,3,3369339
HSU1-04-20,4,2546859
HSU1-04-20,3,2546861
HSU1-04-20,3,2757193
HSU1-04-20,5,2757195
HSU1-04-20,3,2757226
HSU1-04-20,3,2757227
HSU1-04-20,3,2757232
HSU1-04-20,3,2928122
HSU1-04-20,3,2928123
HSU1-04-20,3,2928124
HSU1-04-20,5,2928126
HSU1-04-20,3,3369347
HSU1-04-20,3,3369348
HSU1-04-20,3,3369349
HSU1-04-20,3,3369350
HSU1-04-20,3,3369351
HSU1-04-21,3,2546863
HSU1-04-21,3,2546865
HSU1-04-21,3,2757235
HSU1-04-21,3,2757238
HSU1-04-21,3,2757240
HSU1-04-21,3,2928127
HSU1-04-21,3,2928128
HSU1-04-21,4,2928131
HSU1-04-21,3,3369352
HSU1-04-21,3,3369353
HSU1-04-21,3,3369356
HSU1-04-21,3,3369357
HSU1-05-01,1,2762378
HSU1-05-01,2,2762381
HSU1-05-01,1,2762383
HSU1-05-01,1,2928204
HSU1-05-01,2,2928205
HSU1-05-01,2,2928207
HSU1-05-01,1,3369466
HSU1-05-02,3,2723131
HSU1-05-02,3,2723132
HSU1-05-02,3,2762386
HSU1-05-02,3,2762389
HSU1-05-02,3,2762392
HSU1-05-02,3,2928208
HSU1-05-02,2,2928209
HSU1-05-02,3,2928211
HSU1-05-02,1,3369465
HSU1-05-02,3,3369467
HSU1-05-02,3,3369468
HSU1-05-02,3,3369469
HSU1-05-02,3,3369470
HSU1-05-03,1,2723137
HSU1-05-03,1,2723138
HSU1-05-03,2,2723139
HSU1-05-03,1,2762403
HSU1-05-03,1,2762405
HSU1-05-03,2,2762408
HSU1-05-03,1,2928216
HSU1-05-03,1,2928217
HSU1-05-03,3,2928218
HSU1-05-03,1,3369471
HSU1-05-03,1,3369472
HSU1-05-03,3,3369473
HSU1-05-04,4,2723133
HSU1-05-04,3,2762396
HSU1-05-04,3,2762399
HSU1-05-04,3,2928212
HSU1-05-04,4,2928215
HSU1-05-04,3,3369474
HSU1-05-04,3,3369475
HSU1-05-04,3,3369476
HSU1-05-04,3,3369477
HSU1-05-05,3,2723134
HSU1-05-05,3,2723136
HSU1-05-05,3,2762400
HSU1-05-05,3,2762402
HSU1-05-05,2,2928213
HSU1-05-05,3,2928214
HSU1-05-05,3,3369478
HSU1-05-05,3,3369479
HSU1-05-05,3,3369480
HSU1-05-06,3,2723140
HSU1-05-06,3,2723141
HSU1-05-06,4,2723142
HSU1-05-06,1,2762410
HSU1-05-06,2,2762411
HSU1-05-06,3,2762413
HSU1-05-06,2,2928219
HSU1-05-06,2,2928220
HSU1-05-06,3,2928221
HSU1-05-06,2,3369481
HSU1-05-06,1,3369482
HSU1-05-06,3,3369483
HSU1-05-06,3,3369484
HSU1-05-06,5,3369487
HSU1-05-06,2,3369488
HSU1-05-06,1,3369490
HSU1-05-06,3,3369491
HSU1-05-07,3,2762416
HSU1-05-07,3,2762417
HSU1-05-07,4,2762419
HSU1-05-07,3,2928223
HSU1-05-07,3,3369492
HSU1-05-07,3,3369493
HSU1-05-07,3,3369494
HSU1-05-08,3,2723145
HSU1-05-08,3,2723147
HSU1-05-08,2,2762422
HSU1-05-08,2,2762423
HSU1-05-08,2,2928226
HSU1-05-08,3,2928227
HSU1-05-08,4,2928229
HSU1-05-08,2,3369495
HSU1-05-08,1,3369496
HSU1-05-08,3,3369498
HSU1-05-08,5,3369499
HSU1-05-09,3,2723148
HSU1-05-09,3,2723149
HSU1-05-09,2,2723150
HSU1-05-09,3,2762431
HSU1-05-09,1,2762434
HSU1-05-09,3,2762437
HSU1-05-09,1,2928230
HSU1-05-09,1,2928232
HSU1-05-09,1,2928233
HSU1-05-09,2,2928234
HSU1-05-09,3,2928235
HSU1-05-09,3,2928239
HSU1-05-09,3,3369500
HSU1-05-09,1,3369501
HSU1-05-09,3,3369502
HSU1-05-09,3,3369503
HSU1-05-09,5,3369504
HSU1-05-10,3,2723479
HSU1-05-10,3,2723481
HSU1-05-10,3,2762438
HSU1-05-10,3,2762442
HSU1-05-10,3,2762445
HSU1-05-10,3,2928240
HSU1-05-10,4,2928244
HSU1-05-10,3,3369505
HSU1-05-10,3,3369506
HSU1-05-10,3,3369507
HSU1-05-10,5,3369508
HSU1-05-11,3,2723483
HSU1-05-11,3,2723484
HSU1-05-11,3,2723485
HSU1-05-11,4,2723489
HSU1-05-11,4,2723490
HSU1-05-11,3,2762448
HSU1-05-11,3,2762449
HSU1-05-11,4,2762450
HSU1-05-11,5,2762453
HSU1-05-11,3,2928245
HSU1-05-11,3,2928246
HSU1-05-11,3,2928247
HSU1-05-11,3,2928248
HSU1-05-11,4,2928249
HSU1-05-11,3,3369497
HSU1-05-11,1,3369509
HSU1-05-11,3,3369510
HSU1-05-11,3,3369511
HSU1-05-11,3,3369512
HSU1-05-11,3,3369513
HSU1-05-11,3,3369514
HSU1-05-12,3,2762454
HSU1-05-12,3,2762456
HSU1-05-12,5,2762457
HSU1-05-12,3,2928250
HSU1-05-12,3,2928251
HSU1-05-12,3,2928252
HSU1-05-12,4,2928253
HSU1-05-12,3,3369515
HSU1-05-12,1,3369516
HSU1-05-12,3,3369517
HSU1-05-12,3,3369523
HSU1-05-13,3,2762459
HSU1-05-13,3,2762460
HSU1-05-13,3,2762464
HSU1-05-13,3,2928254
HSU1-05-13,3,2928255
HSU1-05-13,3,2928256
HSU1-05-13,4,2928257
HSU1-05-13,3,3369525
HSU1-05-13,1,3369528
HSU1-05-13,3,3369530
HSU1-05-13,5,3369533
HSU1-06-01,2,2928349
HSU1-06-01,3,2928350
HSU1-06-01,3,2928351
HSU1-06-01,4,2928352
HSU1-06-01,2,3369597
HSU1-06-01,3,3369598
HSU1-06-01,3,3369599
HSU1-06-02,2,3369600
HSU1-06-02,3,3369601
HSU1-06-02,5,3369602
HSU1-06-03,1,3369603
HSU1-06-03,1,3369604
HSU1-06-03,3,3369605
HSU1-06-03,3,3369607
HSU1-06-04,3,2783157
HSU1-06-04,3,2928354
HSU1-06-04,3,2928357
HSU1-06-04,3,3369608
HSU1-06-04,3,3369609
HSU1-06-04,3,3369611
HSU1-06-05,3,2783154
HSU1-06-05,3,2783161
HSU1-06-05,3,2783164
HSU1-06-05,3,2783169
HSU1-06-05,3,2928353
HSU1-06-05,3,2928355
HSU1-06-05,3,2928356
HSU1-06-05,3,2928358
HSU1-06-05,3,2928359
HSU1-06-05,3,2928360
HSU1-06-05,3,2928361
HSU1-06-05,3,3369612
HSU1-06-05,1,3369613
HSU1-06-05,3,3369614
HSU1-06-05,3,3369615
HSU1-06-05,3,3369616
HSU1-06-05,5,3369617
HSU1-06-06,2,2723816
HSU1-06-06,3,2723818
HSU1-06-06,3,2783173
HSU1-06-06,3,2783176
HSU1-06-06,3,2783181
HSU1-06-06,3,2928362
HSU1-06-06,2,2928363
HSU1-06-06,3,2928364
HSU1-06-06,3,3369618
HSU1-06-06,3,3369619
HSU1-06-06,3,3369620
HSU1-06-06,3,3369621
HSU1-06-07,4,2723814
HSU1-06-07,3,2783184
HSU1-06-07,3,2783189
HSU1-06-07,3,2783192
HSU1-06-07,3,2928365
HSU1-06-07,3,2928366
HSU1-06-07,3,2928367
HSU1-06-07,4,2928368
HSU1-06-07,3,3369622
HSU1-06-07,3,3369623
HSU1-06-07,3,3369624
HSU1-06-07,3,3369625
HSU1-06-07,3,3369626
HSU1-06-07,5,3369627
HSU1-06-08,3,2783200
HSU1-06-08,3,2783207
HSU1-06-08,2,2783209
HSU1-06-08,2,2928369
HSU1-06-08,2,2928370
HSU1-06-08,3,2928371
HSU1-06-08,3,2928372
HSU1-06-08,3,3369628
HSU1-06-08,3,3369629
HSU1-06-08,3,3369630
HSU1-06-08,5,3369631
HSU1-06-09,3,2783167
HSU1-06-09,3,2928373
HSU1-06-09,3,2928374
HSU1-06-09,3,2928375
HSU1-06-09,3,3369606
HSU1-06-10,2,2723931
HSU1-06-10,3,2783212
HSU1-06-10,3,2783213
HSU1-06-10,3,2783215
HSU1-06-10,3,2928376
HSU1-06-10,2,2928377
HSU1-06-10,2,2928378
HSU1-06-10,3,2928383
HSU1-06-10,3,3369632
HSU1-06-10,3,3369633
HSU1-06-10,3,3369634
HSU1-06-10,3,3369635
HSU1-06-10,3,3369636
HSU1-06-10,3,3369642
HSU1-06-11,3,2724265
HSU1-06-11,4,2783218
HSU1-06-11,4,2783221
HSU1-06-11,4,2928384
HSU1-06-11,3,3369637
HSU1-06-11,3,3369638
HSU1-06-11,3,3369639
HSU1-06-12,4,2724266
HSU1-06-12,4,2783220
HSU1-06-12,3,3369640
HSU1-06-12,3,3369641
HSU1-06-12,5,3369643
HSU1-06-13,3,2928385
HSU1-06-13,3,2928386
HSU1-06-13,3,2928387
HSU1-06-14,3,2928391
HSU1-06-14,3,3369645
HSU1-06-15,2,2783227
HSU1-06-15,3,2783230
HSU1-06-15,3,2928398
HSU1-06-15,3,2928399
HSU1-06-15,3,2928400
HSU1-06-15,3,3369647
HSU1-06-15,3,3369649
HSU1-06-15,3,3369651
HSU1-06-15,3,3369656
HSU1-06-16,3,2724273
HSU1-06-16,3,2724275
HSU1-06-16,3,2724277
HSU1-06-16,3,2783234
HSU1-06-16,3,2783236
HSU1-06-16,3,2783239
HSU1-06-16,3,2928394
HSU1-06-16,3,2928395
HSU1-06-16,3,2928396
HSU1-06-16,4,2928397
HSU1-06-16,2,3369657
HSU1-06-16,1,3369658
HSU1-06-16,3,3369659
HSU1-06-16,3,3369660
HSU1-06-16,5,3369662
HSU1-06-17,3,2783223
HSU1-06-17,3,2783224
HSU1-06-17,3,2783225
HSU1-06-17,3,2783231
HSU1-06-17,3,2928390
HSU1-06-17,3,2928392
HSU1-06-17,4,2928393
HSU1-06-17,4,2928401
HSU1-06-17,3,3369644
HSU1-06-17,3,3369646
HSU1-06-18,3,2724560
HSU1-06-18,5,2724562
HSU1-06-18,3,2724567
HSU1-06-18,3,2783244
HSU1-06-18,3,2783247
HSU1-06-18,3,2783250
HSU1-06-18,3,2928402
HSU1-06-18,2,2928403
HSU1-06-18,2,2928404
HSU1-06-18,3,2928405
HSU1-06-18,2,3369664
HSU1-06-18,3,3369666
HSU1-06-18,3,3369667
HSU1-06-18,5,3369670
HSU1-06-19,3,2724564
HSU1-06-19,3,2724565
HSU1-06-19,3,2783256
HSU1-06-19,5,2783266
HSU1-06-19,3,2928406
HSU1-06-19,3,2928407
HSU1-06-19,4,2928408
HSU1-06-19,4,2928409
HSU1-06-19,3,3369665
HSU1-06-19,3,3369668
HSU1-06-19,3,3369671
HSU1-06-19,3,3369675
HSU1-06-19,3,3369677
HSU1-06-19,3,3369680
HSU1-06-20,3,2783262
HSU1-06-20,3,2928410
HSU1-06-20,3,2928411
HSU1-06-20,3,2928412
HSU1-06-20,4,2928413
HSU1-06-20,3,3369672
HSU1-06-21,3,2928414
HSU1-06-21,4,2928415
HSU1-06-21,4,2928416
HSU1-06-21,2,3369682
HSU1-06-21,3,3369684
HSU1-06-21,3,3369686
HSU1-06-21,3,3369688
HSU1-06-22,3,2783253
HSU1-06-22,3,2783271
HSU1-06-22,3,2783274
HSU1-06-22,3,2783685
HSU1-06-22,3,2928417
HSU1-06-22,3,2928418
HSU1-06-22,3,2928419
HSU1-06-22,3,2928420
HSU1-06-22,2,2928438
HSU1-06-22,3,2928439
HSU1-06-22,3,2928440
HSU1-06-22,4,2928441
HSU1-06-22,3,3369690
HSU1-06-22,3,3369691
HSU1-06-22,3,3369692
HSU1-06-23,3,2724568
HSU1-06-23,3,2724575
HSU1-06-23,3,2724576
HSU1-06-23,3,2783688
HSU1-06-23,3,2783691
HSU1-06-23,3,2783694
HSU1-06-23,3,2783705
HSU1-06-23,3,2928421
HSU1-06-23,2,2928422
HSU1-06-23,3,2928423
HSU1-06-23,4,2928424
HSU1-06-23,3,3369694
HSU1-06-23,1,3369695
HSU1-06-23,3,3369696
HSU1-06-23,3,3369697
HSU1-06-23,3,3369698
HSU1-06-23,3,3369699
HSU1-06-24,3,2724578
HSU1-06-24,3,2724579
HSU1-06-24,3,2724583
HSU1-06-24,3,2783709
HSU1-06-24,3,2783715
HSU1-06-24,5,2783717
HSU1-06-24,3,2928425
HSU1-06-24,3,2928426
HSU1-06-24,3,2928428
HSU1-06-24,4,2928429
HSU1-06-24,3,3369700
HSU1-06-24,3,3369701
HSU1-06-24,3,3369702
HSU1-06-25,3,2724591
HSU1-06-25,3,2724903
HSU1-06-25,3,2724905
HSU1-06-25,3,2783721
HSU1-06-25,3,2789024
HSU1-06-25,3,2789030
HSU1-06-25,3,2928430
HSU1-06-25,3,2928431
HSU1-06-25,3,2928432
HSU1-06-25,3,2928433
HSU1-06-25,3,2928434
HSU1-06-25,3,3369703
HSU1-06-25,3,3369704
HSU1-06-25,3,3369705
HSU1-06-25,3,3369707
HSU1-06-25,3,3369709
HSU1-06-26,3,2928435
HSU1-06-26,4,2928436
HSU1-06-26,5,2928437
HSU1-07-01,1,2789093
HSU1-07-01,2,2789097
HSU1-07-01,2,2789099
HSU1-07-01,2,2789102
HSU1-07-01,1,2928525
HSU1-07-01,1,2928529
HSU1-07-01,2,2928531
HSU1-07-01,2,3369752
HSU1-07-01,3,3369753
HSU1-07-01,3,3369754
HSU1-07-01,3,3369755
HSU1-07-01,5,3369756
HSU1-07-02,3,2725514
HSU1-07-02,3,2928534
HSU1-07-02,2,2928537
HSU1-07-02,3,2928539
HSU1-07-02,4,2928543
HSU1-07-02,4,2928545
HSU1-07-02,2,3369757
HSU1-07-02,1,3369758
HSU1-07-02,1,3369759
HSU1-07-02,3,3369760
HSU1-07-02,3,3369761
HSU1-07-02,5,3369762
HSU1-07-03,3,2725517
HSU1-07-03,3,2725521
HSU1-07-03,2,2789105
HSU1-07-03,3,2789111
HSU1-07-03,3,2789116
HSU1-07-03,2,2928550
HSU1-07-03,3,2928553
HSU1-07-03,3,2928556
HSU1-07-03,4,2928558
HSU1-07-03,3,3369763
HSU1-07-03,3,3369764
HSU1-07-04,3,2725519
HSU1-07-04,3,2725523
HSU1-07-04,3,2789119
HSU1-07-04,3,2789122
HSU1-07-04,4,2789190
HSU1-07-04,3,2928559
HSU1-07-04,2,2928560
HSU1-07-04,4,2928562
HSU1-07-04,2,3369765
HSU1-07-04,3,3369766
HSU1-07-04,5,3369767
HSU1-07-05,3,2725524
HSU1-07-05,3,2725525
HSU1-07-05,2,2789192
HSU1-07-05,3,2789193
HSU1-07-05,3,2789194
HSU1-07-05,3,2928602
HSU1-07-05,3,2928603
HSU1-07-05,4,2928604
HSU1-07-05,3,2928606
HSU1-07-05,4,2928607
HSU1-07-05,5,2928608
HSU1-07-05,3,3369781
HSU1-07-05,3,3369782
HSU1-07-06,3,2725536
HSU1-07-06,2,2789197
HSU1-07-06,3,2789199
HSU1-07-06,3,2789201
HSU1-07-06,3,2789204
HSU1-07-06,4,2928563
HSU1-07-06,3,2928564
HSU1-07-06,3,2928565
HSU1-07-06,4,2928569
HSU1-07-06,3,3369783
HSU1-07-06,3,3369784
HSU1-07-06,3,3369785
HSU1-07-07,3,2725537
HSU1-07-07,3,2725540
HSU1-07-07,4,2725541
HSU1-07-07,3,2789207
HSU1-07-07,3,2789210
HSU1-07-07,5,2789213
HSU1-07-07,3,2928570
HSU1-07-07,3,2928571
HSU1-07-07,4,2928573
HSU1-07-07,3,2928574
HSU1-07-07,3,2928575
HSU1-07-07,3,2928576
HSU1-07-07,3,2928577
HSU1-07-07,2,3369786
HSU1-07-07,1,3369787
HSU1-07-07,3,3369788
HSU1-07-07,3,3369789
HSU1-07-07,3,3369790
HSU1-07-07,3,3369791
HSU1-07-07,5,3369792
HSU1-07-08,2,2725572
HSU1-07-08,3,2928572
HSU1-07-08,2,2928578
HSU1-07-08,3,2928579
HSU1-07-08,4,2928580
HSU1-07-08,3,2928584
HSU1-07-08,2,3369793
HSU1-07-08,1,3369794
HSU1-07-08,3,3369795
HSU1-07-08,3,3369796
HSU1-07-08,3,3369804
HSU1-07-09,3,2725545
HSU1-07-09,3,2725558
HSU1-07-09,4,2725562
HSU1-07-09,2,2789216
HSU1-07-09,3,2789218
HSU1-07-09,3,2789219
HSU1-07-09,3,2928581
HSU1-07-09,3,2928582
HSU1-07-09,4,2928583
HSU1-07-09,3,3369797
HSU1-07-09,3,3369798
HSU1-07-09,3,3369799
HSU1-07-10,3,2725566
HSU1-07-10,3,2725567
HSU1-07-10,2,2789221
HSU1-07-10,3,2789222
HSU1-07-10,3,2789225
HSU1-07-10,2,2928606
HSU1-07-10,4,2928607
HSU1-07-10,5,2928608
HSU1-07-10,3,3369800
HSU1-07-10,3,3369801
HSU1-07-10,3,3369802
HSU1-07-11,3,2725570
HSU1-07-11,4,2725578
HSU1-07-11,3,2789227
HSU1-07-11,3,2789228
HSU1-07-11,3,2789230
HSU1-07-11,2,2928585
HSU1-07-11,3,2928586
HSU1-07-11,3,3369803
HSU1-07-11,3,3369805
HSU1-07-11,3,3369806
HSU1-07-11,3,3369807
HSU1-07-11,3,3369808
HSU1-07-11,5,3369809
HSU1-07-12,3,3369810
HSU1-07-12,3,3369811
HSU1-07-13,1,2725580
HSU1-07-13,3,2725628
HSU1-07-13,2,2789231
HSU1-07-13,3,2789233
HSU1-07-13,3,2789634
HSU1-07-13,2,2928587
HSU1-07-13,3,2928588
HSU1-07-13,3,2928589
HSU1-07-13,4,2928590
HSU1-07-13,3,3369812
HSU1-07-13,1,3369813
HSU1-07-13,3,3369814
HSU1-07-13,5,3369815
HSU1-07-14,3,3369816
HSU1-07-14,3,3369817
HSU1-07-15,1,2725629
HSU1-07-15,3,2789642
HSU1-07-15,3,2789643
HSU1-07-15,4,2789645
HSU1-07-15,3,2928591
HSU1-07-15,3,2928592
HSU1-07-15,3,2928593
HSU1-07-15,3,3369818
HSU1-07-15,1,3369819
HSU1-07-15,3,3369820
HSU1-07-15,3,3369821
HSU1-07-16,3,2928594
HSU1-07-16,3,2928595
HSU1-07-16,3,2928596
HSU1-07-16,3,3369822
HSU1-07-16,1,3369823
HSU1-07-16,3,3369824
HSU1-07-17,2,2725632
HSU1-07-17,3,2725634
HSU1-07-17,3,2725635
HSU1-07-17,3,2789635
HSU1-07-17,3,2789637
HSU1-07-17,3,2789639
HSU1-07-17,5,2789640
HSU1-07-17,1,2928597
HSU1-07-17,1,2928598
HSU1-07-17,2,2928599
HSU1-07-17,3,2928600
HSU1-07-17,2,3369825
HSU1-07-17,1,3369826
HSU1-07-17,3,3369827
HSU1-07-17,5,3369828
HSU1-01-01,3,3367896
HSU1-01-03,3,3367904
HSU1-01-04,3,2927345
HSU1-01-05,4,2740142
HSU1-01-05,3,3367913
HSU1-01-07,2,2927366
HSU1-01-08,2,3367934
HSU1-01-10,3,2740148
HSU1-01-10,3,3367950
HSU1-01-11,2,2927399
HSU1-01-12,3,2522542
HSU1-01-12,2,3367959
HSU1-01-13,5,2927447
HSU1-01-14,3,2740567
HSU1-01-14,3,3368538
HSU1-02-01,2,2927609
HSU1-02-02,3,2524433
HSU1-02-02,3,2927617
HSU1-02-03,2,2927619
HSU1-02-03,3,3368609
HSU1-02-04,3,2747325
HSU1-02-04,1,3368615
HSU1-02-05,3,2527218
HSU1-02-05,3,2927640
HSU1-02-05,3,3368623
HSU1-02-06,3,2927651
HSU1-02-06,5,3368947
HSU1-02-08,3,2527223
HSU1-02-08,3,2927660
HSU1-02-08,3,3368955
HSU1-02-10,3,2927675
HSU1-02-10,3,3368630
HSU1-02-11,2,2747350
HSU1-02-11,3,2927699
HSU1-02-11,3,3368962
HSU1-02-12,3,2747361
HSU1-02-12,4,2927684
HSU1-02-13,4,2529155
HSU1-02-13,3,2927687
HSU1-02-13,3,3368967
HSU1-02-14,3,2927688
HSU1-02-15,2,2747367
HSU1-02-16,4,2747373
HSU1-02-17,3,2747381
HSU1-02-17,3,3368974
HSU1-02-18,3,3368976
HSU1-08-01,3,2797553
HSU1-08-02,3,3370078
HSU1-08-03,3,3370082
HSU1-08-04,3,2797961
HSU1-08-04,1,3370088
HSU1-08-05,3,2928681
HSU1-08-06,2,2798371
HSU1-08-06,3,3370096
HSU1-08-07,3,2798409
HSU1-08-07,3,3370100
HSU1-08-08,3,2798416
HSU1-08-08,3,3370104
HSU1-08-09,3,2798419
HSU1-08-09,4,2928698
HSU1-08-09,1,3370117
HSU1-08-10,3,3370121
HSU1-08-11,3,3370122
HSU1-08-12,3,2798431
HSU1-08-12,1,3370126
HSU1-08-13,3,2798438
HSU1-08-13,1,3370131
HSU1-08-14,3,2928778
HSU1-08-15,1,2798844
HSU1-08-15,2,2928771
HSU1-09-01,3,2802997
HSU1-09-01,3,3370151
HSU1-09-02,4,2728677
HSU1-09-02,3,2928721
HSU1-09-02,3,3370159
HSU1-09-03,2,2803026
HSU1-09-03,2,3370164
HSU1-09-04,3,2803035
HSU1-09-04,3,2928740
HSU1-09-04,5,3370177
HSU1-09-05,3,2928744
HSU1-09-06,3,2728703
HSU1-09-06,3,3370186
HSU1-09-08,2,2728714
HSU1-09-08,3,2928756
HSU1-09-08,2,3370192
HSU1-09-09,3,2803474
HSU1-09-09,3,3370206
HSU1-09-11,3,2728715
HSU1-09-11,3,2928768
HSU1-09-11,3,3370221
HSU1-09-12,2,2928774
HSU1-09-12,5,3370229
HSU1-10-01,3,2808283
HSU1-10-01,1,3370293
HSU1-10-02,2,2730805
HSU1-10-03,3,3370308
HSU1-10-04,3,2928837
HSU1-10-04,3,3370317
HSU1-10-05,2,2928845
HSU1-10-05,1,3370322
HSU1-10-06,3,2808295
HSU1-10-07,3,2808311
HSU1-10-07,4,2928863
HSU1-10-08,3,2730830
HSU1-10-08,3,2928865
HSU1-10-08,3,3370340
HSU1-10-09,3,2732503
HSU1-10-09,3,2928855
HSU1-10-09,3,3370349
HSU1-10-10,3,3370361
HSU1-10-11,3,2808320
HSU1-10-11,4,2928873
HSU1-10-11,3,3370379
HSU1-10-12,3,2808329
HSU1-10-12,5,2928885
HSU1-10-13,4,2732927
HSU1-10-13,4,2928901
HSU1-10-14,4,2928889
HSU1-10-14,5,3370393
HSU1-10-15,4,2928896
HSU1-10-16,3,2928903
HSU1-11-01,4,2735570
HSU1-11-01,3,2929015
HSU1-11-01,3,3370456
HSU1-11-02,3,2820022
HSU1-11-02,3,3370461
HSU1-11-03,4,2820027
HSU1-11-03,3,3370463
HSU1-11-04,4,2736054
HSU1-11-04,4,2929040
HSU1-11-05,3,2736060
HSU1-11-05,2,2820436
HSU1-11-05,4,2820450
HSU1-11-05,3,3370474
HSU1-11-06,5,3370480
HSU1-11-07,5,2820468
HSTA-01-01,3,4913516
HSTA-01-02,3,4913518
HSTA-01-02,3,4928855
HSTA-01-03,3,4921922
HSTA-01-04,2,4922066
HSTA-01-05,5,4928879
HSTA-01-06,3,4928883
HSTA-01-07,2,4928887
HSTA-01-08,3,4929054
HSTA-01-08,3,4921943
HSTA-01-10,4,4913553
HSTA-01-11,4,4921948
HSTA-02-01,1,4921975
HSTA-02-03,5,4929656
HSTA-02-04,3,4913567
HSTA-02-05,3,4929670
HSTA-02-05,3,4921988
HSTA-02-06,4,4921632
HSTA-02-07,2,4913619
HSTA-02-07,4,4921993
HSTA-02-09,4,4913637
HSTA-02-10,3,4929708
HSTA-02-10,5,4921996
HSTA-03-02,3,4929776
HSTA-03-03,3,4929782
HSTA-03-04,3,4929787
HSTA-03-05,3,4929791
HSTA-03-06,3,4929798
HSTA-03-07,3,4929805
HSTA-03-07,3,4922045
HSTA-03-08,3,4913738
HSTA-03-09,3,4929815
HSTA-03-09,3,4922155
HSTA-03-11,1,4929823
HSTA-03-11,5,4922162
HSTA-03-12,2,4921683
HSTA-03-13,3,4929834
HSTA-03-13,3,4922168
HSTA-03-14,3,4922099
HSTA-03-15,3,4913760
HSTA-03-15,5,4922176
HSTA-04-01,3,4922196
HSTA-04-02,2,4913829
HSTA-04-03,1,4929912
HSTA-04-03,3,4921722
HSTA-04-04,3,4913837
HSTA-04-05,3,4929921
HSTA-04-05,4,4913844
HSTA-04-06,3,4913845
HSTA-04-07,3,4913866
HSTA-04-08,2,4913848
HSTA-04-09,3,4929948
HSTA-04-09,4,4913858
HSTA-04-10,3,4929953
HSTA-04-10,3,4913865
HSTA-04-11,3,4929961
HSTA-04-11,3,4922231
HSTA-05-01,3,4921768
HSTA-05-02,3,4913931
HSTA-05-03,3,4913938
HSTA-05-03,5,4930164
HSTA-05-04,1,4930175
HSTA-05-05,3,4930183
HSTA-05-05,3,4922264
HSTA-05-06,5,4930192
HSTA-05-07,4,4922278
HSTA-05-07,3,4921785
HSTA-05-08,3,4922124
HSTA-05-09,4,4913956
HSTA-05-10,3,4930275
HSTA-05-10,3,4913961
HSTA-05-10,3,4922288
HSTA-05-11,2,4913963
HSTA-05-11,3,4922290
HSTA-05-12,3,4913975
HSTA-06-01,3,4930167
HSTA-06-02,3,4930169
HSTA-06-02,3,4922315
HSTA-06-03,2,4914048
HSTA-06-04,3,4930321
HSTA-06-04,2,4921830
HSTA-06-04,3,4922321
HSTA-06-05,3,4914058
HSTA-06-06,3,4930335
HSTA-06-07,3,4930338
HSTA-06-07,3,4922332
HSTA-06-08,3,4922334
HSTA-06-09,3,4914069
HSTA-06-10,3,4930357
HSTA-06-10,3,4922342
HSTA-06-11,3,4914081
HSTA-06-12,3,4930367
HSTA-06-13,3,4930370
HSTA-06-13,3,4922140
HSTA-06-14,3,4914092
HSTA-07-01,2,4930442
HSTA-07-01,3,4921873
HSTA-07-02,3,4914166
HSTA-07-03,3,4914168
HSTA-07-04,3,4930456
HSTA-07-04,2,4922378
HSTA-07-05,3,4922382
HSTA-07-06,5,4922383
HSTA-07-07,4,4914185
HSTA-07-08,2,4922386
HSTA-07-10,1,4930475
HSTA-07-11,3,4930482
HSTA-07-12,3,4930485
HSTA-07-13,3,4914199
HSTA-07-14,4,4914202
H1S2-01-01,,2885562
H1S2-01-01,,2597119
H1S2-01-02,,2465716
H1S2-01-02,,2885565
H1S2-01-03,,2885580
H1S2-01-03,,2567209
H1S2-01-03,,2597179
H1S2-01-04,,2885569
H1S2-01-05,,2567202
H1S2-01-06,,2567301
H1S2-01-07,,2885591
H1S2-01-07,,2567226
H1S2-01-07,,2466171
H1S2-01-08,,2885596
H1S2-01-08,,2567293
H1S2-01-08,,2597181
H1S2-01-09,,2885610
H1S2-01-09,,2567263
H1S2-01-10,,2567275
H1S2-02-01,,2885697
H1S2-02-01,,2597564
H1S2-02-02,,2885703
H1S2-02-02,,2573976
H1S2-02-02,,2597580
H1S2-02-03,,2573943
H1S2-02-03,,2597607
H1S2-02-04,,2573992
H1S2-02-05,,2885703
H1S2-02-05,,2597586
H1S2-02-06,,2574374
H1S2-02-06,,2597595
H1S2-02-06,,2573994
H1S2-02-07,,2885719
H1S2-02-07,,2574398
H1S2-02-08,,2885723
H1S2-02-08,,2574003
H1S2-02-08,,2597601
H1S2-02-09,,2885731
H1S2-02-10,,2885733
H1S2-02-11,,2885741
H1S2-02-11,,2468476
H1S2-02-12,,2885743
H1S2-02-12,,2574423
H1S2-02-13,,2885747
H1S2-02-14,,2885750
H1S2-02-14,,2885758
H1S2-02-14,,2574446
H1S2-02-14,,2574482
H1S2-02-14,,2574510
H1S2-02-14,,2597638
H1S2-02-15,,2885755
H1S2-02-15,,2574517
H1S2-02-15,,2597666
H1S2-03-01,,2598061
H1S2-03-02,,2468992
H1S2-03-03,,2885847
H1S2-03-03,,2468969
H1S2-03-03,,2579360
H1S2-03-04,,2579394
H1S2-03-05,,2469016
H1S2-03-05,,2598069
H1S2-03-06,,2885852
H1S2-03-06,,2469036
H1S2-03-06,,2469057
H1S2-03-06,,2579388
H1S2-03-07,,2885855
H1S2-03-07,,2579409
H1S2-03-07,,2469076
H1S2-03-07,,2598085
H1S2-03-08,,2579417
H1S2-03-08,,2469089
H1S2-03-08,,2598099
HSTA-01-01,3,4913517
HSTA-01-02,3,4913519
HSTA-01-03,3,4928857
HSTA-01-03,3,4921923
HSTA-01-04,2,4922067
HSTA-01-05,3,4913530
HSTA-01-06,3,4928884
HSTA-01-07,3,4928889
HSTA-01-08,3,4929055
HSTA-01-09,3,4929059
HSTA-01-10,3,4929063
HSTA-01-11,3,4921947
HSTA-02-01,3,4921976
HSTA-02-03,5,4929658
HSTA-02-04,4,4913568
HSTA-02-05,2,4913613
HSTA-02-05,4,4921989
HSTA-02-06,4,4921633
HSTA-02-07,3,4913620
HSTA-02-08,2,4929685
HSTA-02-09,4,4913638
HSTA-02-10,3,4929709
HSTA-03-01,1,4929771
HSTA-03-02,3,4929778
HSTA-03-03,3,4929783
HSTA-03-04,5,4929788
HSTA-03-05,3,4929793
HSTA-03-06,5,4929800
HSTA-03-07,5,4929806
HSTA-03-07,3,4922046
HSTA-03-08,2,4913739
HSTA-03-09,1,4929816
HSTA-03-10,3,4929820
HSTA-03-11,3,4929824
HSTA-03-12,3,4929826
HSTA-03-12,3,4921684
HSTA-03-13,3,4913748
HSTA-03-13,3,4922169
HSTA-03-14,3,4921689
HSTA-03-15,3,4913761
HSTA-04-01,3,4929894
HSTA-04-01,3,4922197
HSTA-04-02,3,4913830
HSTA-04-03,3,4929913
HSTA-04-03,2,4922203
HSTA-04-04,3,4913838
HSTA-04-05,1,4929922
HSTA-04-05,3,4922105
HSTA-04-06,2,4913846
HSTA-04-07,3,4913867
HSTA-04-08,2,4913849
HSTA-04-09,3,4929949
HSTA-04-09,2,4922221
HSTA-04-10,3,4929954
HSTA-04-10,3,4921739
HSTA-04-11,5,4929962
HSTA-04-11,5,4922232
HSTA-05-01,3,4922251
HSTA-05-02,2,4913933
HSTA-05-03,2,4922257
HSTA-05-03,4,4921772
HSTA-05-04,3,4930178
HSTA-05-05,3,4913942
HSTA-05-05,3,4922266
HSTA-05-06,2,4922273
HSTA-05-07,4,4922279
HSTA-05-08,3,4930199
HSTA-05-08,3,4921787
HSTA-05-09,3,4922283
HSTA-05-10,3,4930277
HSTA-05-10,4,4913962
HSTA-05-10,3,4922289
HSTA-05-11,3,4913965
HSTA-05-11,3,4922291
HSTA-05-12,3,4913976
HSTA-06-01,3,4930168
HSTA-06-02,3,4930170
HSTA-06-02,3,4922316
HSTA-06-03,3,4914049
HSTA-06-04,5,4930323
HSTA-06-04,2,4921832
HSTA-06-04,3,4922322
HSTA-06-05,4,4914059
HSTA-06-06,3,4930336
HSTA-06-07,3,4930339
HSTA-06-07,3,4922333
HSTA-06-08,3,4922335
HSTA-06-09,3,4914070
HSTA-06-10,3,4930358
HSTA-06-10,3,4921842
HSTA-06-11,4,4914082
HSTA-06-12,5,4930368
HSTA-06-13,3,4930371
HSTA-06-13,3,4921847
HSTA-06-14,3,4914094
HSTA-07-01,1,4930443
HSTA-07-01,2,4922368
HSTA-07-02,2,4922143
HSTA-07-03,3,4914169
HSTA-07-04,3,4914170
HSTA-07-04,3,4922379
HSTA-07-06,3,4930461
HSTA-07-07,2,4930465
HSTA-07-07,2,4922384
HSTA-07-08,2,4922387
HSTA-07-10,1,4930477
HSTA-07-11,3,4930483
HSTA-07-12,3,4930486
HSTA-07-13,3,4922396
HSTA-07-14,4,4914203
H1S2-01-01,,2566828
H1S2-01-01,,2597117
H1S2-01-02,,2597142
H1S2-01-02,,2885566
H1S2-01-03,,2885582
H1S2-01-03,,2567216
H1S2-01-03,,2597177
H1S2-01-04,,2885570
H1S2-01-05,,2567205
H1S2-01-06,,2567304
H1S2-01-07,,2885593
H1S2-01-07,,2567228
H1S2-01-07,,2466169
H1S2-01-08,,2885597
H1S2-01-08,,2567294
H1S2-01-08,,2597529
H1S2-01-09,,2885611
H1S2-01-09,,2466177
H1S2-01-10,,2567277
H1S2-02-01,,2573918
H1S2-02-01,,2597563
H1S2-02-02,,2885704
H1S2-02-02,,2573981
H1S2-02-02,,2597579
H1S2-02-03,,2573945
H1S2-02-03,,2597605
H1S2-02-04,,2597577
H1S2-02-05,,2885704
H1S2-02-05,,2597584
H1S2-02-06,,2574378
H1S2-02-06,,2597612
H1S2-02-06,,2573997
H1S2-02-07,,2885720
H1S2-02-07,,2574402
H1S2-02-08,,2885724
H1S2-02-08,,2574007
H1S2-02-08,,2597599
H1S2-02-09,,2574014
H1S2-02-10,,2885734
H1S2-02-11,,2885742
H1S2-02-11,,2468474
H1S2-02-12,,2885744
H1S2-02-12,,2574429
H1S2-02-13,,2885748
H1S2-02-14,,2885751
H1S2-02-14,,2885759
H1S2-02-14,,2574452
H1S2-02-14,,2574491
H1S2-02-14,,2468512
H1S2-02-14,,2597653
H1S2-02-15,,2885756
H1S2-02-15,,2574518
H1S2-02-15,,2597662
H1S2-03-02,,2885839
H1S2-03-02,,2468990
H1S2-03-03,,2579380
H1S2-03-03,,2468965
H1S2-03-03,,2579370
H1S2-03-05,,2885842
H1S2-03-05,,2469012
H1S2-03-05,,2885850
H1S2-03-06,,2885853
H1S2-03-06,,2469035
H1S2-03-06,,2598092
H1S2-03-06,,2579390
H1S2-03-07,,2885856
H1S2-03-07,,2579411
H1S2-03-07,,2469075
H1S2-03-07,,2598102
H1S2-03-08,,2579419
H1S2-03-08,,2469088
H1S2-03-08,,2598097
HSTA-01-01,3,4921914
HSTA-01-02,3,4913520
HSTA-01-03,3,4928858
HSTA-01-04,2,4928863
HSTA-01-04,2,4921521
HSTA-01-05,3,4913531
HSTA-01-06,3,4928886
HSTA-01-07,3,4928890
HSTA-01-08,3,4929056
HSTA-01-09,3,4929060
HSTA-01-10,3,4929067
HSTA-01-11,4,4921949
HSTA-02-02,2,4921977
HSTA-02-03,3,4913558
HSTA-02-04,4,4913569
HSTA-02-05,2,4913614
HSTA-02-06,3,4929671
HSTA-02-06,3,4922001
HSTA-02-07,3,4913621
HSTA-02-08,1,4929686
HSTA-02-09,3,4921628
HSTA-02-10,3,4913625
HSTA-03-01,1,4929772
HSTA-03-02,3,4929779
HSTA-03-03,5,4929784
HSTA-03-04,3,4913718
HSTA-03-05,3,4929794
HSTA-03-06,3,4913726
HSTA-03-07,3,4913730
HSTA-03-07,3,4922148
HSTA-03-08,2,4913740
HSTA-03-09,3,4929818
HSTA-03-10,3,4929821
HSTA-03-11,5,4929825
HSTA-03-12,1,4929827
HSTA-03-12,4,4921685
HSTA-03-13,3,4913749
HSTA-03-14,3,4929835
HSTA-03-14,3,4922171
HSTA-03-15,3,4913762
HSTA-04-01,1,4929897
HSTA-04-01,3,4922198
HSTA-04-02,2,4922102
HSTA-04-03,3,4929915
HSTA-04-03,2,4922204
HSTA-04-04,3,4922104
HSTA-04-05,3,4929924
HSTA-04-05,5,4921726
HSTA-04-06,3,4913847
HSTA-04-07,4,4913868
HSTA-04-08,3,4913850
HSTA-04-09,5,4929950
HSTA-04-09,3,4922222
HSTA-04-10,5,4929955
HSTA-04-10,4,4921740
HSTA-04-11,3,4913869
HSTA-05-01,2,4930146
HSTA-05-01,3,4922252
HSTA-05-02,3,4913934
HSTA-05-03,2,4922258
HSTA-05-04,2,4913939
HSTA-05-04,2,4921776
HSTA-05-05,3,4913943
HSTA-05-05,3,4922268
HSTA-05-06,2,4922274
HSTA-05-07,3,4930193
HSTA-05-08,3,4930200
HSTA-05-08,3,4921791
HSTA-05-09,3,4922284
HSTA-05-10,3,4930278
HSTA-05-10,2,4922128
HSTA-05-11,3,4930305
HSTA-05-11,3,4913966
HSTA-05-11,3,4922292
HSTA-05-12,3,4913977
HSTA-06-01,2,4914041
HSTA-06-02,3,4930171
HSTA-06-02,5,4922317
HSTA-06-03,3,4914050
HSTA-06-04,2,4930324
HSTA-06-04,2,4921833
HSTA-06-04,3,4922323
HSTA-06-05,3,4922324
HSTA-06-06,3,4914060
HSTA-06-07,3,4930341
HSTA-06-08,3,4930342
HSTA-06-08,3,4922336
HSTA-06-09,3,4914071
HSTA-06-10,5,4930359
HSTA-06-11,3,4930361
HSTA-06-11,3,4922139
HSTA-06-12,3,4914083
HSTA-06-13,3,4930373
HSTA-06-13,3,4921848
HSTA-06-14,3,4914095
HSTA-07-01,3,4930444
HSTA-07-01,3,4922369
HSTA-07-02,3,4922371
HSTA-07-03,3,4921871
HSTA-07-04,2,4914171
HSTA-07-05,3,4930457
HSTA-07-06,3,4930462
HSTA-07-07,1,4930466
HSTA-07-07,2,4922385
HSTA-07-08,5,4922389
HSTA-07-10,3,4930479
HSTA-07-11,2,4914192
HSTA-07-12,3,4914195
HSTA-07-13,3,4922397
HSTA-07-14,3,4922399
H1S2-01-01,,2566830
H1S2-01-01,,2597144
H1S2-01-02,,2597141
H1S2-01-02,,2885567
H1S2-01-03,,2885584
H1S2-01-03,,2567218
H1S2-01-03,,2885568
H1S2-01-04,,2885571
H1S2-01-05,,2465725
H1S2-01-06,,2465721
H1S2-01-07,,2885600
H1S2-01-07,,2567229
H1S2-01-07,,2466192
H1S2-01-08,,2885598
H1S2-01-08,,2597168
H1S2-01-08,,2567240
H1S2-01-09,,2885618
H1S2-01-09,,2466199
H1S2-01-10,,2567281
H1S2-02-01,,2573921
H1S2-02-01,,2597582
H1S2-02-02,,2573951
H1S2-02-02,,2573985
H1S2-02-02,,2885709
H1S2-02-03,,2573949
H1S2-02-04,,2885711
H1S2-02-04,,2597591
H1S2-02-05,,2468438
H1S2-02-05,,2597598
H1S2-02-06,,2574392
H1S2-02-06,,2597610
H1S2-02-06,,2573999
H1S2-02-07,,2885721
H1S2-02-07,,2574405
H1S2-02-08,,2885725
H1S2-02-08,,2574010
H1S2-02-08,,2597614
H1S2-02-09,,2574015
H1S2-02-10,,2885735
H1S2-02-11,,2574520
H1S2-02-11,,2468473
H1S2-02-12,,2885745
H1S2-02-12,,2597635
H1S2-02-13,,2885749
H1S2-02-14,,2885752
H1S2-02-14,,2885760
H1S2-02-14,,2574457
H1S2-02-14,,2574497
H1S2-02-14,,2468510
H1S2-02-14,,2597650
H1S2-02-15,,2885761
H1S2-02-15,,2468518
H1S2-03-01,,2885837
H1S2-03-02,,2885840
H1S2-03-02,,2598053
H1S2-03-03,,2579382
H1S2-03-03,,2469002
H1S2-03-03,,2598059
H1S2-03-05,,2885843
H1S2-03-05,,2469048
H1S2-03-05,,2579362
H1S2-03-06,,2579396
H1S2-03-06,,2469028
H1S2-03-06,,2598090
H1S2-03-06,,2598064
H1S2-03-07,,2885857
H1S2-03-07,,2579414
H1S2-03-07,,2598086
H1S2-03-07,,2598066
H1S2-03-08,,2579421
H1S2-03-08,,2469086
H1S2-03-08,,2598095
HSTA-01-01,3,4921915
HSTA-01-02,4,4913521
HSTA-01-03,3,4928860
HSTA-01-04,1,4928865
HSTA-01-04,2,4921522
HSTA-01-05,3,4913532
HSTA-01-06,3,4913534
HSTA-01-07,3,4928891
HSTA-01-08,5,4929057
HSTA-01-09,3,4929061
HSTA-01-10,5,4929069
HSTA-01-11,3,4913564
HSTA-02-01,4,4921978
HSTA-02-03,3,4913559
HSTA-02-04,3,4921983
HSTA-02-05,3,4913615
HSTA-02-06,3,4929672
HSTA-02-06,4,4922002
HSTA-02-07,4,4913622
HSTA-02-08,3,4929699
HSTA-02-09,3,4921629
HSTA-02-10,2,4913626
HSTA-03-01,1,4929773
HSTA-03-02,3,4913710
HSTA-03-03,3,4913714
HSTA-03-04,2,4913719
HSTA-03-05,3,4913722
HSTA-03-06,3,4913727
HSTA-03-07,2,4913731
HSTA-03-07,4,4922149
HSTA-03-08,3,4922096
HSTA-03-09,3,4929819
HSTA-03-10,2,4913741
HSTA-03-11,3,4913752
HSTA-03-12,3,4929828
HSTA-03-12,1,4922163
HSTA-03-13,3,4913750
HSTA-03-14,3,4929836
HSTA-03-14,3,4922172
HSTA-03-15,4,4913763
HSTA-04-01,3,4929898
HSTA-04-01,3,4922199
HSTA-04-02,2,4921715
HSTA-04-03,3,4913831
HSTA-04-03,3,4922205
HSTA-04-04,3,4921723
HSTA-04-05,5,4929925
HSTA-04-05,4,4921727
HSTA-04-06,3,4922213
HSTA-04-07,4,4922216
HSTA-04-08,4,4913851
HSTA-04-09,2,4913852
HSTA-04-09,3,4922223
HSTA-04-10,3,4913859
HSTA-04-10,2,4922227
HSTA-04-11,3,4913870
HSTA-05-01,1,4930147
HSTA-05-01,3,4922253
HSTA-05-02,3,4921767
HSTA-05-03,3,4922259
HSTA-05-04,2,4913940
HSTA-05-04,2,4921777
HSTA-05-05,3,4913944
HSTA-05-05,5,4922269
HSTA-05-06,2,4922275
HSTA-05-07,3,4930194
HSTA-05-08,3,4930201
HSTA-05-08,3,4922280
HSTA-05-09,3,4922285
HSTA-05-10,3,4930302
HSTA-05-10,2,4921802
HSTA-05-11,3,4930307
HSTA-05-11,3,4913967
HSTA-05-11,3,4922293
HSTA-05-12,4,4913978
HSTA-06-01,2,4914042
HSTA-06-02,3,4930172
HSTA-06-02,3,4921823
HSTA-06-03,3,4914051
HSTA-06-04,3,4930325
HSTA-06-04,2,4922131
HSTA-06-05,3,4930329
HSTA-06-05,3,4922325
HSTA-06-06,3,4914061
HSTA-06-07,3,4914064
HSTA-06-08,3,4930344
HSTA-06-09,3,4930348
HSTA-06-09,3,4914072
HSTA-06-10,3,4914074
HSTA-06-11,3,4930362
HSTA-06-11,3,4921843
HSTA-06-12,3,4914084
HSTA-06-13,5,4930374
HSTA-06-13,3,4922350
HSTA-06-14,3,4922141
HSTA-07-01,3,4930445
HSTA-07-01,3,4922370
HSTA-07-02,2,4922372
HSTA-07-03,3,4922374
HSTA-07-04,3,4914172
HSTA-07-05,3,4930459
HSTA-07-06,3,4930463
HSTA-07-07,3,4930467
HSTA-07-08,2,4930469
HSTA-07-09,3,4930473
HSTA-07-10,2,4914191
HSTA-07-11,2,4922147
HSTA-07-12,4,4914196
HSTA-07-13,5,4922398
HSTA-07-14,3,4922400
M3S1-03-01,3,134859
M3S1-03-01,3,134857
M3S1-03-01,1,134856
M3S1-03-01,3,134855
M3S1-03-01,5,39020
M3S1-03-01,3,39019
M3S1-03-01,3,39018
M3S1-03-01,3,39017
M3S1-03-01,3,39016
M3S1-03-01,3,39015
M3S1-04-06,4,134963
M3S1-04-06,4,134961
M3S1-04-06,5,39119
M3S1-04-06,3,39118
M3S1-04-06,3,39117
M3S1-04-06,3,39116
M3S1-04-06,3,134958
M3S1-04-06,5,39140
M3S1-04-06,3,39139
M3S1-04-06,3,39138
M3S1-04-06,3,39137
M3S1-04-06,3,39127
M3S1-04-06,3,39125
M3S1-02-08,3,39187
M3S1-02-08,3,39185
M3S1-02-08,3,39184
M3S1-02-08,1,1664496
M3S1-02-08,1,1664495
M3S1-02-08,1,1664494
M3S1-02-08,1,1664493
M3S1-02-08,1,1664492
M3S1-02-08,1,1664491
M3S1-02-08,1,1664490
M3S1-02-08,1,1664489
M3S1-02-08,1,1664488
M3S1-02-08,1,1664487
M3S1-02-08,1,1664486
M3S1-02-08,1,1664485
M3S1-02-08,3,134925
M3S1-02-08,3,134923
M3S1-02-08,3,134921
M3S1-02-08,3,134920
HSTA-01-01,3,4921916
HSTA-01-02,3,4922064
HSTA-01-03,3,4928862
HSTA-01-04,3,4928867
HSTA-01-04,3,4921524
HSTA-01-05,4,4913533
HSTA-01-06,3,4913535
HSTA-01-07,5,4928892
HSTA-01-08,3,4913542
HSTA-01-09,3,4929062
HSTA-01-10,3,4921944
HSTA-01-11,4,4913565
HSTA-02-01,2,4921582
HSTA-02-03,3,4913560
HSTA-02-04,3,4921984
HSTA-02-05,3,4913616
HSTA-02-06,3,4929673
HSTA-02-06,4,4922003
HSTA-02-07,3,4913623
HSTA-02-09,3,4929700
HSTA-02-09,3,4921618
HSTA-02-10,3,4913627
HSTA-03-01,3,4929774
HSTA-03-02,2,4913712
HSTA-03-03,3,4913715
HSTA-03-04,3,4913720
HSTA-03-05,3,4913723
HSTA-03-06,3,4913728
HSTA-03-07,3,4913732
HSTA-03-07,4,4921674
HSTA-03-08,3,4921677
HSTA-03-09,3,4913764
HSTA-03-10,2,4913742
HSTA-03-11,3,4913753
HSTA-03-12,3,4929829
HSTA-03-12,3,4922164
HSTA-03-13,4,4913751
HSTA-03-14,3,4929840
HSTA-03-14,3,4922174
HSTA-03-15,3,4921690
HSTA-04-01,3,4929900
HSTA-04-02,1,4929904
HSTA-04-02,2,4921716
HSTA-04-03,2,4913832
HSTA-04-04,3,4929916
HSTA-04-04,3,4921724
HSTA-04-05,5,4929926
HSTA-04-05,3,4922210
HSTA-04-06,3,4922215
HSTA-04-07,4,4922217
HSTA-04-08,3,4922218
HSTA-04-09,2,4913853
HSTA-04-09,3,4922224
HSTA-04-10,2,4913860
HSTA-04-10,3,4922228
HSTA-04-11,4,4913871
HSTA-05-01,3,4930148
HSTA-05-01,3,4922254
HSTA-05-02,3,4922255
HSTA-05-03,5,4922260
HSTA-05-04,3,4913941
HSTA-05-04,3,4921778
HSTA-05-05,4,4913945
HSTA-05-06,2,4930187
HSTA-05-06,2,4922276
HSTA-05-07,3,4930198
HSTA-05-08,3,4930203
HSTA-05-08,3,4922281
HSTA-05-09,3,4930266
HSTA-05-10,3,4930304
HSTA-05-10,2,4921803
HSTA-05-11,3,4930308
HSTA-05-11,4,4913968
HSTA-05-12,3,4930184
HSTA-05-12,3,4922270
HSTA-06-01,3,4914043
HSTA-06-02,5,4930173
HSTA-06-03,3,4930314
HSTA-06-03,2,4922318
HSTA-06-04,5,4930327
HSTA-06-04,2,4922132
HSTA-06-05,3,4930330
HSTA-06-05,3,4922326
HSTA-06-06,3,4914062
HSTA-06-07,3,4914065
HSTA-06-08,3,4930346
HSTA-06-09,3,4930349
HSTA-06-09,4,4914073
HSTA-06-10,3,4914075
HSTA-06-11,3,4930364
HSTA-06-11,3,4921844
HSTA-06-12,3,4914085
HSTA-06-13,3,4914087
HSTA-06-13,3,4922349
HSTA-06-14,3,4921849
HSTA-07-01,2,4914160
HSTA-07-02,3,4930446
HSTA-07-02,3,4922373
HSTA-07-03,3,4922376
HSTA-07-04,3,4914173
HSTA-07-05,5,4930460
HSTA-07-06,5,4930464
HSTA-07-07,3,4930468
HSTA-07-08,3,4930471
HSTA-07-09,3,4930474
HSTA-07-10,3,4914193
HSTA-07-11,3,4921883
HSTA-07-12,4,4922395
HSTA-07-13,3,4921884
M3S1-08-08,1,1665634
M3S1-08-08,1,1665618
M3S1-08-08,2,1665665
M3S1-08-08,5,196215
M3S1-08-08,5,196214
M3S1-08-08,3,196213
M3S1-08-08,3,196212
M3S1-08-08,3,196211
M3S1-08-08,3,196210
M3S1-09-10,4,53253
M3S1-09-10,3,53252
M3S1-09-10,3,53249
M3S1-09-10,3,53248
M3S1-09-10,3,53246
M3S1-09-10,3,196256
M3S1-09-10,3,196255
M3S1-12-06,1,1666643
M3S1-12-06,1,1666642
M3S1-12-06,3,54804
M3S1-12-06,3,54803
M3S1-12-06,5,196732
M3S1-12-06,5,196731
M3S1-12-06,3,196729
M3S1-12-06,3,196728
M3S1-12-06,3,196727
M3S1-12-06,3,196726
M3S1-12-09,3,39326
M3S1-12-09,3,39325
M3S1-12-09,4,54822
M3S1-12-09,3,54821
M3S1-07-12,1,1665474
M3S1-07-12,1,1665459
M3S1-07-12,1,1665458
M3S1-07-12,1,1665457
M3S1-07-12,1,1665456
M3S1-07-12,1,1665455
M3S1-07-12,1,1665436
M3S1-07-12,1,1665435
M3S1-07-12,1,1665434
M3S1-07-12,1,1665433
M3S1-07-12,1,1665432
M3S1-07-12,1,1665431
M3S1-07-12,1,1665430
M3S1-07-12,1,1665429
M3S1-07-12,3,53140
M3S1-07-12,3,53139
M3S1-07-12,1,53138
M3S1-07-12,2,53137
M3S1-07-12,5,196091
M3S1-07-12,3,196090
M3S1-07-12,3,196089
M3S1-07-12,3,196088
M3S1-07-12,3,196087
M3S1-07-12,3,196086
H1S2-01-01,,2465704
H1S2-01-02,,2465306
H1S2-01-02,,2597138
H1S2-01-02,,2567197
H1S2-01-03,,2885585
H1S2-01-03,,2567220
H1S2-01-03,,2566835
H1S2-01-04,,2567200
H1S2-01-05,,2465723
H1S2-01-06,,2465746
H1S2-01-07,,2885601
H1S2-01-07,,2567231
H1S2-01-07,,2597175
H1S2-01-08,,2885606
H1S2-01-08,,2597170
H1S2-01-08,,2567242
H1S2-01-09,,2885619
H1S2-01-10,,2885613
H1S2-01-10,,2597528
H1S2-02-01,,2573925
H1S2-02-01,,2885705
H1S2-02-02,,2573956
HSTA-01-01,3,4921917
HSTA-01-02,3,4921504
HSTA-01-03,3,4913522
HSTA-01-04,3,4928868
HSTA-01-04,3,4921544
HSTA-01-05,3,4921928
HSTA-01-06,3,4913536
HSTA-01-07,2,4913538
HSTA-01-08,3,4913543
HSTA-01-09,3,4913546
HSTA-01-10,3,4921945
HSTA-02-01,1,4929638
HSTA-02-02,3,4929645
HSTA-02-03,4,4913561
HSTA-02-04,5,4921985
HSTA-02-05,4,4913617
HSTA-02-06,5,4929675
HSTA-02-06,5,4922004
HSTA-02-07,3,4913624
HSTA-02-09,3,4929701
HSTA-02-09,3,4921619
HSTA-02-10,3,4913628
HSTA-03-01,1,4913707
HSTA-03-02,3,4913711
HSTA-03-03,3,4913716
HSTA-03-04,4,4913721
HSTA-03-05,3,4913724
HSTA-03-06,3,4913729
HSTA-03-07,3,4913733
HSTA-03-07,3,4921675
HSTA-03-08,2,4921678
HSTA-03-09,3,4913765
HSTA-03-10,3,4913743
HSTA-03-11,3,4913754
HSTA-03-12,3,4913744
HSTA-03-12,3,4922165
HSTA-03-13,3,4922098
HSTA-03-14,3,4929841
HSTA-03-15,3,4929842
HSTA-03-15,3,4921691
HSTA-04-01,3,4929901
HSTA-04-02,1,4929905
HSTA-04-02,3,4921717
HSTA-04-03,3,4913833
HSTA-04-04,3,4929917
HSTA-04-04,3,4921725
HSTA-04-05,3,4913839
HSTA-04-05,3,4922211
HSTA-04-06,4,4922214
HSTA-04-08,2,4929935
HSTA-04-08,3,4922219
HSTA-04-09,3,4913854
HSTA-04-09,3,4922225
HSTA-04-10,3,4913861
HSTA-04-10,3,4922229
HSTA-04-11,3,4922114
HSTA-05-01,3,4913927
HSTA-05-02,2,4930149
HSTA-05-02,3,4922256
HSTA-05-03,2,4930155
HSTA-05-04,2,4922261
HSTA-05-05,3,4930179
HSTA-05-05,3,4922122
HSTA-05-06,1,4930188
HSTA-05-06,3,4913946
HSTA-05-07,3,4913948
HSTA-05-08,5,4930204
HSTA-05-08,3,4922282
HSTA-05-09,3,4930271
HSTA-05-10,3,4913957
HSTA-05-10,3,4921804
HSTA-05-11,3,4930310
HSTA-05-11,3,4913969
HSTA-05-12,3,4930185
HSTA-05-12,3,4922271
HSTA-06-01,2,4922311
HSTA-06-02,3,4914044
HSTA-06-03,1,4930315
HSTA-06-03,3,4922319
HSTA-06-04,2,4914052
HSTA-06-04,2,4922133
HSTA-06-05,3,4930331
HSTA-06-05,3,4921838
HSTA-06-06,3,4914063
HSTA-06-07,3,4914066
HSTA-06-08,3,4914096
HSTA-06-09,3,4930350
HSTA-06-09,3,4922337
HSTA-06-10,3,4914076
HSTA-06-11,5,4930365
HSTA-06-11,3,4922343
HSTA-06-12,3,4914086
HSTA-06-13,3,4914088
HSTA-06-13,5,4922351
HSTA-06-14,3,4921850
HSTA-07-01,2,4914161
HSTA-07-02,3,4930447
HSTA-07-03,3,4930449
HSTA-07-04,3,4930452
HSTA-07-04,3,4914174
HSTA-07-05,3,4914176
HSTA-07-06,3,4914179
HSTA-07-07,2,4914181
HSTA-07-08,3,4930472
HSTA-07-09,3,4914189
HSTA-07-10,3,4914194
HSTA-07-11,2,4922392
HSTA-07-13,3,4930487
HSTA-07-14,3,4930489
M3S1-04-10,3,134976
M3S1-04-10,3,134974
M3S1-04-10,3,134972
M3S1-04-10,3,134970
M3S1-04-10,5,39109
M3S1-04-10,5,39108
M3S1-04-10,3,39107
M3S1-04-10,3,39106
M3S1-04-10,3,39105
M3S1-04-10,3,39104
H1S2-01-01,,2465700
H1S2-01-02,,2465305
H1S2-01-02,,2597136
H1S2-01-03,,2885563
H1S2-01-03,,2885587
H1S2-01-03,,2567222
H1S2-01-03,,2566837
H1S2-01-05,,2885572
H1S2-01-05,,2597148
H1S2-01-06,,2597159
H1S2-01-07,,2885603
H1S2-01-07,,2567233
H1S2-01-07,,2597174
H1S2-01-08,,2885607
H1S2-01-08,,2597166
H1S2-01-08,,2567246
H1S2-01-09,,2567252
H1S2-01-10,,2885614
H1S2-01-10,,2597526
H1S2-02-01,,2573930
H1S2-02-01,,2468422
H1S2-02-02,,2573959
H1S2-02-02,,2466793
H1S2-02-03,,2885698
H1S2-02-03,,2468459
H1S2-02-04,,2885712
H1S2-02-04,,2597590
H1S2-02-05,,2468435
H1S2-02-06,,2885716
H1S2-02-06,,2468466
H1S2-02-06,,2597609
H1S2-02-06,,2468464
H1S2-02-07,,2885722
H1S2-02-07,,2573996
H1S2-02-08,,2885726
H1S2-02-08,,2468453
H1S2-02-09,,2885728
H1S2-02-09,,2574021
H1S2-02-10,,2885736
H1S2-02-11,,2574522
H1S2-02-11,,2597625
H1S2-02-12,,2885746
H1S2-02-12,,2597633
H1S2-02-13,,2597643
H1S2-02-14,,2885753
H1S2-02-14,,2574431
H1S2-02-14,,2574464
H1S2-02-14,,2574501
H1S2-02-14,,2468505
H1S2-02-14,,2597648
H1S2-02-15,,2885762
H1S2-02-15,,2468922
H1S2-03-01,,2885838
H1S2-03-02,,2885841
H1S2-03-02,,2598051
H1S2-03-03,,2579384
H1S2-03-03,,2598081
H1S2-03-03,,2598057
H1S2-03-05,,2885844
H1S2-03-05,,2598071
H1S2-03-05,,2579365
H1S2-03-06,,2579400
H1S2-03-06,,2469060
HSTA-01-01,3,4928840
HSTA-01-02,3,4921505
HSTA-01-03,3,4913523
HSTA-01-04,5,4928869
HSTA-01-04,2,4921924
HSTA-01-05,3,4921929
HSTA-01-06,4,4913537
HSTA-01-07,3,4913539
HSTA-01-08,3,4913544
HSTA-01-09,3,4913547
HSTA-01-10,3,4921946
HSTA-02-01,1,4929639
HSTA-02-02,3,4929646
HSTA-02-03,3,4921979
HSTA-02-04,3,4929659
HSTA-02-05,2,4921623
HSTA-02-06,5,4929676
HSTA-02-07,3,4929677
HSTA-02-07,3,4921625
HSTA-02-09,3,4929703
HSTA-02-09,3,4921620
HSTA-02-10,4,4913629
HSTA-03-01,3,4913708
HSTA-03-02,3,4913713
HSTA-03-03,3,4913717
HSTA-03-04,3,4922032
HSTA-03-05,4,4913725
HSTA-03-06,3,4922039
HSTA-03-07,3,4913734
HSTA-03-07,3,4921676
HSTA-03-08,2,4921679
HSTA-03-09,3,4913766
HSTA-03-10,2,4922156
HSTA-03-11,4,4913755
HSTA-03-12,2,4913745
HSTA-03-12,3,4922166
HSTA-03-13,3,4921686
HSTA-03-14,3,4913756
HSTA-03-15,1,4929843
HSTA-03-15,3,4921692
HSTA-04-01,3,4913823
HSTA-04-02,3,4929907
HSTA-04-02,2,4922200
HSTA-04-03,3,4913834
HSTA-04-04,3,4929919
HSTA-04-04,3,4922206
HSTA-04-05,3,4913840
HSTA-04-05,3,4922212
HSTA-04-06,3,4921730
HSTA-04-08,3,4929936
HSTA-04-08,3,4922220
HSTA-04-09,3,4913855
HSTA-04-09,5,4922226
HSTA-04-10,3,4913862
HSTA-04-11,3,4929956
HSTA-04-11,3,4921741
HSTA-05-01,2,4913928
HSTA-05-02,1,4930150
HSTA-05-03,1,4913935
HSTA-05-03,1,4930157
HSTA-05-04,3,4922262
HSTA-05-05,3,4930180
HSTA-05-05,3,4921779
HSTA-05-06,3,4930189
HSTA-05-06,3,4913947
HSTA-05-07,3,4913949
HSTA-05-08,3,4913950
HSTA-05-09,3,4913953
HSTA-05-09,5,4930273
HSTA-05-10,2,4913958
HSTA-05-10,3,4921805
HSTA-05-11,5,4930311
HSTA-05-11,3,4913970
HSTA-05-12,3,4930186
HSTA-05-12,3,4922272
HSTA-06-01,2,4922312
HSTA-06-02,3,4914045
HSTA-06-03,3,4930316
HSTA-06-03,3,4922320
HSTA-06-04,3,4914053
HSTA-06-04,2,4922134
HSTA-06-05,3,4914055
HSTA-06-05,3,4921839
HSTA-06-06,3,4922327
HSTA-06-07,3,4914067
HSTA-06-08,3,4914097
HSTA-06-09,5,4930352
HSTA-06-09,3,4922338
HSTA-06-10,3,4914077
HSTA-06-11,3,4914078
HSTA-06-11,3,4922344
HSTA-06-12,3,4922346
HSTA-06-13,3,4914089
HSTA-06-14,3,4930376
HSTA-06-14,3,4922352
HSTA-07-01,2,4914162
HSTA-07-02,3,4930448
HSTA-07-03,3,4930450
HSTA-07-04,3,4930453
HSTA-07-04,4,4914175
HSTA-07-05,3,4914177
HSTA-07-06,3,4914180
HSTA-07-07,2,4914182
HSTA-07-08,2,4914186
HSTA-07-09,3,4914190
HSTA-07-10,2,4922390
HSTA-07-11,2,4922393
HSTA-07-13,3,4930488
HSTA-07-14,1,4930490
H1S1-08-02,3,2091221
H1S1-08-02,3,2091222
H1S1-08-02,3,2091223
H1S1-08-02,3,2910325
H1S1-08-02,3,2910326
H1S1-08-02,3,2910327
H1S2-01-01,,2465698
H1S2-01-02,,2465303
H1S2-01-02,,2597154
H1S2-01-03,,2885564
H1S2-01-03,,2566831
H1S2-01-03,,2465748
H1S2-01-03,,2566839
H1S2-01-05,,2885573
H1S2-01-05,,2597146
H1S2-01-06,,2597158
H1S2-01-07,,2885604
H1S2-01-07,,2567235
H1S2-01-07,,2597172
H1S2-01-08,,2885608
H1S2-01-08,,2597165
H1S2-01-08,,2567247
H1S2-01-09,,2567254
H1S2-01-10,,2885615
H1S2-01-10,,2597524
H1S2-02-01,,2573936
H1S2-02-02,,2885701
H1S2-02-02,,2573965
H1S2-02-02,,2468442
H1S2-02-03,,2885699
H1S2-02-03,,2468455
H1S2-02-04,,2573987
H1S2-02-05,,2885701
H1S2-02-05,,2468463
H1S2-02-06,,2885717
H1S2-02-06,,2468465
H1S2-02-06,,2597619
H1S2-02-06,,2597616
H1S2-02-07,,2885737
H1S2-02-07,,2468480
H1S2-02-08,,2885727
H1S2-02-08,,2468470
H1S2-02-09,,2885729
H1S2-02-09,,2574025
H1S2-02-11,,2885739
H1S2-02-11,,2574525
H1S2-02-11,,2597623
H1S2-02-12,,2574411
H1S2-02-12,,2597632
H1S2-02-13,,2597641
H1S2-02-14,,2885754
H1S2-02-14,,2574435
H1S2-02-14,,2574472
H1S2-02-14,,2574506
H1S2-02-14,,2468904
H1S2-02-14,,2597646
H1S2-02-15,,2885763
H1S2-02-15,,2468920
H1S2-03-01,,2579357
H1S2-03-02,,2579372
H1S2-03-03,,2885845
H1S2-03-03,,2468973
H1S2-03-03,,2598079
H1S2-03-04,,2885848
H1S2-03-05,,2469020
H1S2-03-05,,2598070
H1S2-03-06,,2885851
H1S2-03-06,,2579402
H1S2-03-06,,2469059
H1S2-03-06,,2598088
H1S2-03-07,,2885854
H1S2-03-07,,2579405
H1S2-03-07,,2469050
HSTA-01-01,3,4928841
HSTA-01-02,3,4921507
HSTA-01-03,3,4913524
HSTA-01-04,2,4928870
HSTA-01-04,3,4921925
HSTA-01-05,4,4921930
HSTA-01-06,2,4921932
HSTA-01-07,3,4913540
HSTA-01-08,3,4913545
HSTA-01-09,3,4913548
HSTA-01-10,3,4913562
HSTA-02-01,3,4929640
HSTA-02-02,3,4929648
HSTA-02-03,3,4921980
HSTA-02-04,3,4929663
HSTA-02-05,2,4921624
HSTA-02-06,4,4913639
HSTA-02-07,3,4929679
HSTA-02-07,3,4921626
HSTA-02-09,3,4929704
HSTA-02-09,3,4921621
HSTA-02-10,3,4921627
HSTA-03-01,3,4913709
HSTA-03-02,3,4922025
HSTA-03-03,3,4922028
HSTA-03-04,3,4922033
HSTA-03-05,3,4922036
HSTA-03-06,3,4922040
HSTA-03-07,4,4913735
HSTA-03-08,1,4929808
HSTA-03-08,2,4922150
HSTA-03-09,4,4913767
HSTA-03-10,2,4922157
HSTA-03-11,3,4922159
HSTA-03-12,3,4913746
HSTA-03-13,3,4929830
HSTA-03-13,3,4921687
HSTA-03-14,3,4913757
HSTA-03-15,1,4929844
HSTA-03-15,1,4922170
HSTA-04-01,2,4913824
HSTA-04-02,3,4929909
HSTA-04-02,2,4922201
HSTA-04-03,3,4922103
HSTA-04-04,3,4929920
HSTA-04-04,3,4922207
HSTA-04-05,3,4913841
HSTA-04-06,3,4929928
HSTA-04-06,3,4921731
HSTA-04-08,3,4929939
HSTA-04-09,3,4929943
HSTA-04-09,3,4913856
HSTA-04-09,3,4921734
HSTA-04-10,3,4913863
HSTA-04-11,3,4929958
HSTA-04-11,3,4921742
HSTA-05-01,3,4913929
HSTA-05-02,1,4930152
HSTA-05-03,3,4913936
HSTA-05-03,3,4930158
HSTA-05-04,3,4922263
HSTA-05-05,3,4930181
HSTA-05-05,3,4921780
HSTA-05-06,3,4930190
HSTA-05-06,3,4921786
HSTA-05-07,3,4922123
HSTA-05-08,3,4913951
HSTA-05-09,2,4913954
HSTA-05-09,3,4921801
HSTA-05-10,3,4913959
HSTA-05-10,3,4922286
HSTA-05-11,5,4930312
HSTA-05-11,3,4913971
HSTA-05-12,3,4913973
HSTA-06-01,2,4930165
HSTA-06-01,3,4922313
HSTA-06-02,3,4914046
HSTA-06-03,3,4930318
HSTA-06-04,2,4930319
HSTA-06-04,3,4914054
HSTA-06-04,3,4921834
HSTA-06-05,2,4914056
HSTA-06-06,3,4930332
HSTA-06-06,3,4922328
HSTA-06-07,3,4922330
HSTA-06-08,3,4914098
HSTA-06-09,5,4930353
HSTA-06-09,5,4922339
HSTA-06-10,3,4922340
HSTA-06-11,3,4914079
HSTA-06-11,3,4922345
HSTA-06-12,3,4922347
HSTA-06-13,4,4914090
HSTA-06-14,3,4930377
HSTA-06-14,3,4922353
HSTA-07-01,3,4914163
HSTA-07-02,3,4914164
HSTA-07-03,3,4930451
HSTA-07-04,3,4930454
HSTA-07-04,2,4922144
HSTA-07-05,4,4914178
HSTA-07-06,3,4921875
HSTA-07-07,3,4914183
HSTA-07-08,2,4914187
HSTA-07-09,3,4921882
HSTA-07-10,3,4922391
HSTA-07-11,3,4922394
HSTA-07-13,3,4914197
HSTA-07-14,3,4914200
HSU1-01-13,5,3367977
HSU1-01-13,3,3367975
HSU1-01-13,3,3367974
HSU1-01-13,3,3367972
HSU1-01-13,4,2927444
HSU1-01-13,4,2927439
HSU1-01-13,3,2740164
HSU1-01-13,3,2522896
HSU1-01-13,3,2522545
HSU1-02-18,5,3368979
HSU1-02-18,5,3368978
HSU1-02-18,3,3368977
HSU1-02-18,3,2927708
HSU1-02-18,3,2747387
H1S2-01-01,,2465312
H1S2-01-02,,2465301
H1S2-01-02,,2597152
H1S2-01-03,,2885577
H1S2-01-03,,2566832
H1S2-01-03,,2466175
H1S2-01-03,,2465707
H1S2-01-05,,2885574
H1S2-01-05,,2597161
H1S2-01-06,,2597156
H1S2-01-07,,2885605
H1S2-01-07,,2567237
H1S2-01-07,,2597190
H1S2-01-08,,2567285
H1S2-01-08,,2597187
H1S2-01-08,,2567248
H1S2-01-09,,2567258
H1S2-01-10,,2885616
H1S2-02-01,,2885695
H1S2-02-01,,2573938
H1S2-02-02,,2885702
H1S2-02-02,,2573968
H1S2-02-02,,2597581
H1S2-02-03,,2885700
H1S2-02-03,,2597593
H1S2-02-04,,2573990
H1S2-02-05,,2885702
H1S2-02-05,,2597588
H1S2-02-06,,2885718
H1S2-02-06,,2597597
H1S2-02-06,,2597618
H1S2-02-06,,2597628
H1S2-02-07,,2885738
H1S2-02-07,,2597626
H1S2-02-08,,2574001
H1S2-02-08,,2468468
H1S2-02-09,,2885730
H1S2-02-10,,2885732
H1S2-02-11,,2885740
H1S2-02-11,,2574527
H1S2-02-11,,2597621
H1S2-02-12,,2574418
H1S2-02-12,,2597630
H1S2-02-13,,2597639
H1S2-02-14,,2885757
H1S2-02-14,,2574441
H1S2-02-14,,2574477
H1S2-02-14,,2574508
H1S2-02-14,,2468522
H1S2-02-14,,2597645
H1S2-02-15,,2574512
H1S2-02-15,,2597669
H1S2-03-01,,2598028
H1S2-03-02,,2468998
H1S2-03-03,,2885846
H1S2-03-03,,2468971
H1S2-03-03,,2598077
H1S2-03-04,,2885849
H1S2-03-05,,2469018
HSTA-01-01,3,4928845
HSTA-01-02,3,4921918
HSTA-01-03,4,4913525
HSTA-01-04,3,4928871
HSTA-01-04,4,4921926
HSTA-01-05,4,4921931
HSTA-01-06,2,4921933
HSTA-01-07,4,4913541
HSTA-01-08,3,4922072
HSTA-01-09,4,4913549
HSTA-01-10,3,4913563
HSTA-02-01,3,4929642
HSTA-02-02,3,4929649
HSTA-02-03,3,4921981
HSTA-02-04,5,4929664
HSTA-02-05,2,4921595
HSTA-02-06,3,4913640
HSTA-02-07,3,4929680
HSTA-02-07,3,4921611
HSTA-02-09,3,4913630
HSTA-02-09,3,4921997
HSTA-02-10,3,4921614
HSTA-03-01,2,4922022
HSTA-03-02,3,4922026
HSTA-03-03,3,4922029
HSTA-03-04,3,4922034
HSTA-03-05,3,4922037
HSTA-03-06,3,4922041
HSTA-03-07,3,4913736
HSTA-03-08,1,4929809
HSTA-03-08,2,4922151
HSTA-03-09,3,4922153
HSTA-03-10,3,4922158
HSTA-03-11,3,4922160
HSTA-03-12,4,4913747
HSTA-03-13,1,4929832
HSTA-03-13,3,4921688
HSTA-03-14,3,4913758
HSTA-03-15,3,4929846
HSTA-03-15,3,4922173
HSTA-04-01,3,4913825
HSTA-04-02,5,4929910
HSTA-04-02,3,4922202
HSTA-04-03,3,4921720
HSTA-04-04,3,4913835
HSTA-04-04,5,4922208
HSTA-04-05,3,4913842
HSTA-04-06,3,4929929
HSTA-04-07,5,4929931
HSTA-04-08,3,4929940
HSTA-04-09,3,4929945
HSTA-04-09,3,4913857
HSTA-04-10,3,4929952
HSTA-04-10,3,4913864
HSTA-04-11,3,4929959
HSTA-04-11,3,4922230
HSTA-05-01,3,4913930
HSTA-05-02,3,4930154
HSTA-05-03,3,4913937
HSTA-05-03,3,4930163
HSTA-05-04,2,4930174
HSTA-05-05,3,4930182
HSTA-05-05,3,4921781
HSTA-05-06,3,4930191
HSTA-05-07,3,4922277
HSTA-05-07,4,4921784
HSTA-05-08,3,4913952
HSTA-05-09,3,4913955
HSTA-05-10,3,4930274
HSTA-05-10,3,4913960
HSTA-05-10,3,4922287
HSTA-05-11,3,4913964
HSTA-05-11,4,4913972
HSTA-05-12,3,4913974
HSTA-06-01,1,4930166
HSTA-06-01,3,4921824
HSTA-06-02,3,4922314
HSTA-06-03,3,4914047
HSTA-06-04,3,4930320
HSTA-06-04,2,4921829
HSTA-06-04,3,4921835
HSTA-06-05,3,4914057
HSTA-06-06,3,4930333
HSTA-06-06,3,4922329
HSTA-06-07,3,4922331
HSTA-06-08,4,4914099
HSTA-06-09,3,4914068
HSTA-06-10,3,4930355
HSTA-06-10,3,4922341
HSTA-06-11,3,4914080
HSTA-06-12,3,4930366
HSTA-06-12,5,4922348
HSTA-06-13,4,4914091
HSTA-06-14,5,4930378
HSTA-06-14,5,4922354
HSTA-07-01,2,4921872
HSTA-07-02,2,4914165
HSTA-07-03,3,4914167
HSTA-07-04,3,4930455
HSTA-07-04,2,4921874
HSTA-07-05,3,4922380
HSTA-07-06,3,4922381
HSTA-07-07,3,4914184
HSTA-07-08,3,4914188
HSTA-07-09,3,4922388
HSTA-07-11,2,4930480
HSTA-07-12,3,4930484
HSTA-07-13,3,4914198
HSTA-07-14,3,4914201
H1S2-01-01,,2885561
H1S2-01-01,,2465310
H1S2-01-02,,2465299
H1S2-01-02,,2597150
H1S2-01-03,,2885579
H1S2-01-03,,2567207
H1S2-01-03,,2597163
H1S2-01-03,,2465727
H1S2-01-05,,2885575
H1S2-01-06,,2567298
H1S2-01-07,,2885589
H1S2-01-07,,2567224
H1S2-01-07,,2567238
H1S2-01-08,,2885595
H1S2-01-08,,2567288
H1S2-01-08,,2597183
H1S2-01-09,,2885609
H1S2-01-09,,2567259
M1S1-01-01,2,2715690
M1S1-01-01,1,2715691
M1S1-01-01,1,2715692
M1S1-01-01,3,2715693
M1S1-01-01,3,2715694
M1S1-01-02,1,1601181
M1S1-01-02,1,1601183
M1S1-01-02,1,1601184
M1S1-01-02,1,1601186
M1S1-01-02,1,1601188
M1S1-01-02,1,1601190
M1S1-01-02,1,1601192
M1S1-01-02,1,1916289
M1S1-01-02,1,1916290
M1S1-01-02,3,1916291
M1S1-01-02,3,1916292
M1S1-01-02,3,2715695
M1S1-01-02,1,2715696
M1S1-01-02,3,2715697
M1S1-01-02,3,2715698
M1S1-01-02,3,2715699
M1S1-01-02,3,2715700
M1S1-01-02,1,2715701
M1S1-01-02,3,2715702
M1S1-01-02,3,2715703
M1S1-01-02,1,3621563
M1S1-01-02,1,3621564
M1S1-01-02,1,3621565
M1S1-01-02,1,3621566
M1S1-01-02,1,3621567
M1S1-01-02,1,3621568
M1S1-01-02,1,3621570
M1S1-01-02,1,3621576
M1S1-01-02,1,3621580
M1S1-01-02,1,3621582
M1S1-01-02,1,3621583
M1S1-01-02,1,3621584
M1S1-01-02,1,3621585
M1S1-01-02,1,3621586
M1S1-01-03,1,1601229
M1S1-01-03,1,1601230
M1S1-01-03,1,1601231
M1S1-01-03,1,1601232
M1S1-01-03,1,1601233
M1S1-01-03,1,1601234
M1S1-01-03,1,1601235
M1S1-01-03,1,1601236
M1S1-01-03,1,1601237
M1S1-01-03,1,1601238
M1S1-01-03,1,1601239
M1S1-01-03,1,1601240
M1S1-01-03,1,1601241
M1S1-01-03,1,1601242
M1S1-01-03,1,1601243
M1S1-01-03,3,1916293
H1S2-01-10,,2567267
H1S2-02-01,,2885696
H1S2-02-01,,2573941
M1S1-01-03,2,1916294
M1S1-01-03,2,1916295
M1S1-01-03,3,1916296
M1S1-01-03,1,2715704
M1S1-01-03,1,2715705
M1S1-01-03,3,2715706
M1S1-01-03,3,2715707
M1S1-01-03,3,2715708
M1S1-01-03,3,2715709
M1S1-01-03,1,3621587
M1S1-01-03,1,3621658
M1S1-01-03,1,3621659
M1S1-01-03,1,3621662
M1S1-01-03,1,3621663
M1S1-01-03,1,3621664
M1S1-01-03,1,3621665
M1S1-01-03,1,3621666
M1S1-01-03,1,3621667
M1S1-01-03,1,3621668
M1S1-01-03,1,3621669
M1S1-01-03,1,3621670
M1S1-01-03,1,3621671
M1S1-01-03,1,3621672
M1S1-01-03,1,3621673
M1S1-01-03,1,3621674
M1S1-01-03,1,3621675
M1S1-01-04,2,1601248
M1S1-01-04,1,1601266
M1S1-01-04,1,1601267
M1S1-01-04,1,1601268
M1S1-01-04,1,1601269
M1S1-01-04,1,1601270
M1S1-01-04,2,1601271
M1S1-01-04,1,1601335
M1S1-01-04,2,1916297
M1S1-01-04,1,1916299
M1S1-01-04,2,1916300
M1S1-01-04,3,1916301
M1S1-01-04,2,1916304
M1S1-01-04,1,1916307
M1S1-01-04,2,1916310
M1S1-01-04,3,1916316
M1S1-01-04,3,2715710
M1S1-01-04,1,2715711
M1S1-01-04,3,2715712
M1S1-01-04,3,2715713
M1S1-01-04,1,2715714
M1S1-01-04,3,2715715
M1S1-01-04,3,2715716
M1S1-01-04,3,2715717
M1S1-01-04,1,2715718
M1S1-01-04,3,2715719
M1S1-01-04,3,2715720
M1S1-01-04,2,3617143
M1S1-01-04,2,3617144
M1S1-01-04,1,3621683
M1S1-01-04,1,3621684
M1S1-01-04,1,3621685
M1S1-01-04,1,3621686
M1S1-01-04,1,3621687
M1S1-01-04,1,3621688
M1S1-01-04,2,3621747
M1S1-01-04,2,3621748
M1S1-01-04,2,3621750
M1S1-01-04,2,3621823
M1S1-01-04,2,3621830
M1S1-01-05,3,1916329
M1S1-01-05,4,1916330
M1S1-01-05,4,1916331
M1S1-01-05,5,1916332
M1S1-01-05,3,2715721
M1S1-01-05,1,2715722
M1S1-01-05,3,2715723
M1S1-01-05,3,2715724
M1S1-01-05,3,2715725
M1S1-01-05,3,2715726
M1S1-01-05,3,2715727
M1S1-01-05,3,2715728
M1S1-01-05,3,2715729
M1S1-01-05,5,2715730
M1S1-01-05,3,3621863
M1S1-01-05,3,3621864
M1S1-01-05,3,3621865
M1S1-01-05,1,3621873
M1S1-01-05,1,3621876
M1S1-01-05,1,3621914
M1S1-01-05,2,3621920
M1S1-01-05,2,3621930
M1S1-01-05,2,3621934
M1S1-01-05,2,3621937
M1S1-01-05,2,3621940
M1S1-01-05,2,3621951
M1S1-01-05,2,3621953
M1S1-01-05,2,3621954
M1S1-01-05,2,3621955
M1S1-01-05,2,3621957
M1S1-01-05,2,3621959
M1S1-01-06,2,1601317
M1S1-01-06,1,1601336
M1S1-01-06,2,1916319
M1S1-01-06,2,1916321
M1S1-01-06,2,1916322
M1S1-01-06,4,1916323
M1S1-01-06,1,2715731
M1S1-01-06,1,2715732
M1S1-01-06,3,2715733
M1S1-01-06,3,2715734
M1S1-01-06,3,2715735
M1S1-01-06,5,2715736
M1S1-01-07,2,1601326
M1S1-01-07,2,1601327
M1S1-01-07,2,1601328
M1S1-01-07,2,1601329
M1S1-01-07,2,1601330
M1S1-01-07,2,1601331
M1S1-01-07,2,1601332
M1S1-01-07,2,1601333
M1S1-01-07,2,1601337
M1S1-01-07,2,1916325
M1S1-01-07,2,1916326
M1S1-01-07,2,1916327
M1S1-01-07,3,1916328
M1S1-01-07,3,2715737
M1S1-01-07,1,2715738
M1S1-01-07,1,2715739
M1S1-01-07,3,2715740
M1S1-01-07,3,2715741
M1S1-01-07,5,2715742
M1S1-01-08,5,1916333
M1S1-01-08,5,1916334
M1S1-01-08,3,2715743
M1S1-01-08,3,2715744
M1S1-01-08,3,2715745
M1S1-01-08,5,2715746
M1S1-01-08,3,2715747
M1S1-01-08,5,2715748
M1S1-01-09,5,1916335
M1S1-01-09,5,1916336
M1S1-01-09,4,2715749
M1S1-01-09,3,2715750
M1S1-01-09,5,2715754
M1S1-02-01,1,1601494
M1S1-02-01,1,1601495
M1S1-02-01,1,1601496
M1S1-02-01,1,1601497
M1S1-02-01,1,1601498
M1S1-02-01,1,1601499
M1S1-02-01,1,1601500
M1S1-02-01,1,1601501
M1S1-02-01,2,1601502
M1S1-02-01,2,1601503
M1S1-02-01,2,1601504
M1S1-02-01,2,1601505
M1S1-02-01,2,1601506
M1S1-02-01,2,1601507
M1S1-02-01,1,1601508
M1S1-02-01,1,1601509
M1S1-02-01,1,1601755
M1S1-02-01,1,1601756
M1S1-02-01,1,1601757
M1S1-02-01,2,1601758
M1S1-02-01,2,1601759
M1S1-02-01,2,1601760
M1S1-02-01,1,1918050
M1S1-02-01,1,1918051
M1S1-02-01,3,1918052
M1S1-02-01,4,1918053
M1S1-02-01,1,1918057
M1S1-02-01,2,1918058
M1S1-02-01,3,1918059
M1S1-02-01,3,1918060
M1S1-02-01,1,2715886
M1S1-02-01,1,2715887
M1S1-02-01,3,2715888
M1S1-02-01,1,2715895
M1S1-02-01,1,2715896
M1S1-02-01,1,2715897
M1S1-02-01,3,2715898
M1S1-02-01,3,2715899
M1S1-02-01,3,2715900
M1S1-02-01,5,2715901
M1S1-02-01,1,3622197
M1S1-02-01,1,3622199
M1S1-02-01,1,3622201
M1S1-02-01,1,3622203
M1S1-02-01,1,3622249
M1S1-02-01,1,3622252
M1S1-02-01,1,3622256
M1S1-02-01,1,3622260
M1S1-02-01,1,3622263
M1S1-02-01,1,3622266
M1S1-02-01,2,3622275
M1S1-02-01,2,3622279
M1S1-02-01,2,3622361
M1S1-02-01,1,3622481
M1S1-02-01,1,3622482
M1S1-02-01,1,3622483
M1S1-02-01,1,3622484
M1S1-02-01,1,3622485
M1S1-02-01,1,3622486
M1S1-02-01,1,3622494
M1S1-02-01,1,3622497
M1S1-02-01,1,3622500
M1S1-02-01,1,3622502
M1S1-02-01,1,3622506
M1S1-02-01,1,3622510
M1S1-02-01,1,3622569
M1S1-02-01,1,3622570
M1S1-02-01,1,3622571
M1S1-02-02,1,1918054
M1S1-02-02,2,1918055
M1S1-02-02,3,1918056
M1S1-02-02,3,2715889
M1S1-02-02,1,2715890
M1S1-02-02,3,2715891
M1S1-02-02,3,2715892
M1S1-02-02,3,2715893
M1S1-02-02,5,2715894
M1S1-02-03,1,1601808
M1S1-02-03,1,1601809
M1S1-02-03,1,1601810
M1S1-02-03,1,1601811
M1S1-02-03,1,1601812
M1S1-02-03,1,1601813
M1S1-02-03,1,1601814
M1S1-02-03,1,1601815
M1S1-02-03,1,1601816
M1S1-02-03,1,1601817
M1S1-02-03,1,1601818
M1S1-02-03,1,1601819
M1S1-02-03,1,1601820
M1S1-02-03,1,1601821
M1S1-02-03,1,1918061
M1S1-02-03,1,1918062
M1S1-02-03,2,1918063
M1S1-02-03,3,1918064
M1S1-02-03,2,1918065
M1S1-02-03,2,1918066
M1S1-02-03,3,1918067
M1S1-02-03,3,1918068
M1S1-02-03,2,2715902
M1S1-02-03,1,2715903
M1S1-02-03,3,2715904
M1S1-02-03,3,2715906
M1S1-02-03,2,2715907
M1S1-02-03,1,2715908
M1S1-02-03,3,2715909
M1S1-02-03,3,2715910
M1S1-02-03,5,2715911
M1S1-02-03,1,3622799
M1S1-02-03,1,3622800
M1S1-02-03,1,3622801
M1S1-02-03,1,3622803
M1S1-02-03,1,3622805
M1S1-02-03,1,3622807
M1S1-02-03,1,3622809
M1S1-02-03,1,3622811
M1S1-02-03,1,3622813
M1S1-02-03,1,3622814
M1S1-02-03,1,3622816
M1S1-02-03,1,3622818
M1S1-02-03,1,3622820
M1S1-02-03,1,3622822
M1S1-02-03,1,3622824
M1S1-02-03,1,3622977
M1S1-02-03,1,3622979
M1S1-02-03,1,3622981
M1S1-02-03,1,3622983
M1S1-02-03,1,3622985
M1S1-02-03,1,3622987
M1S1-02-03,1,3622991
M1S1-02-03,1,3622993
M1S1-02-03,1,3622995
M1S1-02-03,1,3622997
M1S1-02-03,1,3622998
M1S1-02-03,1,3622999
M1S1-02-03,1,3623004
M1S1-02-03,1,3623006
M1S1-02-03,1,3623007
M1S1-02-04,3,1918069
M1S1-02-04,1,1918070
M1S1-02-04,3,1918072
M1S1-02-04,3,1918073
M1S1-02-04,3,1918074
M1S1-02-04,3,1918076
M1S1-02-04,4,1918077
M1S1-02-04,2,1918078
M1S1-02-04,2,1918079
M1S1-02-04,2,1918081
M1S1-02-04,4,1918083
M1S1-02-04,2,1918085
M1S1-02-04,3,1918086
M1S1-02-04,4,1918090
M1S1-02-04,4,1918092
M1S1-02-04,5,1918455
M1S1-02-04,5,1918457
M1S1-02-04,3,2715912
M1S1-02-04,3,2715913
M1S1-02-04,3,2715914
M1S1-02-04,3,2715915
M1S1-02-04,3,2715916
M1S1-02-04,3,2715917
M1S1-02-04,3,2715918
M1S1-02-04,3,2715919
M1S1-02-04,5,2715920
M1S1-02-04,1,2715968
M1S1-02-04,3,2715969
M1S1-02-04,3,2715970
M1S1-02-05,1,1601510
M1S1-02-05,1,1601511
M1S1-02-05,1,1601512
M1S1-02-05,1,1918094
M1S1-02-05,3,1918097
M1S1-02-05,3,1918101
M1S1-02-05,1,2715921
M1S1-02-05,1,2715922
M1S1-02-05,3,2715923
M1S1-02-05,3,2715924
M1S1-02-05,3,2715925
M1S1-02-05,5,2715926
M1S1-02-05,1,3622220
M1S1-02-05,2,3622223
M1S1-02-05,1,3622558
M1S1-02-05,1,3622559
M1S1-02-06,2,1601660
M1S1-02-06,2,1601661
M1S1-02-06,3,1601663
M1S1-02-06,3,1918261
M1S1-02-06,3,1918263
M1S1-02-06,3,1918266
M1S1-02-06,1,2715927
M1S1-02-06,3,2715928
M1S1-02-06,3,2715929
M1S1-02-06,3,2715930
M1S1-02-06,1,3622227
M1S1-02-06,2,3622229
M1S1-02-06,1,3622562
M1S1-02-06,1,3622565
M1S1-02-07,3,1918269
M1S1-02-07,3,1918271
M1S1-02-07,4,1918274
M1S1-02-07,3,2715931
M1S1-02-07,3,2715932
M1S1-02-07,3,2715933
M1S1-02-07,3,2715934
M1S1-02-08,1,1601665
M1S1-02-08,1,1601667
M1S1-02-08,2,1601670
M1S1-02-08,3,1918276
M1S1-02-08,3,1918278
M1S1-02-08,3,1918279
M1S1-02-08,4,1918283
M1S1-02-08,3,2715935
M1S1-02-08,3,2715936
M1S1-02-08,3,2715937
M1S1-02-08,3,2715938
M1S1-02-08,5,2715939
M1S1-02-08,5,2715940
M1S1-02-09,1,1601895
M1S1-02-09,1,1601897
M1S1-02-09,2,1601899
M1S1-02-09,3,1601900
M1S1-02-09,3,1601902
M1S1-02-09,3,1918428
M1S1-02-09,2,1918430
M1S1-02-09,3,1918434
M1S1-02-09,3,1918436
M1S1-02-09,2,2715941
M1S1-02-09,1,2715942
M1S1-02-09,3,2715943
M1S1-02-09,3,2715944
M1S1-02-09,5,2715945
M1S1-02-10,3,1918421
M1S1-02-10,2,1918423
M1S1-02-10,3,1918425
M1S1-02-10,3,2715946
M1S1-02-10,3,2715947
M1S1-02-10,3,2715948
M1S1-02-11,1,1601940
M1S1-02-11,2,1601941
M1S1-02-11,3,1601942
M1S1-02-11,2,1918303
M1S1-02-11,2,1918307
M1S1-02-11,2,1918312
M1S1-02-11,3,1918328
M1S1-02-11,1,2715949
M1S1-02-11,3,2715950
M1S1-02-11,3,2715951
M1S1-02-11,3,2715952
M1S1-02-12,1,1601943
M1S1-02-12,1,1601944
M1S1-02-12,3,1601956
M1S1-02-12,3,1918440
M1S1-02-12,3,1918442
M1S1-02-12,3,1918444
M1S1-02-12,4,1918445
M1S1-02-12,3,2715955
M1S1-02-12,3,2715956
M1S1-02-12,5,2715957
M1S1-02-12,3,2715958
M1S1-02-12,3,2715959
M1S1-02-12,5,2715960
M1S1-02-13,1,1601987
M1S1-02-13,1,1601989
M1S1-02-13,2,1601991
M1S1-02-13,2,1601992
M1S1-02-13,3,1918446
M1S1-02-13,3,1918447
M1S1-02-13,3,1918449
M1S1-02-13,4,1918452
M1S1-02-13,3,2715961
M1S1-02-13,3,2715962
M1S1-02-13,3,2715963
M1S1-02-13,3,2715964
M1S1-02-13,3,2715965
M1S1-02-13,3,2715966
M1S1-02-13,5,2715967
M1S1-02-14,1,1601993
M1S1-02-14,1,1601994
M1S1-02-14,3,1918460
M1S1-02-14,5,1918463
M1S1-02-14,5,1918465
M1S1-02-14,5,1918467
M1S1-02-14,5,1918474
M1S1-02-14,3,2715971
M1S1-02-14,1,2715972
M1S1-02-14,3,2715973
M1S1-02-14,5,2715974
M1S1-02-14,5,2715975
M1S1-02-14,3,2715976
M1S1-02-14,1,2715977
M1S1-02-14,3,2715978
M1S1-03-01,1,1602315
M1S1-03-01,1,1602316
M1S1-03-01,1,1602317
M1S1-03-01,1,1602318
M1S1-03-01,1,1602319
M1S1-03-01,1,1602320
M1S1-03-01,1,1602321
M1S1-03-01,1,1602323
M1S1-03-01,1,1602324
M1S1-03-01,1,1602325
M1S1-03-01,1,1602327
M1S1-03-01,1,1919625
M1S1-03-01,1,1919627
M1S1-03-01,1,1919628
M1S1-03-01,1,2718341
M1S1-03-01,1,2718342
M1S1-03-01,3,2718343
M1S1-03-01,1,3623072
M1S1-03-01,1,3623312
M1S1-03-01,1,3623315
M1S1-03-01,1,3623319
M1S1-03-01,1,3623334
M1S1-03-01,1,3623340
M1S1-03-02,2,1602333
M1S1-03-02,2,1602334
M1S1-03-02,2,1602335
M1S1-03-02,2,1602336
M1S1-03-02,1,1602338
M1S1-03-02,1,1602339
M1S1-03-02,2,1602341
M1S1-03-02,2,1602342
M1S1-03-02,2,1602344
M1S1-03-02,2,1602346
M1S1-03-02,2,1602348
M1S1-03-02,2,1602349
M1S1-03-02,2,1602350
M1S1-03-02,3,1602351
M1S1-03-02,1,1919630
M1S1-03-02,1,1919631
M1S1-03-02,2,1919632
M1S1-03-02,2,1919634
M1S1-03-02,3,1919636
M1S1-03-02,3,1919637
M1S1-03-02,3,1919638
M1S1-03-02,1,2718344
M1S1-03-02,1,2718345
M1S1-03-02,3,2718346
M1S1-03-02,1,2718347
M1S1-03-02,1,2718348
M1S1-03-02,3,2718349
M1S1-03-02,3,2718350
M1S1-03-02,3,2718351
M1S1-03-02,3,2718352
M1S1-03-02,1,3623266
M1S1-03-02,1,3623347
M1S1-03-02,2,3623351
M1S1-03-02,2,3623353
M1S1-03-02,2,3623356
M1S1-03-02,2,3623367
M1S1-03-02,2,3623380
M1S1-03-02,2,3623401
M1S1-03-02,2,3623405
M1S1-03-03,1,1602471
M1S1-03-03,1,1602472
M1S1-03-03,1,1919640
M1S1-03-03,1,1919641
M1S1-03-03,1,1919642
M1S1-03-03,2,1919643
M1S1-03-03,3,1919646
M1S1-03-03,3,1919647
M1S1-03-03,1,2718353
M1S1-03-03,3,2718354
M1S1-03-03,3,2718355
M1S1-03-03,3,2718356
M1S1-03-03,1,3623415
M1S1-03-03,1,3623418
M1S1-03-04,3,1919648
M1S1-03-04,3,1919650
M1S1-03-04,4,1919651
M1S1-03-04,3,2718357
M1S1-03-04,1,2718358
M1S1-03-04,3,2718359
M1S1-03-04,5,2718360
M1S1-03-05,1,1602466
M1S1-03-05,1,1602467
M1S1-03-05,1,1602468
M1S1-03-05,1,1602469
M1S1-03-05,1,1602470
M1S1-03-05,1,1919652
M1S1-03-05,3,1919653
M1S1-03-05,3,1919654
M1S1-03-05,3,1919655
M1S1-03-05,4,1919656
M1S1-03-05,3,1919658
M1S1-03-05,3,1919660
M1S1-03-05,3,1919722
M1S1-03-05,3,1919723
M1S1-03-05,1,2718361
M1S1-03-05,1,2718362
M1S1-03-05,1,2718363
M1S1-03-05,3,2718364
M1S1-03-05,3,2718365
M1S1-03-05,5,2718366
M1S1-03-05,3,2718367
M1S1-03-05,3,2718368
M1S1-03-05,3,2718369
M1S1-03-05,3,2718370
M1S1-03-05,1,3621562
M1S1-03-06,2,1919728
M1S1-03-06,2,1919729
M1S1-03-06,2,1919730
M1S1-03-06,3,1919731
M1S1-03-06,2,2718371
M1S1-03-06,3,2718372
M1S1-03-06,3,2718373
M1S1-03-07,2,1919724
M1S1-03-07,2,1919725
M1S1-03-07,2,1919726
M1S1-03-07,3,1919727
M1S1-03-07,2,2718374
M1S1-03-07,3,2718375
M1S1-03-07,3,2718376
M1S1-03-07,5,2718377
M1S1-03-07,3,2718378
M1S1-03-07,1,2718379
M1S1-03-07,3,2718380
M1S1-03-07,3,2718381
M1S1-03-08,1,1602562
M1S1-03-08,1,1602564
M1S1-03-08,1,1602565
M1S1-03-08,1,1602567
M1S1-03-08,1,1602570
M1S1-03-08,1,1602571
M1S1-03-08,1,1602573
M1S1-03-08,1,1602574
M1S1-03-08,3,1919732
M1S1-03-08,2,1919733
M1S1-03-08,2,1919734
M1S1-03-08,3,1919735
M1S1-03-08,3,1919736
M1S1-03-08,3,1919737
M1S1-03-08,3,1919738
M1S1-03-08,1,1919739
M1S1-03-08,1,1919740
M1S1-03-08,1,1919741
M1S1-03-08,1,1919742
M1S1-03-08,1,2718382
M1S1-03-08,1,2718383
M1S1-03-08,1,2718384
M1S1-03-08,3,2718385
M1S1-03-08,5,2718386
M1S1-03-08,1,3623589
M1S1-03-08,1,3623590
M1S1-03-08,1,3623591
M1S1-03-08,1,3623592
M1S1-03-08,1,3623593
M1S1-03-08,1,3623595
M1S1-03-08,1,3623596
M1S1-03-08,1,3623597
M1S1-03-08,2,3623630
M1S1-03-08,2,3623631
M1S1-03-08,1,3623668
M1S1-03-08,1,3623670
M1S1-03-08,1,3623671
M1S1-03-08,1,3623673
M1S1-03-08,2,3623680
M1S1-03-08,2,3623682
M1S1-03-08,2,3623684
M1S1-03-08,2,3623692
M1S1-03-08,2,3623693
M1S1-03-09,1,1602576
M1S1-03-09,1,1602578
M1S1-03-09,5,1919750
M1S1-03-09,5,1919751
M1S1-03-09,5,1919752
M1S1-03-09,1,2718387
M1S1-03-09,1,2718388
M1S1-03-09,1,2718389
M1S1-03-09,3,2718390
M1S1-03-09,5,2718391
M1S1-03-09,1,2718392
M1S1-03-09,1,2718393
M1S1-03-09,1,2718394
M1S1-03-09,3,2718395
M1S1-03-10,1,1919743
M1S1-03-10,1,1919744
M1S1-03-10,2,1919745
M1S1-03-10,4,1919746
M1S1-03-10,3,1919747
M1S1-03-10,4,1919748
M1S1-03-10,5,1919749
M1S1-03-10,1,2718396
M1S1-03-10,1,2718397
M1S1-03-10,3,2718398
M1S1-03-10,3,2718399
M1S1-03-10,3,2718400
M1S1-03-10,5,2718401
M1S1-04-01,1,1602645
M1S1-04-01,1,1602647
M1S1-04-01,1,1602649
M1S1-04-01,1,1602651
M1S1-04-01,1,1602652
M1S1-04-01,1,1602653
M1S1-04-01,1,1602654
M1S1-04-01,1,1602655
M1S1-04-01,1,1602725
M1S1-04-01,1,1602726
M1S1-04-01,1,1602728
M1S1-04-01,1,1602730
M1S1-04-01,1,1602731
M1S1-04-01,1,1602732
M1S1-04-01,1,1602734
M1S1-04-01,1,1602735
M1S1-04-01,1,1602738
M1S1-04-01,1,1602740
M1S1-04-01,2,1939945
M1S1-04-01,1,1939946
M1S1-04-01,2,1939947
M1S1-04-01,2,2718501
M1S1-04-01,1,2718502
M1S1-04-01,3,2718503
M1S1-04-01,3,2718504
M1S1-04-01,1,3623800
M1S1-04-01,1,3623803
M1S1-04-01,1,3623806
M1S1-04-01,1,3623808
M1S1-04-01,1,3623899
M1S1-04-01,1,3623900
M1S1-04-01,1,3623901
M1S1-04-01,1,3623902
M1S1-04-01,1,3623904
M1S1-04-01,1,3623905
M1S1-04-01,1,3623906
M1S1-04-01,1,3623907
M1S1-04-01,1,3623908
M1S1-04-01,1,3623909
M1S1-04-01,1,3623910
M1S1-04-01,1,3623911
M1S1-04-01,1,3623912
M1S1-04-01,1,3623913
M1S1-04-01,1,3623914
M1S1-04-01,1,3623915
M1S1-04-02,1,1602741
M1S1-04-02,1,1602743
M1S1-04-02,1,1602744
M1S1-04-02,1,1602745
M1S1-04-02,1,1602746
M1S1-04-02,1,1602747
M1S1-04-02,1,1939948
M1S1-04-02,2,1939949
M1S1-04-02,2,1939950
M1S1-04-02,1,2718505
M1S1-04-02,1,2718506
M1S1-04-02,3,2718507
M1S1-04-02,1,3623917
M1S1-04-02,1,3623918
M1S1-04-02,1,3623919
M1S1-04-02,1,3623920
M1S1-04-02,1,3623921
M1S1-04-02,1,3623922
M1S1-04-02,1,3623923
M1S1-04-02,1,3624065
M1S1-04-02,1,3624067
M1S1-04-02,1,3624069
M1S1-04-02,1,3624071
M1S1-04-02,1,3624073
M1S1-04-03,1,1602834
M1S1-04-03,1,1602835
M1S1-04-03,1,1602836
M1S1-04-03,1,1602838
M1S1-04-03,1,1602839
M1S1-04-03,1,1602840
M1S1-04-03,1,1602841
M1S1-04-03,1,1602842
M1S1-04-03,1,1602843
M1S1-04-03,1,1602844
M1S1-04-03,1,1602845
M1S1-04-03,1,1602846
M1S1-04-03,1,1602847
M1S1-04-03,1,1602848
M1S1-04-03,1,1602849
M1S1-04-03,1,1602850
M1S1-04-03,1,1939951
M1S1-04-03,2,1939952
M1S1-04-03,3,1939953
M1S1-04-03,1,2718508
M1S1-04-03,1,2718509
M1S1-04-03,3,2718510
M1S1-04-03,3,2718511
M1S1-04-03,3,2718512
M1S1-04-03,1,2718513
M1S1-04-03,1,2718514
M1S1-04-03,1,3624080
M1S1-04-03,1,3624081
M1S1-04-03,1,3624082
M1S1-04-03,1,3624083
M1S1-04-03,1,3624084
M1S1-04-03,1,3624085
M1S1-04-03,1,3624086
M1S1-04-03,1,3624087
M1S1-04-03,1,3624088
M1S1-04-03,1,3624089
M1S1-04-03,1,3624090
M1S1-04-03,1,3624091
M1S1-04-03,1,3624092
M1S1-04-03,1,3624093
M1S1-04-03,1,3624094
M1S1-04-03,1,3624095
M1S1-04-03,1,3624096
M1S1-04-03,1,3624097
M1S1-04-03,1,3624348
M1S1-04-03,1,3624349
M1S1-04-03,1,3624350
M1S1-04-03,1,3624351
M1S1-04-03,1,3624352
M1S1-04-03,1,3624353
M1S1-04-04,1,1602865
M1S1-04-04,1,1602866
M1S1-04-04,1,1602867
M1S1-04-04,1,1602868
M1S1-04-04,1,1602869
M1S1-04-04,1,1602870
M1S1-04-04,1,1602871
M1S1-04-04,1,1602872
M1S1-04-04,1,1602873
M1S1-04-04,1,1602874
M1S1-04-04,1,1602875
M1S1-04-04,1,1602876
M1S1-04-04,1,1602877
M1S1-04-04,2,1939954
M1S1-04-04,2,1939955
M1S1-04-04,2,1939956
M1S1-04-04,2,1939957
M1S1-04-04,2,1939958
M1S1-04-04,3,1939959
M1S1-04-04,3,1939960
M1S1-04-04,2,1939961
M1S1-04-04,3,1939962
M1S1-04-04,3,1939963
M1S1-04-04,3,1939967
M1S1-04-04,3,1939968
M1S1-04-04,3,1939969
M1S1-04-04,3,1939970
M1S1-04-04,3,1939971
M1S1-04-04,3,1939972
M1S1-04-04,3,2718515
M1S1-04-04,3,2718516
M1S1-04-04,3,2718517
M1S1-04-04,3,2718518
M1S1-04-04,3,2718519
M1S1-04-04,5,2718520
M1S1-04-04,1,3624354
M1S1-04-04,1,3624356
M1S1-04-04,1,3624357
M1S1-04-04,2,3624358
M1S1-04-04,2,3624359
M1S1-04-04,2,3624360
M1S1-04-04,1,3624361
M1S1-04-04,1,3624362
M1S1-04-04,2,3624485
M1S1-04-04,2,3624491
M1S1-04-04,2,3624494
M1S1-04-04,1,3624606
M1S1-04-04,1,3624611
M1S1-04-04,2,3624616
M1S1-04-04,2,3624621
M1S1-04-04,3,3624626
M1S1-04-04,1,3624693
M1S1-04-04,1,3624694
M1S1-04-04,1,3624695
M1S1-04-04,2,3624696
M1S1-04-04,2,3624697
M1S1-04-05,2,1939973
M1S1-04-05,2,1939974
M1S1-04-05,3,1939975
M1S1-04-05,3,1939976
M1S1-04-05,3,2718521
M1S1-04-05,3,2718522
M1S1-04-05,3,2718523
M1S1-04-05,5,2718524
M1S1-04-05,5,2718525
M1S1-04-06,3,1939977
M1S1-04-06,2,1939981
M1S1-04-06,2,1939982
M1S1-04-06,3,1939983
M1S1-04-06,1,2718526
M1S1-04-06,1,2718527
M1S1-04-06,3,2718528
M1S1-04-06,5,2718529
M1S1-04-07,3,1939984
M1S1-04-07,3,1939985
M1S1-04-07,3,1939986
M1S1-04-07,4,1939987
M1S1-04-07,3,2718530
M1S1-04-07,1,2718531
M1S1-04-07,3,2718532
M1S1-04-07,3,2718533
M1S1-04-08,3,1939988
M1S1-04-08,3,1939989
M1S1-04-08,4,1939990
M1S1-04-08,1,2718534
M1S1-04-08,1,2718535
M1S1-04-08,3,2718536
M1S1-04-08,3,2718537
M1S1-04-08,2,2718538
M1S1-04-08,3,2718539
M1S1-04-08,3,2718540
M1S1-04-08,3,2718541
M1S1-04-08,3,2718542
M1S1-04-08,3,2718543
M1S1-04-08,3,2718544
M1S1-04-08,5,2718545
M1S1-04-09,1,1603155
M1S1-04-09,1,1603157
M1S1-04-09,1,1603158
M1S1-04-09,1,1603159
M1S1-04-09,1,1603161
M1S1-04-09,1,1603162
M1S1-04-09,1,1603163
M1S1-04-09,1,1603165
M1S1-04-09,1,1603166
M1S1-04-09,1,1603168
M1S1-04-09,1,1603169
M1S1-04-09,1,1603170
M1S1-04-09,1,1603172
M1S1-04-09,1,1603174
M1S1-04-09,1,1603175
M1S1-04-09,1,1603177
M1S1-04-09,2,1939991
M1S1-04-09,2,1939992
M1S1-04-09,3,1939993
M1S1-04-09,4,1939994
M1S1-04-09,3,2718546
M1S1-04-09,1,2718547
M1S1-04-09,3,2718548
M1S1-04-09,5,2718549
M1S1-04-09,1,3624744
M1S1-04-09,1,3624745
M1S1-04-09,1,3624746
M1S1-04-09,1,3624747
M1S1-04-09,1,3624748
M1S1-04-09,1,3624749
M1S1-04-09,1,3624750
M1S1-04-09,1,3624751
M1S1-04-09,1,3624752
M1S1-04-09,1,3624753
M1S1-04-09,1,3624754
M1S1-04-09,1,3624755
M1S1-04-10,1,1603246
M1S1-04-10,1,1603249
M1S1-04-10,1,1603250
M1S1-04-10,1,1603252
M1S1-04-10,1,1603253
M1S1-04-10,1,1603256
M1S1-04-10,1,1603257
M1S1-04-10,1,1603259
M1S1-04-10,1,1603260
M1S1-04-10,1,1603261
M1S1-04-10,1,1939998
M1S1-04-10,1,1939999
M1S1-04-10,1,2718550
M1S1-04-10,1,2718551
M1S1-04-10,1,3624756
M1S1-04-10,1,3624757
M1S1-04-10,1,3624758
M1S1-04-10,1,3624759
M1S1-04-10,2,3625045
M1S1-04-10,1,3625046
M1S1-04-10,1,3625047
M1S1-04-10,1,3625048
M1S1-04-11,3,1939995
M1S1-04-11,3,1939996
M1S1-04-11,4,1939997
M1S1-04-11,3,2718552
M1S1-04-11,3,2718553
M1S1-04-11,5,2718554
M1S1-04-12,2,1940000
M1S1-04-12,2,1940001
M1S1-04-12,2,1940002
M1S1-04-12,3,1940003
M1S1-04-12,3,1940004
M1S1-04-12,2,1940005
M1S1-04-12,2,1940006
M1S1-04-12,4,1940007
M1S1-04-12,4,1940008
M1S1-04-12,2,2718555
M1S1-04-12,1,2718556
M1S1-04-12,3,2718557
M1S1-04-12,5,2718558
M1S1-04-12,2,2718559
M1S1-04-12,3,2718560
M1S1-04-12,5,2718561
M1S1-04-12,1,3625050
M1S1-04-12,1,3625051
M1S1-04-12,1,3625052
M1S1-04-12,1,3625053
M1S1-04-12,1,3625054
M1S1-04-12,1,3625056
M1S1-04-12,1,3625058
M1S1-04-12,1,3625059
M1S1-04-12,1,3625060
M1S1-04-12,1,3625061
M1S1-04-12,1,3625062
M1S1-04-12,1,3625063
M1S1-04-12,2,3625066
M1S1-04-13,2,1940009
M1S1-04-13,2,1940010
M1S1-04-13,1,1940011
M1S1-04-13,2,1940012
M1S1-04-13,2,1940013
M1S1-04-13,3,1940014
M1S1-04-13,3,1940086
M1S1-04-13,3,1940087
M1S1-04-13,4,1940088
M1S1-04-13,2,2718562
M1S1-04-13,1,2718563
M1S1-04-13,1,2718564
M1S1-04-13,3,2718565
M1S1-04-13,3,2718566
M1S1-04-13,2,3625049
M1S1-04-13,2,3625068
M1S1-04-13,2,3625071
M1S1-04-13,2,3625074
M1S1-04-13,2,3625078
M1S1-04-13,2,3625081
M1S1-04-14,2,1940089
M1S1-04-14,2,1940090
M1S1-04-14,2,1940091
M1S1-04-14,3,2718567
M1S1-04-14,1,2718568
M1S1-04-14,3,2718569
M1S1-04-15,1,1603713
M1S1-04-15,1,1603715
M1S1-04-15,1,1603716
M1S1-04-15,1,1603718
M1S1-04-15,1,1603720
M1S1-04-15,1,1603721
M1S1-04-15,1,1603723
M1S1-04-15,1,1603726
M1S1-04-15,3,1603729
M1S1-04-15,1,1940092
M1S1-04-15,3,1940093
M1S1-04-15,1,1940094
M1S1-04-15,2,1940095
M1S1-04-15,3,1940098
M1S1-04-15,3,1940102
M1S1-04-15,1,2718570
M1S1-04-15,1,2718571
M1S1-04-15,3,2718572
M1S1-04-15,3,2718573
M1S1-04-15,3,2718574
M1S1-04-15,1,3625082
M1S1-04-15,1,3625083
M1S1-04-15,1,3625084
M1S1-04-15,1,3625086
M1S1-04-15,1,3625088
M1S1-04-15,1,3625153
M1S1-04-15,1,3625155
M1S1-04-15,1,3625157
M1S1-04-15,1,3625165
M1S1-04-15,1,3625167
M1S1-04-15,1,3625168
M1S1-04-15,1,3625184
M1S1-04-15,1,3625186
M1S1-04-15,1,3625188
M1S1-04-16,3,1940106
M1S1-04-16,3,1940108
M1S1-04-16,3,1940112
M1S1-04-16,1,2718575
M1S1-04-16,3,2718576
M1S1-04-16,3,2718577
M1S1-04-16,1,3625203
M1S1-04-16,1,3625205
M1S1-04-16,1,3625207
M1S1-04-16,1,3625209
M1S1-04-16,2,3625212
M1S1-04-17,3,1940113
M1S1-04-17,1,1940115
M1S1-04-17,3,1940128
M1S1-04-17,3,1940130
M1S1-04-17,3,1940131
M1S1-04-17,3,1940132
M1S1-04-17,3,1940133
M1S1-04-17,3,2718593
M1S1-04-17,1,2718594
M1S1-04-17,3,2718595
M1S1-04-17,3,2718596
M1S1-04-17,3,2718597
M1S1-04-17,5,2718598
M1S1-04-17,1,3625213
M1S1-04-17,2,3625214
M1S1-04-17,2,3625215
M1S1-04-17,2,3625218
M1S1-04-17,2,3625220
M1S1-04-17,2,3625222
M1S1-04-17,2,3625223
M1S1-04-17,2,3625225
M1S1-04-17,3,3625227
M1S1-04-18,3,1940134
M1S1-04-18,3,1940135
M1S1-04-18,4,1940136
M1S1-04-18,4,1940137
M1S1-04-18,4,1940138
M1S1-04-18,1,2718578
M1S1-04-18,1,2718579
M1S1-04-18,3,2718580
M1S1-04-18,5,2718581
M1S1-04-19,3,1940139
M1S1-04-19,3,1940140
M1S1-04-19,3,1940141
M1S1-04-19,3,1940142
M1S1-04-19,3,1940143
M1S1-04-19,3,2718582
M1S1-04-19,3,2718583
M1S1-04-19,3,2718584
M1S1-04-19,5,2718585
M1S1-04-20,3,1940144
M1S1-04-20,3,1940145
M1S1-04-20,3,1940146
M1S1-04-20,3,1940147
M1S1-04-20,3,1940148
M1S1-04-20,3,1940149
M1S1-04-20,3,1940150
M1S1-04-20,3,1940151
M1S1-04-20,2,2718586
M1S1-04-20,3,2718587
M1S1-04-20,3,2718588
M1S1-04-20,3,2718589
M1S1-04-20,3,2718590
M1S1-04-20,3,2718591
M1S1-04-20,5,2718592
M1S1-04-21,1,1604128
M1S1-04-21,1,1604130
M1S1-04-21,1,1604131
M1S1-04-21,1,1604133
M1S1-04-21,1,1604135
M1S1-04-21,1,1604138
M1S1-04-21,1,1604139
M1S1-04-21,1,1604141
M1S1-04-21,2,1604143
M1S1-04-21,3,1940152
M1S1-04-21,3,1940153
M1S1-04-21,5,1940154
M1S1-04-21,1,1940156
M1S1-04-21,1,1940157
M1S1-04-21,3,1940158
M1S1-04-21,5,1940159
M1S1-04-21,5,1940160
M1S1-04-21,3,2718599
M1S1-04-21,3,2718600
M1S1-04-21,5,2718601
M1S1-04-21,3,2718602
M1S1-04-21,3,2718603
M1S1-04-21,3,2718604
M1S1-04-21,5,2718605
M1S1-05-01,1,1604198
M1S1-05-01,1,1604233
M1S1-05-01,1,1604236
M1S1-05-01,1,1604238
M1S1-05-01,1,1604255
M1S1-05-01,1,1604258
M1S1-05-01,1,1604260
M1S1-05-01,1,1604261
M1S1-05-01,1,1604264
M1S1-04-14,1,3625092
M1S1-04-14,1,3625091
M1S1-04-14,1,3625090
M1S1-04-14,1,3625089
M1S1-05-01,1,1604266
M1S1-05-01,1,1604268
M1S1-05-01,1,1604270
M1S1-05-01,1,1604273
M1S1-05-01,1,1604274
M1S1-05-01,2,1604276
M1S1-05-01,1,1604279
M1S1-05-01,3,1941318
M1S1-05-01,3,1941319
M1S1-05-01,3,1941396
M1S1-05-01,3,2826402
M1S1-05-01,1,2826403
M1S1-05-01,3,2826405
M1S1-05-01,3,2826408
M1S1-05-01,3,2826409
M1S1-05-01,1,3625372
M1S1-05-01,1,3625374
M1S1-05-01,1,3625375
M1S1-05-01,1,3625377
M1S1-05-01,1,3625379
M1S1-05-01,1,3625381
M1S1-05-01,1,3625382
M1S1-05-01,1,3625383
M1S1-05-01,1,3625385
M1S1-05-01,1,3625387
M1S1-05-01,1,3625389
M1S1-05-01,1,3625390
M1S1-05-01,1,3625392
M1S1-05-01,1,3625394
M1S1-05-01,1,3625396
M1S1-05-01,1,3625398
M1S1-05-01,1,3625399
M1S1-05-01,1,3625400
M1S1-05-01,1,3625402
M1S1-05-01,1,3625404
M1S1-05-01,1,3625406
M1S1-05-01,1,3625407
M1S1-05-01,1,3625409
M1S1-05-01,1,3625410
M1S1-05-01,1,3625412
M1S1-05-01,2,3625414
M1S1-05-01,3,3625416
M1S1-05-01,1,3628634
M1S1-05-01,1,3628635
M1S1-05-01,1,3628636
M1S1-05-01,1,3628637
M1S1-05-01,1,3628638
M1S1-05-01,1,3628639
M1S1-05-01,1,3628640
M1S1-05-01,1,3628641
M1S1-05-02,3,1941397
M1S1-05-02,2,1941398
M1S1-05-02,3,1941399
M1S1-05-02,3,1941400
M1S1-05-02,3,2826411
M1S1-05-02,1,2826414
M1S1-05-02,3,2826415
M1S1-05-02,3,2826416
M1S1-05-02,5,2826418
M1S1-05-02,1,2826435
M1S1-05-02,1,2826436
M1S1-05-02,3,2826438
M1S1-05-02,5,2826441
M1S1-05-02,5,2826442
M1S1-05-02,5,2826444
M1S1-05-03,3,1941401
M1S1-05-03,1,1941402
M1S1-05-03,3,1941403
M1S1-05-03,3,1941404
M1S1-05-03,3,2826431
M1S1-05-03,3,2826432
M1S1-05-03,3,2826434
M1S1-05-04,2,1941405
M1S1-05-04,1,1941406
M1S1-05-04,3,1941407
M1S1-05-04,3,1941408
M1S1-05-04,3,1941409
M1S1-05-04,2,2826446
M1S1-05-04,1,2826447
M1S1-05-04,3,2826450
M1S1-05-04,3,2826451
M1S1-05-04,3,2826454
M1S1-05-04,5,2826456
M1S1-05-05,3,2826459
M1S1-05-05,3,2826462
M1S1-05-05,3,2826464
M1S1-05-05,3,2826466
M1S1-05-05,3,2826468
M1S1-05-05,3,2826469
M1S1-05-06,1,1604592
M1S1-05-06,1,1604593
M1S1-05-06,1,1604594
M1S1-05-06,1,1604595
M1S1-05-06,1,1604596
M1S1-05-06,1,1604597
M1S1-05-06,1,1604598
M1S1-05-06,1,1604599
M1S1-05-06,1,1604602
M1S1-05-06,1,1604603
M1S1-05-06,1,1604604
M1S1-05-06,1,1604605
M1S1-05-06,1,1604612
M1S1-05-06,1,1604613
M1S1-05-06,3,1941410
M1S1-05-06,2,1941411
M1S1-05-06,3,1941412
M1S1-05-06,4,1941413
M1S1-05-06,4,1941414
M1S1-05-06,3,1941415
M1S1-05-06,2,1941416
M1S1-05-06,3,1941417
M1S1-05-06,4,1941418
M1S1-05-06,3,2826471
M1S1-05-06,1,2826473
M1S1-05-06,3,2826475
M1S1-05-06,3,2826476
M1S1-05-06,5,2826478
M1S1-05-06,1,3628642
M1S1-05-06,1,3628643
M1S1-05-06,1,3628644
M1S1-05-06,2,3628645
M1S1-05-06,2,3628646
M1S1-05-06,2,3628647
M1S1-05-06,3,3628648
M1S1-05-06,2,3628649
M1S1-05-06,2,3628650
M1S1-05-06,2,3628651
M1S1-05-06,2,3628652
M1S1-05-06,2,3628653
M1S1-05-06,2,3628654
M1S1-05-06,2,3628655
M1S1-05-06,2,3628656
M1S1-05-06,2,3628657
M1S1-05-06,2,3628658
M1S1-05-06,2,3628659
M1S1-05-07,2,1941419
M1S1-05-07,3,1941420
M1S1-05-07,3,1941421
M1S1-05-07,3,1941422
M1S1-05-07,3,1941423
M1S1-05-07,3,1941424
M1S1-05-07,2,2826479
M1S1-05-07,1,2826480
M1S1-05-07,3,2826481
M1S1-05-07,3,2826484
M1S1-05-07,3,2826486
M1S1-05-07,3,2826490
M1S1-05-07,3,2826491
M1S1-05-07,1,2826492
M1S1-05-07,1,2826493
M1S1-05-07,3,2826495
M1S1-05-07,3,2826497
M1S1-05-07,3,2826498
M1S1-05-07,3,2826500
M1S1-05-08,1,1941425
M1S1-05-08,1,1941426
M1S1-05-08,2,1941430
M1S1-05-08,3,1941431
M1S1-05-08,2,2826509
M1S1-05-08,1,2826510
M1S1-05-08,1,2826511
M1S1-05-08,3,2826512
M1S1-05-08,3,2826514
M1S1-05-08,2,3628704
M1S1-05-08,2,3628705
M1S1-05-08,2,3628708
M1S1-05-08,2,3628709
M1S1-05-08,2,3628710
M1S1-05-08,2,3628711
M1S1-05-08,2,3628712
M1S1-05-08,2,3628713
M1S1-05-09,1,1941432
M1S1-05-09,1,1941433
M1S1-05-09,2,1941434
M1S1-05-09,1,2826515
M1S1-05-09,1,2826516
M1S1-05-09,3,2826517
M1S1-05-09,3,2826518
M1S1-05-10,1,1604852
M1S1-05-10,1,1604853
M1S1-05-10,1,1604854
M1S1-05-10,1,1604855
M1S1-05-10,1,1604856
M1S1-05-10,1,1604857
M1S1-05-10,1,1604858
M1S1-05-10,1,1604859
M1S1-05-10,2,1604860
M1S1-05-10,2,1604862
M1S1-05-10,2,1604863
M1S1-05-10,2,1604865
M1S1-05-10,3,1941435
M1S1-05-10,2,1941436
M1S1-05-10,2,1941437
M1S1-05-10,2,1941438
M1S1-05-10,2,1941439
M1S1-05-10,3,1941440
M1S1-05-10,3,2826520
M1S1-05-10,1,2826522
M1S1-05-10,3,2826524
M1S1-05-10,3,2826525
M1S1-05-10,3,2826526
M1S1-05-10,1,3628714
M1S1-05-10,1,3628715
M1S1-05-10,1,3628716
M1S1-05-10,1,3628717
M1S1-05-10,1,3628718
M1S1-05-10,1,3628719
M1S1-05-10,1,3628720
M1S1-05-10,1,3628731
M1S1-05-10,1,3628734
M1S1-05-10,1,3628736
M1S1-05-10,2,3628738
M1S1-05-10,2,3628740
M1S1-05-11,1,1609954
M1S1-05-11,1,1609955
M1S1-05-11,2,1609956
M1S1-05-11,2,1609957
M1S1-05-11,1,1609958
M1S1-05-11,1,1609959
M1S1-05-11,1,1609960
M1S1-05-11,1,1609961
M1S1-05-11,1,1609962
M1S1-05-11,1,1609963
M1S1-05-11,1,1609964
M1S1-05-11,1,1609965
M1S1-05-11,1,1609966
M1S1-05-11,3,1941441
M1S1-05-11,1,1941442
M1S1-05-11,1,1941443
M1S1-05-11,2,1941444
M1S1-05-11,3,2826528
M1S1-05-11,1,2826529
M1S1-05-11,3,2826531
M1S1-05-11,1,3628756
M1S1-05-11,1,3628757
M1S1-05-11,1,3628758
M1S1-05-11,1,3628759
M1S1-05-11,1,3628760
M1S1-05-11,1,3628761
M1S1-05-11,1,3628762
M1S1-05-11,1,3628763
M1S1-05-11,1,3628764
M1S1-05-11,1,3628765
M1S1-05-11,1,3628766
M1S1-05-11,1,3628767
M1S1-05-11,1,3628768
M1S1-05-11,1,3628769
M1S1-05-11,1,3628770
M1S1-05-11,1,3628771
M1S1-05-11,1,3628772
M1S1-05-11,1,3628773
M1S1-05-11,1,3628774
M1S1-05-11,1,3628775
M1S1-05-12,1,1609997
M1S1-05-12,1,1609998
M1S1-05-12,1,1609999
M1S1-05-12,2,1610000
M1S1-05-12,2,1610001
M1S1-05-12,1,1610003
M1S1-05-12,1,1610004
M1S1-05-12,2,1610005
M1S1-05-12,2,1610006
M1S1-05-12,3,1610007
M1S1-05-12,3,1610009
M1S1-05-12,2,1610010
M1S1-05-12,2,1610012
M1S1-05-12,2,1610013
M1S1-05-12,2,1610014
M1S1-05-12,3,1941445
M1S1-05-12,3,1941446
M1S1-05-12,3,1941447
M1S1-05-12,4,1941448
M1S1-05-12,3,2826532
M1S1-05-12,1,2826534
M1S1-05-12,3,2826535
M1S1-05-12,3,2826536
M1S1-05-12,1,3628791
M1S1-05-12,1,3628792
M1S1-05-12,1,3628793
M1S1-05-12,1,3628794
M1S1-05-12,2,3628795
M1S1-05-12,2,3628796
M1S1-05-12,1,3628797
M1S1-05-12,1,3628798
M1S1-05-12,1,3628799
M1S1-05-12,1,3628800
M1S1-05-12,1,3628801
M1S1-05-12,1,3628802
M1S1-05-12,2,3628803
M1S1-05-12,2,3628804
M1S1-05-12,2,3628805
M1S1-05-12,2,3628806
M1S1-05-12,2,3628807
M1S1-05-12,2,3628808
M1S1-05-12,2,3628809
M1S1-05-12,2,3628810
M1S1-05-12,2,3628811
M1S1-05-12,2,3628812
M1S1-05-12,3,3628813
M1S1-05-12,2,3628814
M1S1-05-12,2,3628815
M1S1-05-12,2,3628816
M1S1-05-12,3,3628817
M1S1-05-12,2,3628818
M1S1-05-12,2,3628819
M1S1-05-12,2,3628821
M1S1-05-12,2,3628822
M1S1-05-12,2,3628823
M1S1-05-12,2,3628847
M1S1-05-12,2,3628850
M1S1-05-12,1,3628874
M1S1-05-12,2,3628875
M1S1-05-12,2,3628876
M1S1-05-13,3,1941449
M1S1-05-13,3,1941450
M1S1-05-13,3,1941451
M1S1-05-13,3,1941452
M1S1-05-13,3,1941453
M1S1-05-13,3,1941454
M1S1-05-13,3,1941455
M1S1-05-13,4,1941456
M1S1-05-13,3,2826547
M1S1-05-13,3,2826548
M1S1-05-13,3,2826551
M1S1-05-13,3,2826552
M1S1-05-13,3,2826554
M1S1-05-13,5,2826555
M1S1-05-14,3,1941457
M1S1-05-14,3,1941458
M1S1-05-14,3,1941459
M1S1-05-14,4,1941460
M1S1-05-15,3,1941461
M1S1-05-15,2,1941462
M1S1-05-15,3,1941463
M1S1-05-15,4,1941464
M1S1-05-15,3,2826556
M1S1-05-15,3,2826557
M1S1-05-15,5,2826558
M1S1-05-16,3,1941465
M1S1-05-16,3,1941466
M1S1-05-16,3,1941467
M1S1-05-16,4,1941468
M1S1-05-16,1,2826559
M1S1-05-16,1,2826560
M1S1-05-16,3,2826561
M1S1-05-16,5,2826562
M1S1-05-17,3,1941469
M1S1-05-17,3,1941470
M1S1-05-17,3,1941471
M1S1-05-17,4,1941472
M1S1-05-17,4,1941473
M1S1-05-17,3,2826563
M1S1-05-17,3,2826564
M1S1-05-17,3,2826565
M1S1-05-17,3,2826566
M1S1-05-18,3,1941474
M1S1-05-18,4,1941475
M1S1-05-18,4,1941476
M1S1-05-18,3,2826537
M1S1-05-18,3,2826538
M1S1-05-18,3,2826540
M1S1-05-18,3,2826541
M1S1-05-18,3,2826543
M1S1-05-18,3,2826544
M1S1-05-18,3,2826545
M1S1-05-18,5,2826546
M1S1-05-19,4,1941477
M1S1-05-19,4,1941478
M1S1-05-19,4,1941479
M1S1-05-19,5,1941480
M1S1-06-01,1,1967495
M1S1-06-01,3,1967496
M1S1-06-01,3,1967497
M1S1-06-01,3,1967499
M1S1-06-01,1,2829032
M1S1-06-01,1,2829035
M1S1-06-01,1,2829036
M1S1-06-01,3,2829038
M1S1-06-01,1,2829040
M1S1-06-01,1,2829041
M1S1-06-01,3,2829042
M1S1-06-01,3,2829044
M1S1-06-01,1,3628916
M1S1-06-01,1,3628917
M1S1-06-01,2,3628918
M1S1-06-01,3,3628919
M1S1-06-01,3,3628920
M1S1-06-02,1,1610138
M1S1-06-02,2,1610139
M1S1-06-02,2,1610140
M1S1-06-02,2,1610141
M1S1-06-02,2,1610142
M1S1-06-02,2,1610143
M1S1-06-02,2,1610144
M1S1-06-02,2,1610145
M1S1-06-02,2,1610146
M1S1-06-02,1,1610149
M1S1-06-02,1,1610150
M1S1-06-02,1,1610151
M1S1-06-02,3,1610152
M1S1-06-02,3,1610153
M1S1-06-02,3,1610154
M1S1-06-02,1,1967501
M1S1-06-02,1,1967503
M1S1-06-02,3,1967504
M1S1-06-02,4,1967506
M1S1-06-02,3,2829045
M1S1-06-02,1,2829046
M1S1-06-02,1,2829047
M1S1-06-02,3,2829050
M1S1-06-02,3,2829052
M1S1-06-03,3,1967507
M1S1-06-03,1,1967508
M1S1-06-03,2,1967515
M1S1-06-03,2,1967516
M1S1-06-03,1,2829053
M1S1-06-03,3,2829054
M1S1-06-03,3,2829055
M1S1-06-03,1,3628906
M1S1-06-03,1,3628907
M1S1-06-03,3,3628910
M1S1-06-03,1,3628921
M1S1-06-03,1,3628922
M1S1-06-03,1,3628923
M1S1-06-03,1,3628934
M1S1-06-04,3,1967520
M1S1-06-04,2,1967522
M1S1-06-04,3,1967524
M1S1-06-04,3,1967526
M1S1-06-04,3,2829056
M1S1-06-04,1,2829057
M1S1-06-04,3,2829058
M1S1-06-04,3,2829059
M1S1-06-04,5,2829060
M1S1-06-05,2,1610170
M1S1-06-05,3,1610172
M1S1-06-05,1,1610173
M1S1-06-05,1,1610174
M1S1-06-05,1,1610175
M1S1-06-05,1,1610177
M1S1-06-05,3,1967527
M1S1-06-05,3,1967529
M1S1-06-05,3,1967530
M1S1-06-05,3,2829061
M1S1-06-05,1,2829063
M1S1-06-05,3,2829065
M1S1-06-05,3,2829066
M1S1-06-05,3,2829068
M1S1-06-05,5,2829070
M1S1-06-05,1,3628979
M1S1-06-05,1,3628982
M1S1-06-05,1,3628989
M1S1-06-05,1,3628991
M1S1-06-05,2,3628994
M1S1-06-05,2,3628996
M1S1-06-05,2,3628999
M1S1-06-06,1,1967532
M1S1-06-06,2,1967533
M1S1-06-06,2,1967535
M1S1-06-06,3,1967537
M1S1-06-06,2,2829071
M1S1-06-06,3,2829073
M1S1-06-06,3,2829074
M1S1-06-06,3,2829075
M1S1-06-06,5,2829076
M1S1-06-07,2,1967539
M1S1-06-07,2,1967540
M1S1-06-07,2,1967541
M1S1-06-07,3,1967542
M1S1-06-07,2,2829078
M1S1-06-07,1,2829087
M1S1-06-07,3,2829088
M1S1-06-07,3,2829089
M1S1-06-07,2,3629003
M1S1-06-07,2,3629005
M1S1-06-07,2,3629011
M1S1-06-07,2,3629012
M1S1-06-08,3,1967543
M1S1-06-08,2,1967544
M1S1-06-08,3,1967545
M1S1-06-08,3,1967546
M1S1-06-08,2,2829090
M1S1-06-08,1,2829091
M1S1-06-08,1,2829092
M1S1-06-08,3,2829093
M1S1-06-08,3,3628936
M1S1-06-08,1,3629020
M1S1-06-08,1,3629021
M1S1-06-08,1,3629056
M1S1-06-08,1,3629057
M1S1-06-08,2,3629058
M1S1-06-08,2,3629059
M1S1-06-08,2,3629060
M1S1-06-08,2,3629061
M1S1-06-08,2,3629062
M1S1-06-08,2,3629063
M1S1-06-08,2,3629064
M1S1-06-08,2,3629065
M1S1-06-08,2,3629066
M1S1-06-09,1,1610207
M1S1-06-09,2,1610208
M1S1-06-09,2,1610213
M1S1-06-09,2,1610214
M1S1-06-09,2,1610215
M1S1-06-09,3,1610216
M1S1-06-09,2,1967548
M1S1-06-09,3,1967551
M1S1-06-09,3,1967552
M1S1-06-09,4,1967554
M1S1-06-09,2,2829094
M1S1-06-09,3,2829113
M1S1-06-09,3,2829114
M1S1-06-09,3,2829115
M1S1-06-09,5,2829116
M1S1-06-09,1,3629043
M1S1-06-09,1,3629067
M1S1-06-09,1,3629068
M1S1-06-09,1,3629069
M1S1-06-09,2,3629070
M1S1-06-09,2,3629084
M1S1-06-09,2,3629085
M1S1-06-10,3,1967555
M1S1-06-10,3,1967565
M1S1-06-10,3,1967570
M1S1-06-10,3,2829117
M1S1-06-10,1,2829118
M1S1-06-10,3,2829120
M1S1-06-11,4,1967572
M1S1-06-11,4,1967575
M1S1-06-11,3,2829121
M1S1-06-11,1,2829122
M1S1-06-11,3,2829123
M1S1-06-11,5,2829124
M1S1-06-11,3,3629086
M1S1-06-11,3,3629087
M1S1-06-10,1,1610218
M1S1-06-10,1,1610219
M1S1-06-10,1,1610220
M1S1-06-10,2,1610221
M1S1-06-10,3,1610222
M1S1-06-11,2,1610223
M1S1-06-11,2,1610224
M1S1-06-08,1,1610211
M1S1-06-08,1,1610210
M1S1-06-08,1,1610209
M1S1-06-08,1,1610206
M1S1-06-08,1,1610205
M1S1-06-08,1,1610204
M1S1-06-08,1,1610203
M1S1-06-07,1,3629025
M1S1-06-07,1,3629024
M1S1-06-07,1,3629023
M1S1-06-12,2,1967576
M1S1-06-12,3,1967577
M1S1-06-12,4,1967579
M1S1-06-12,2,2829125
M1S1-06-12,3,2829126
M1S1-06-12,3,2829127
M1S1-06-12,3,2829128
M1S1-06-12,3,2829129
M1S1-06-12,3,3629155
M1S1-06-12,3,3629158
M1S1-06-12,3,3629161
M1S1-06-12,3,3629165
M1S1-06-13,2,1967580
M1S1-06-13,1,1967581
M1S1-06-13,3,1967583
M1S1-06-13,4,1967584
M1S1-06-13,3,2829130
M1S1-06-13,3,2829131
M1S1-06-13,3,2829132
M1S1-06-14,2,1967585
M1S1-06-14,2,1967587
M1S1-06-14,3,1967588
M1S1-06-14,4,1967589
M1S1-06-14,3,2829133
M1S1-06-14,1,2829134
M1S1-06-14,3,2829135
M1S1-06-14,3,2829136
M1S1-06-14,3,2829137
M1S1-06-15,4,1967591
M1S1-06-15,3,1967592
M1S1-06-15,4,1967594
M1S1-06-15,4,1967595
M1S1-06-15,3,2829138
M1S1-06-15,3,2829139
M1S1-06-15,4,2829140
M1S1-06-16,4,1967607
M1S1-06-16,4,1967609
M1S1-06-16,4,1967611
M1S1-06-16,4,1967613
M1S1-06-16,3,2829141
M1S1-06-16,3,2829142
M1S1-06-16,5,2829143
M1S1-06-16,5,2829144
M1S1-06-17,3,1967596
M1S1-06-17,3,1967602
M1S1-06-17,3,1967604
M1S1-06-17,4,1967605
M1S1-06-17,3,2829145
M1S1-06-17,3,2829146
M1S1-06-17,3,2829147
M1S1-07-01,2,1610350
M1S1-07-01,2,2077086
M1S1-07-01,2,2077087
M1S1-07-01,3,2077088
M1S1-07-01,3,2077089
M1S1-07-01,3,2077090
M1S1-07-01,2,2829704
M1S1-07-01,1,2829705
M1S1-07-01,3,2829706
M1S1-07-01,3,2829707
M1S1-07-01,5,2829708
M1S1-07-01,2,3629181
M1S1-07-01,2,3629183
M1S1-07-02,1,1610351
M1S1-07-02,2,1610352
M1S1-07-02,2,2077091
M1S1-07-02,2,2077092
M1S1-07-02,3,2077093
M1S1-07-02,3,2077094
M1S1-07-02,2,2829711
M1S1-07-02,1,2829713
M1S1-07-02,3,2829715
M1S1-07-02,5,2829721
M1S1-07-02,2,3629190
M1S1-07-03,3,1610353
M1S1-07-03,3,2077095
M1S1-07-03,2,2077096
M1S1-07-03,3,2077097
M1S1-07-03,4,2077098
M1S1-07-03,3,2829724
M1S1-07-03,1,2829726
M1S1-07-03,3,2829729
M1S1-07-03,3,2829732
M1S1-07-03,5,2829736
M1S1-07-03,4,3629238
M1S1-07-04,3,1610667
M1S1-07-04,2,1610668
M1S1-07-04,2,2077109
M1S1-07-04,2,2077110
M1S1-07-04,3,2077111
M1S1-07-04,3,2077112
M1S1-07-04,2,2829738
M1S1-07-04,1,2829740
M1S1-07-04,3,2829742
M1S1-07-04,3,2829866
M1S1-07-04,3,2829869
M1S1-07-04,5,2829870
M1S1-07-05,3,1610665
M1S1-07-05,2,2077103
M1S1-07-05,2,2077104
M1S1-07-05,2,2077105
M1S1-07-05,3,2077108
M1S1-07-05,2,2829872
M1S1-07-05,3,2829874
M1S1-07-05,3,2829875
M1S1-07-05,3,2829876
M1S1-07-05,5,2829878
M1S1-07-06,3,1610666
M1S1-07-06,3,2077099
M1S1-07-06,3,2077100
M1S1-07-06,2,2829880
M1S1-07-06,1,2829883
M1S1-07-06,3,2829885
M1S1-07-06,3,2829887
M1S1-07-06,5,2829890
M1S1-07-07,3,2077101
M1S1-07-07,3,2077102
M1S1-07-07,2,2829893
M1S1-07-07,3,2829895
M1S1-07-07,3,2829897
M1S1-07-08,1,1610672
M1S1-07-08,1,1610673
M1S1-07-08,2,1610674
M1S1-07-08,4,1610675
M1S1-07-08,4,2077201
M1S1-07-08,4,2077205
M1S1-07-08,5,2077206
M1S1-07-08,5,2077209
M1S1-07-08,3,2829902
M1S1-07-08,3,2829904
M1S1-07-08,3,2829908
M1S1-07-08,5,2829910
M1S1-07-09,3,2077116
M1S1-07-09,2,2077117
M1S1-07-09,3,2077118
M1S1-07-09,3,2077120
M1S1-07-09,3,2829919
M1S1-07-09,1,2829921
M1S1-07-09,3,2829923
M1S1-07-09,5,2829928
M1S1-07-10,3,2077113
M1S1-07-10,3,2077114
M1S1-07-10,3,2077115
M1S1-07-10,4,2077218
M1S1-07-10,4,2077220
M1S1-07-10,4,2077222
M1S1-07-10,5,2077226
M1S1-07-10,2,2829930
M1S1-07-10,1,2829932
M1S1-07-10,3,2829933
M1S1-07-10,3,2829934
M1S1-07-10,5,2829936
M1S1-07-11,3,2077122
M1S1-07-11,3,2077124
M1S1-07-11,3,2077126
M1S1-07-11,3,2829937
M1S1-07-11,3,2829938
M1S1-07-11,3,2829939
M1S1-07-11,3,2829940
M1S1-07-11,5,2829942
M1S1-06-11,2,1610225
M1S1-06-11,2,1610226
M1S1-06-11,2,1610227
M1S1-06-11,2,1610228
M1S1-06-10,1,3629075
M1S1-06-10,1,3629078
M1S1-06-11,1,3629082
M1S1-06-10,1,3629090
M1S1-06-10,1,3629094
M1S1-06-10,1,3629096
M1S1-06-10,2,3629097
M1S1-06-10,2,3629099
M1S1-06-11,1,3629101
M1S1-06-11,1,3629103
M1S1-06-11,1,3629105
M1S1-06-11,1,3629109
M1S1-06-14,2,3629139
M1S1-06-15,3,3629144
M1S1-06-11,2,3629147
M1S1-06-11,2,3629149
M1S1-06-11,3,3629151
M1S1-06-11,3,3629153
M1S1-07-12,1,1610691
M1S1-07-12,1,1610693
M1S1-07-12,1,1610696
M1S1-07-12,2,1610700
M1S1-07-12,2,1610703
M1S1-07-12,2,2077128
M1S1-07-12,2,2077130
M1S1-07-12,3,2077132
M1S1-07-12,4,2077134
M1S1-07-12,2,2829944
M1S1-07-12,3,2829946
M1S1-07-12,3,2829947
M1S1-07-12,5,2829949
M1S1-07-13,2,1610718
M1S1-07-13,2,1610719
M1S1-07-13,3,2077136
M1S1-07-13,3,2077138
M1S1-07-13,4,2077140
M1S1-07-13,3,2829951
M1S1-07-13,3,2829953
M1S1-07-13,5,2829956
M1S1-07-14,3,1610720
M1S1-07-14,3,1610721
M1S1-07-14,3,2077142
M1S1-07-14,3,2077145
M1S1-07-14,3,2077147
M1S1-07-14,3,2829960
M1S1-07-14,3,2829963
M1S1-07-14,5,2829964
M1S1-07-15,3,2077149
M1S1-07-15,3,2077152
M1S1-07-15,3,2077154
M1S1-07-15,4,2077156
M1S1-07-15,3,2829966
M1S1-07-15,3,2829967
M1S1-07-15,3,2829969
M1S1-07-15,5,2829973
M1S1-07-16,4,2077235
M1S1-07-16,4,2077237
M1S1-07-16,5,2077240
M1S1-07-16,3,2829980
M1S1-07-16,3,2829984
M1S1-07-16,3,2829987
M1S1-07-16,5,2829989
M1S1-07-17,2,1610722
M1S1-07-17,2,1610723
M1S1-07-17,2,1610724
M1S1-07-17,3,2077160
M1S1-07-17,3,2077162
M1S1-07-17,3,2077174
M1S1-07-17,3,2077175
M1S1-07-17,3,2077179
M1S1-07-17,2,2077180
M1S1-07-17,3,2077183
M1S1-07-17,3,2077186
M1S1-07-17,2,2829992
M1S1-07-17,1,2829995
M1S1-07-17,3,2829997
M1S1-07-17,3,2830000
M1S1-07-17,5,2830003
M1S1-07-18,4,1610725
M1S1-07-18,3,2077188
M1S1-07-18,3,2077191
M1S1-07-18,3,2077195
M1S1-07-18,4,2077199
M1S1-07-18,2,2830006
M1S1-07-18,1,2830008
M1S1-07-18,3,2830011
M1S1-07-18,5,2830012
M1S1-07-19,3,2077210
M1S1-07-19,3,2077212
M1S1-07-19,3,2077214
M1S1-07-19,4,2077215
M1S1-07-19,3,2830014
M1S1-07-19,1,2830016
M1S1-07-19,3,2830017
M1S1-07-19,3,2830019
M1S1-07-19,3,2830020
M1S1-07-19,5,2830022
M1S1-07-20,3,2830024
M1S1-07-20,3,2830027
M1S1-07-20,3,2830028
M1S1-07-20,5,2830032
M1S1-07-21,3,2830035
M1S1-07-21,3,2830037
M1S1-07-21,3,2830042
M1S1-07-21,5,2830045
M1S1-07-21,5,2830050
M1S1-08-01,1,1610826
M1S1-08-01,1,1610827
M1S1-08-01,1,1610828
M1S1-08-01,1,1610829
M1S1-08-01,2,1610830
M1S1-08-01,2,1610831
M1S1-08-01,1,1610832
M1S1-08-01,1,2077455
M1S1-08-01,1,2077456
M1S1-08-01,2,2077457
M1S1-08-01,3,2077458
M1S1-08-01,2,2831036
M1S1-08-01,1,2831039
M1S1-08-01,3,2831042
M1S1-08-01,5,2831045
M1S1-08-01,1,2831047
M1S1-08-01,1,2831049
M1S1-08-01,3,2831052
M1S1-08-01,3,2831068
M1S1-08-02,1,1610833
M1S1-08-02,1,1610835
M1S1-08-02,1,1610836
M1S1-08-02,1,2077459
M1S1-08-02,1,2077460
M1S1-08-02,2,2077461
M1S1-08-02,3,2077462
M1S1-08-02,2,2831069
M1S1-08-02,1,2831071
M1S1-08-02,3,2831077
M1S1-08-02,3,2831079
M1S1-08-03,2,2077464
M1S1-08-03,2,2077465
M1S1-08-03,3,2077466
M1S1-08-03,4,2077467
M1S1-08-03,2,2831081
M1S1-08-03,3,2831082
M1S1-08-03,3,2831084
M1S1-08-03,3,2831085
M1S1-08-03,5,2831086
M1S1-08-04,1,1610897
M1S1-08-04,1,1610899
M1S1-08-04,1,1610901
M1S1-08-04,1,1610902
M1S1-08-04,1,1610904
M1S1-08-04,1,1610906
M1S1-08-04,1,1610908
M1S1-08-04,2,2077468
M1S1-08-04,1,2077469
M1S1-08-04,2,2077470
M1S1-08-04,2,2077471
M1S1-08-04,2,2831087
M1S1-08-04,1,2831088
M1S1-08-04,1,2831089
M1S1-08-04,3,2831092
M1S1-08-04,3,2831093
M1S1-08-05,3,2077472
M1S1-08-05,3,2077473
M1S1-08-05,4,2077474
M1S1-08-05,3,2077536
M1S1-08-05,3,2077537
M1S1-08-05,4,2077538
M1S1-08-05,3,2831094
M1S1-08-05,1,2831095
M1S1-08-05,3,2831096
M1S1-08-05,3,2831098
M1S1-08-05,5,2831099
M1S1-08-05,2,2831100
M1S1-08-05,3,2831102
M1S1-08-05,3,2831103
M1S1-08-05,3,2831107
M1S1-08-05,5,2831108
M1S1-08-05,5,2831112
M1S1-08-06,2,2077539
M1S1-08-06,2,2077540
M1S1-08-06,3,2077541
M1S1-08-06,4,2077542
M1S1-08-06,2,2831116
M1S1-08-06,1,2831120
M1S1-08-06,3,2831123
M1S1-08-06,3,2831128
M1S1-08-06,5,2831130
M1S1-08-07,1,1611104
M1S1-08-07,1,1611107
M1S1-08-07,1,1611123
M1S1-08-07,1,1611125
M1S1-08-07,1,1611127
M1S1-08-07,1,1611179
M1S1-08-07,1,1611180
M1S1-08-07,1,1611180
M1S1-08-07,1,1611181
M1S1-08-07,1,1611181
M1S1-08-07,1,1611182
M1S1-08-07,2,1611183
M1S1-08-07,1,2077525
M1S1-08-07,1,2077526
M1S1-08-07,2,2077527
M1S1-08-07,2,2077528
M1S1-08-07,2,2077529
M1S1-08-07,2,2077530
M1S1-08-07,2,2077531
M1S1-08-07,2,2077532
M1S1-08-07,3,2077533
M1S1-08-07,3,2077534
M1S1-08-07,4,2077535
M1S1-08-07,2,2831131
M1S1-08-07,3,2831133
M1S1-08-07,3,2831134
M1S1-08-07,3,2831136
M1S1-08-07,5,2831138
M1S1-08-08,2,2077475
M1S1-08-08,2,2077476
M1S1-08-08,3,2077518
M1S1-08-08,3,2077520
M1S1-08-08,1,2831139
M1S1-08-08,1,2831140
M1S1-08-08,1,2831141
M1S1-08-08,3,2831142
M1S1-08-08,3,2831143
M1S1-08-08,1,2831144
M1S1-08-08,3,2831145
M1S1-08-08,3,2831146
M1S1-09-01,1,1611319
M1S1-09-01,1,1611320
M1S1-09-01,1,1611321
M1S1-09-01,1,1611323
M1S1-09-01,1,1611324
M1S1-09-01,1,1611325
M1S1-09-01,2,2077798
M1S1-09-01,2,2077800
M1S1-09-01,3,2077803
M1S1-09-01,3,2831617
M1S1-09-01,1,2831618
M1S1-09-01,3,2831619
M1S1-09-02,1,1611365
M1S1-09-02,1,1611366
M1S1-09-02,1,1611367
M1S1-09-02,1,1611368
M1S1-09-02,1,1611369
M1S1-09-02,1,1611370
M1S1-09-02,2,1611371
M1S1-09-02,2,2077804
M1S1-09-02,2,2077805
M1S1-09-02,2,2077806
M1S1-09-02,3,2077807
M1S1-09-02,2,2077887
M1S1-09-02,1,2077889
M1S1-09-02,2,2077890
M1S1-09-02,3,2077891
M1S1-09-02,2,2077892
M1S1-09-02,2,2077893
M1S1-09-02,3,2077894
M1S1-09-02,3,2077895
M1S1-09-02,2,2831620
M1S1-09-02,1,2831621
M1S1-09-02,3,2831624
M1S1-09-02,3,2831625
M1S1-09-02,1,2831626
M1S1-09-02,3,2831627
M1S1-09-02,3,2831628
M1S1-09-02,3,2831629
M1S1-09-02,5,2831630
M1S1-09-03,1,1611328
M1S1-09-03,1,1611329
M1S1-09-03,1,1611330
M1S1-09-03,1,1611331
M1S1-09-03,2,2077808
M1S1-09-03,3,2077810
M1S1-09-03,3,2077812
M1S1-09-03,2,2077813
M1S1-09-03,2,2077814
M1S1-09-03,3,2077816
M1S1-09-03,3,2077818
M1S1-09-03,2,2831631
M1S1-09-03,1,2831632
M1S1-09-03,1,2831633
M1S1-09-03,1,2831634
M1S1-09-03,3,2831635
M1S1-09-03,1,2831636
M1S1-09-03,3,2831637
M1S1-09-03,3,2831638
M1S1-09-03,3,2831639
M1S1-09-04,1,1611337
M1S1-09-04,1,1611338
M1S1-09-04,2,1611339
M1S1-09-04,2,1611340
M1S1-09-04,2,1611341
M1S1-09-04,2,1611342
M1S1-09-04,2,2077821
M1S1-09-04,2,2077822
M1S1-09-04,3,2077823
M1S1-09-04,3,2077824
M1S1-09-04,2,2077825
M1S1-09-04,3,2077826
M1S1-09-04,3,2077827
M1S1-09-04,2,2831640
M1S1-09-04,3,2831641
M1S1-09-04,3,2831642
M1S1-09-04,3,2831643
M1S1-09-04,3,2831644
M1S1-09-04,5,2831645
M1S1-09-04,3,2831646
M1S1-09-04,1,2831647
M1S1-09-04,3,2831648
M1S1-09-04,3,2831649
M1S1-09-04,3,2831650
M1S1-09-05,2,2077828
M1S1-09-05,3,2077829
M1S1-09-05,3,2077830
M1S1-09-05,3,2077832
M1S1-09-05,5,2077913
M1S1-09-05,5,2077915
M1S1-09-05,2,2831651
M1S1-09-05,3,2831652
M1S1-09-05,3,2831653
M1S1-09-06,2,2077833
M1S1-09-06,3,2077834
M1S1-09-06,4,2077836
M1S1-09-06,2,2077909
M1S1-09-06,3,2077911
M1S1-09-06,4,2077912
M1S1-09-06,2,2831654
M1S1-09-06,3,2831655
M1S1-09-06,3,2831657
M1S1-09-06,3,2831658
M1S1-09-07,1,1617252
M1S1-09-07,1,1617253
M1S1-09-07,1,1617254
M1S1-09-07,1,1617255
M1S1-09-07,1,1617256
M1S1-09-07,1,1617257
M1S1-09-07,2,2077837
M1S1-09-07,2,2077838
M1S1-09-07,3,2077839
M1S1-09-07,2,2831659
M1S1-09-07,1,2831660
M1S1-09-07,3,2831661
M1S1-09-08,2,1617268
M1S1-09-08,2,1617269
M1S1-09-08,2,1617270
M1S1-09-08,2,1617271
M1S1-09-08,2,1617272
M1S1-09-08,2,1617273
M1S1-09-08,2,1617274
M1S1-09-08,3,2077840
M1S1-09-08,1,2077841
M1S1-09-08,2,2077842
M1S1-09-08,3,2077843
M1S1-09-08,3,2077896
M1S1-09-08,3,2077897
M1S1-09-08,3,2077898
M1S1-09-08,4,2077899
M1S1-09-08,3,2077900
M1S1-09-08,4,2077907
M1S1-09-08,2,2831662
M1S1-09-08,1,2831663
M1S1-09-08,3,2831664
M1S1-09-08,3,2831665
M1S1-09-08,1,2831666
M1S1-09-08,3,2831667
M1S1-09-08,3,2831668
M1S1-09-08,5,2831674
M1S1-09-09,1,1617258
M1S1-09-09,1,1617259
M1S1-09-09,1,1617260
M1S1-09-09,1,1617261
M1S1-09-09,2,2077844
M1S1-09-09,3,2077846
M1S1-09-09,3,2077848
M1S1-09-09,2,2077849
M1S1-09-09,2,2077851
M1S1-09-09,4,2077852
M1S1-09-09,2,2831676
M1S1-09-09,1,2831677
M1S1-09-09,1,2831678
M1S1-09-09,2,2831679
M1S1-09-09,1,2831680
M1S1-09-09,3,2831682
M1S1-09-09,3,2831683
M1S1-09-09,3,2831685
M1S1-09-09,3,2831687
M1S1-09-09,3,2831689
M1S1-09-10,2,1617262
M1S1-09-10,2,1617263
M1S1-09-10,2,1617264
M1S1-09-10,2,1617265
M1S1-09-10,2,1617266
M1S1-09-10,2,1617267
M1S1-09-10,3,2077856
M1S1-09-10,2,2077858
M1S1-09-10,3,2077860
M1S1-09-10,4,2077861
M1S1-09-10,3,2077863
M1S1-09-10,3,2077864
M1S1-09-10,3,2077865
M1S1-09-10,2,2831695
M1S1-09-10,1,2831698
M1S1-09-10,3,2831699
M1S1-09-10,3,2831700
M1S1-09-10,3,2831701
M1S1-09-10,5,2831702
M1S1-09-10,3,2831703
M1S1-09-10,3,2831704
M1S1-09-11,3,2077867
M1S1-09-11,3,2077868
M1S1-09-11,3,2077870
M1S1-09-11,3,2077902
M1S1-09-11,3,2831705
M1S1-09-11,3,2831707
M1S1-09-11,3,2831708
M1S1-09-11,3,2831710
M1S1-09-11,3,2831711
M1S1-09-11,5,2831712
M1S1-09-11,2,2831713
M1S1-09-11,3,2831715
M1S1-09-11,3,2831716
M1S1-09-11,3,2831718
M1S1-09-12,2,2077880
M1S1-09-12,2,2077881
M1S1-09-12,3,2077882
M1S1-09-12,3,2077884
M1S1-09-12,4,2077886
M1S1-09-12,3,2831720
M1S1-09-12,3,2831721
M1S1-09-12,3,2831722
M1S1-09-12,3,2831723
M1S1-09-13,3,2077871
M1S1-09-13,2,2077873
M1S1-09-13,3,2077875
M1S1-09-13,4,2077878
M1S1-09-13,2,2831724
M1S1-09-13,3,2831725
M1S1-09-13,3,2831726
M1S1-09-13,5,2831727
M2S1-01-01,1,4902768
M2S1-01-01,1,4902769
M2S1-01-01,1,4928709
M2S1-01-01,1,4928710
M2S1-01-01,3,4928711
M2S1-01-02,1,4902771
M2S1-01-02,3,4902772
M2S1-01-02,1,4902774
M2S1-01-02,3,4902780
M2S1-01-02,4,4902782
M2S1-01-02,1,4912152
M2S1-01-02,1,4912153
M2S1-01-02,3,4912154
M2S1-01-02,3,4912155
M2S1-01-02,1,4928713
M2S1-01-02,1,4928714
M2S1-01-02,3,4928715
M2S1-01-02,3,4928716
M2S1-01-02,5,4928717
M2S1-01-02,1,4928718
M2S1-01-02,1,4928720
M2S1-01-03,1,4902900
M2S1-01-03,1,4902901
M2S1-01-03,1,4902902
M2S1-01-03,1,4902903
M2S1-01-03,3,4902904
M2S1-01-03,3,4902905
M2S1-01-03,3,4928721
M2S1-01-04,3,4902783
M2S1-01-04,3,4902786
M2S1-01-04,3,4902788
M2S1-01-04,5,4902791
M2S1-01-04,3,4912156
M2S1-01-04,3,4912157
M2S1-01-04,3,4912158
M2S1-01-04,3,4912159
M2S1-01-04,3,4928723
M2S1-01-04,3,4928724
M2S1-01-04,5,4928726
M2S1-01-04,5,4928727
M2S1-01-05,2,4902793
M2S1-01-05,3,4902795
M2S1-01-05,2,4912128
M2S1-01-05,2,4912129
M2S1-01-05,3,4912130
M2S1-01-05,2,4928728
M2S1-01-05,3,4928730
M2S1-01-05,3,4928731
M2S1-01-06,2,4902796
M2S1-01-06,2,4902797
M2S1-01-06,2,4902799
M2S1-01-06,3,4902800
M2S1-01-06,5,4902801
M2S1-01-06,4,4902906
M2S1-01-06,3,4912131
M2S1-01-06,2,4912132
M2S1-01-06,3,4912133
M2S1-01-06,3,4912134
M2S1-01-06,4,4912190
M2S1-01-06,3,4912191
M2S1-01-06,4,4912193
M2S1-01-06,1,4928732
M2S1-01-06,1,4928733
M2S1-01-06,1,4928734
M2S1-01-06,3,4928735
M2S1-01-06,3,4928736
M2S1-01-06,5,4928737
M2S1-01-07,2,4902803
M2S1-01-07,2,4902804
M2S1-01-07,3,4902805
M2S1-01-07,3,4902807
M2S1-01-07,3,4902809
M2S1-01-07,3,4902810
M2S1-01-07,3,4902812
M2S1-01-07,3,4912135
M2S1-01-07,2,4912136
M2S1-01-07,3,4912137
M2S1-01-07,3,4912138
M2S1-01-07,3,4912140
M2S1-01-07,3,4912142
M2S1-01-07,2,4928738
M2S1-01-07,1,4928739
M2S1-01-07,3,4928740
M2S1-01-07,5,4928741
M2S1-01-08,2,4902813
M2S1-01-08,2,4902815
M2S1-01-08,3,4902816
M2S1-01-08,3,4902817
M2S1-01-08,3,4912143
M2S1-01-08,3,4912144
M2S1-01-08,3,4912145
M2S1-01-08,4,4912147
M2S1-01-08,3,4928742
M2S1-01-08,3,4928743
M2S1-01-08,5,4928744
M2S1-01-09,3,4902818
M2S1-01-09,5,4902819
M2S1-01-09,2,4902821
M2S1-01-09,3,4912148
M2S1-01-09,4,4912150
M2S1-01-09,4,4912151
M2S1-01-09,3,4928745
M2S1-01-09,3,4928746
M2S1-01-09,5,4928747
M2S1-01-10,3,4912160
M2S1-01-10,3,4912161
M2S1-01-10,3,4912162
M2S1-01-10,3,4928748
M2S1-01-10,1,4928749
M2S1-01-10,3,4928750
M2S1-01-11,1,4902822
M2S1-01-11,2,4902823
M2S1-01-11,2,4902824
M2S1-01-11,2,4902825
M2S1-01-11,2,4902827
M2S1-01-11,3,4912163
M2S1-01-11,2,4912164
M2S1-01-11,2,4912165
M2S1-01-11,2,4928751
M2S1-01-11,1,4928752
M2S1-01-11,3,4928753
M2S1-01-11,3,4928754
M2S1-01-11,3,4928755
M2S1-01-12,3,4902828
M2S1-01-12,3,4902829
M2S1-01-12,2,4902830
M2S1-01-12,3,4902884
M2S1-01-12,2,4902885
M2S1-01-12,4,4902886
M2S1-01-12,5,4902887
M2S1-01-12,3,4902888
M2S1-01-12,3,4902891
M2S1-01-12,3,4902892
M2S1-01-12,3,4902893
M2S1-01-12,3,4912166
M2S1-01-12,2,4912167
M2S1-01-12,3,4912168
M2S1-01-12,4,4912169
M2S1-01-12,3,4928756
M2S1-01-12,1,4928757
M2S1-01-12,3,4928758
M2S1-01-12,5,4928759
M2S1-01-13,3,4902889
M2S1-01-13,3,4902890
M2S1-01-13,3,4912175
M2S1-01-13,3,4912177
M2S1-01-13,3,4912179
M2S1-01-13,3,4928760
M2S1-01-13,5,4928761
M2S1-01-14,2,4902896
M2S1-01-14,2,4902897
M2S1-01-14,3,4902898
M2S1-01-14,2,4912183
M2S1-01-14,3,4912184
M2S1-01-14,4,4912194
M2S1-01-14,4,4912196
M2S1-01-14,4,4912197
M2S1-01-14,3,4928762
M2S1-01-14,1,4928763
M2S1-01-14,3,4928764
M2S1-01-15,3,4912180
M2S1-01-15,3,4912181
M2S1-01-15,4,4912182
M2S1-01-15,3,4912185
M2S1-01-15,3,4912186
M2S1-01-15,3,4928765
M2S1-01-15,1,4928766
M2S1-01-15,3,4928767
M2S1-01-15,3,4928768
M2S1-01-16,3,4902907
M2S1-01-16,3,4902910
M2S1-01-16,3,4902912
M2S1-01-16,3,4912170
M2S1-01-16,3,4912171
M2S1-01-16,3,4912172
M2S1-01-16,3,4912173
M2S1-01-16,3,4928769
M2S1-01-16,3,4928770
M2S1-01-16,3,4928771
M2S1-01-16,3,4928772
M2S1-01-16,5,4928773
M2S1-01-17,1,4902766
M2S1-01-17,3,4902913
M2S1-01-17,3,4902915
M2S1-01-17,3,4912187
M2S1-01-17,2,4912188
M2S1-01-17,3,4912189
M2S1-01-17,3,4928774
M2S1-01-17,1,4928775
M2S1-01-17,3,4928776
M2S1-01-17,3,4928777
M2S1-02-01,2,4902975
M2S1-02-01,1,4902976
M2S1-02-01,1,4902982
M2S1-02-01,3,4902983
M2S1-02-01,3,4902984
M2S1-02-01,2,4912295
M2S1-02-01,1,4912296
M2S1-02-01,3,4912297
M2S1-02-01,3,4912298
M2S1-02-01,2,4928964
M2S1-02-01,1,4928966
M2S1-02-01,3,4928967
M2S1-02-01,5,4928969
M2S1-02-02,2,4902985
M2S1-02-02,1,4902986
M2S1-02-02,2,4902987
M2S1-02-02,1,4912299
M2S1-02-02,1,4912300
M2S1-02-02,3,4912301
M2S1-02-02,3,4912313
M2S1-02-02,1,4928970
M2S1-02-02,1,4928972
M2S1-02-02,1,4928974
M2S1-02-02,3,4928975
M2S1-02-02,5,4928977
M2S1-02-03,3,4902989
M2S1-02-03,3,4902990
M2S1-02-03,3,4902991
M2S1-02-03,3,4902992
M2S1-02-03,2,4912303
M2S1-02-03,2,4912304
M2S1-02-03,3,4912305
M2S1-02-03,3,4912314
M2S1-02-03,2,4928981
M2S1-02-03,1,4928982
M2S1-02-03,3,4928984
M2S1-02-03,3,4928985
M2S1-02-03,3,4928987
M2S1-02-04,3,4902993
M2S1-02-04,3,4902994
M2S1-02-04,3,4902995
M2S1-02-04,4,4902996
M2S1-02-04,3,4912306
M2S1-02-04,3,4912307
M2S1-02-04,3,4912308
M2S1-02-04,3,4912309
M2S1-02-04,3,4912310
M2S1-02-04,2,4912311
M2S1-02-04,3,4912312
M2S1-02-04,3,4928988
M2S1-02-04,1,4928990
M2S1-02-04,3,4928991
M2S1-02-04,5,4928993
M2S1-02-04,5,4928995
M2S1-02-04,3,4928996
M2S1-02-04,1,4928997
M2S1-02-04,1,4928999
M2S1-02-05,3,4903005
M2S1-02-05,3,4903006
M2S1-02-05,3,4903007
M2S1-02-05,3,4903008
M2S1-02-05,3,4912315
M2S1-02-05,3,4912316
M2S1-02-05,3,4929000
M2S1-02-05,3,4929001
M2S1-02-05,3,4929003
M2S1-02-05,3,4929004
M2S1-02-06,4,4902988
M2S1-02-06,5,4912302
M2S1-02-06,4,4928978
M2S1-02-06,5,4928979
M2S1-02-06,5,4928980
M2S1-02-07,3,4903009
M2S1-02-07,3,4903010
M2S1-02-07,3,4903011
M2S1-02-07,3,4929005
M2S1-02-07,3,4929006
M2S1-02-07,3,4929007
M2S1-02-08,2,4903014
M2S1-02-08,3,4903015
M2S1-02-08,2,4912317
M2S1-02-08,3,4912318
M2S1-02-08,3,4912319
M2S1-02-08,3,4912320
M2S1-02-08,4,4912348
M2S1-02-08,4,4912349
M2S1-02-08,4,4912350
M2S1-02-08,4,4912351
M2S1-02-08,3,4929008
M2S1-02-08,3,4929010
M2S1-02-08,5,4929011
M2S1-02-08,5,4929012
M2S1-02-09,3,4903012
M2S1-02-09,3,4903013
M2S1-02-09,3,4903016
M2S1-02-09,3,4903017
M2S1-02-09,4,4903018
M2S1-02-09,3,4912321
M2S1-02-09,3,4912322
M2S1-02-09,3,4912323
M2S1-02-09,4,4912324
M2S1-02-09,3,4929013
M2S1-02-09,3,4929014
M2S1-02-09,3,4929015
M2S1-02-09,5,4929017
M2S1-02-09,3,4929018
M2S1-02-09,3,4929019
M2S1-02-09,5,4929020
M2S1-02-10,5,4903022
M2S1-02-10,5,4912352
M2S1-02-10,5,4912353
M2S1-02-10,5,4912354
M2S1-02-11,2,4903019
M2S1-02-11,3,4903020
M2S1-02-11,5,4903021
M2S1-02-11,2,4912325
M2S1-02-11,3,4912326
M2S1-02-11,4,4912327
M2S1-02-11,4,4912328
M2S1-02-11,2,4929022
M2S1-02-11,3,4929023
M2S1-02-11,3,4929025
M2S1-02-11,5,4929026
M2S1-02-11,5,4929028
M2S1-02-12,1,4903023
M2S1-02-12,2,4903024
M2S1-02-12,2,4903025
M2S1-02-12,3,4903026
M2S1-02-12,3,4903027
M2S1-02-12,3,4903028
M2S1-02-12,3,4912329
M2S1-02-12,2,4912330
M2S1-02-12,3,4912331
M2S1-02-12,3,4912332
M2S1-02-12,3,4929030
M2S1-02-12,3,4929032
M2S1-02-12,3,4929033
M2S1-02-13,2,4903029
M2S1-02-13,3,4903030
M2S1-02-13,3,4903031
M2S1-02-13,3,4903032
M2S1-02-13,3,4903033
M2S1-02-13,3,4912333
M2S1-02-13,3,4912334
M2S1-02-13,3,4912336
M2S1-02-13,3,4912337
M2S1-02-13,3,4929034
M2S1-02-13,3,4929035
M2S1-02-13,3,4929036
M2S1-02-13,5,4929037
M2S1-02-14,3,4903034
M2S1-02-14,3,4903035
M2S1-02-14,3,4903036
M2S1-02-14,3,4912338
M2S1-02-14,3,4912339
M2S1-02-14,3,4912340
M2S1-02-14,3,4929038
M2S1-02-14,3,4929039
M2S1-02-14,3,4929040
M2S1-02-14,5,4929041
M2S1-02-15,2,4903045
M2S1-02-15,3,4903046
M2S1-02-15,2,4903047
M2S1-02-15,3,4903048
M2S1-02-15,3,4903049
M2S1-02-15,3,4903050
M2S1-02-15,3,4912341
M2S1-02-15,3,4912342
M2S1-02-15,3,4912343
M2S1-02-15,3,4929042
M2S1-02-15,3,4929043
M2S1-02-15,3,4929044
M2S1-02-15,3,4929045
M2S1-02-15,5,4929046
M2S1-02-16,2,4903051
M2S1-02-16,3,4903052
M2S1-02-16,3,4903053
M2S1-02-16,3,4912344
M2S1-02-16,2,4912345
M2S1-02-16,3,4929047
M2S1-02-16,1,4929048
M2S1-02-16,3,4929049
M2S1-02-16,5,4929050
M2S1-02-17,2,4903054
M2S1-02-17,3,4903055
M2S1-02-17,5,4903056
M2S1-02-17,5,4903057
M2S1-02-17,2,4912346
M2S1-02-17,3,4912347
M2S1-02-17,2,4929051
M2S1-02-17,3,4929082
M2S1-02-17,3,4929083
M2S1-02-17,5,4929085
M2S1-03-01,1,4903058
M2S1-03-01,1,4903059
M2S1-03-01,1,4903060
M2S1-03-01,1,4903061
M2S1-03-01,2,4903062
M2S1-03-01,4,4903063
M2S1-03-01,3,4912404
M2S1-03-01,2,4912406
M2S1-03-01,2,4912409
M2S1-03-01,3,4912411
M2S1-03-01,2,4929146
M2S1-03-01,3,4929147
M2S1-03-01,3,4929148
M2S1-03-01,5,4929149
M2S1-03-02,1,4903064
M2S1-03-02,1,4903065
M2S1-03-02,2,4903066
M2S1-03-02,2,4903067
M2S1-03-02,2,4912413
M2S1-03-02,1,4912414
M2S1-03-02,2,4912416
M2S1-03-02,3,4912417
M2S1-03-02,2,4929150
M2S1-03-02,1,4929151
M2S1-03-02,3,4929152
M2S1-03-02,3,4929153
M2S1-03-03,3,4903068
M2S1-03-03,3,4903069
M2S1-03-03,3,4903070
M2S1-03-03,3,4912418
M2S1-03-03,3,4912419
M2S1-03-03,3,4912420
M2S1-03-03,4,4912421
M2S1-03-03,3,4929154
M2S1-03-03,3,4929155
M2S1-03-03,3,4929156
M2S1-03-04,3,4912425
M2S1-03-04,3,4912430
M2S1-03-04,4,4912459
M2S1-03-04,3,4912462
M2S1-03-04,4,4912464
M2S1-03-04,3,4929157
M2S1-03-04,1,4929158
M2S1-03-04,3,4929159
M2S1-03-04,3,4929160
M2S1-03-04,5,4929161
M2S1-03-04,5,4929162
M2S1-03-05,3,4903076
M2S1-03-05,3,4903077
M2S1-03-05,3,4912423
M2S1-03-05,3,4929163
M2S1-03-05,3,4929164
M2S1-03-05,3,4929165
M2S1-03-05,3,4929166
M2S1-03-05,3,4929167
M2S1-03-05,5,4929168
M2S1-03-06,2,4903080
M2S1-03-06,2,4903081
M2S1-03-06,2,4903082
M2S1-03-06,2,4912431
M2S1-03-06,2,4912432
M2S1-03-06,2,4912433
M2S1-03-06,3,4912434
M2S1-03-06,2,4929169
M2S1-03-06,1,4929170
M2S1-03-06,3,4929171
M2S1-03-06,3,4929172
M2S1-03-06,3,4929173
M2S1-03-07,1,4903084
M2S1-03-07,1,4903085
M2S1-03-07,1,4903086
M2S1-03-07,3,4903087
M2S1-03-07,3,4912435
M2S1-03-07,2,4912436
M2S1-03-07,3,4912437
M2S1-03-07,3,4912438
M2S1-03-07,2,4929174
M2S1-03-07,1,4929175
M2S1-03-07,3,4929176
M2S1-03-07,3,4929177
M2S1-03-08,3,4903083
M2S1-03-08,3,4903088
M2S1-03-08,3,4929178
M2S1-03-08,3,4929179
M2S1-03-08,3,4929180
M2S1-03-08,3,4929181
M2S1-03-09,2,4903089
M2S1-03-09,3,4903090
M2S1-03-09,2,4903091
M2S1-03-09,3,4903092
M2S1-03-09,3,4903093
M2S1-03-09,3,4912440
M2S1-03-09,2,4912442
M2S1-03-09,3,4912443
M2S1-03-09,3,4912444
M2S1-03-09,3,4929182
M2S1-03-09,1,4929183
M2S1-03-09,3,4929184
M2S1-03-09,3,4929185
M2S1-03-09,5,4929186
M2S1-03-10,2,4903096
M2S1-03-10,3,4903098
M2S1-03-10,2,4912447
M2S1-03-10,3,4912465
M2S1-03-10,4,4912466
M2S1-03-10,3,4929187
M2S1-03-10,1,4929189
M2S1-03-10,3,4929190
M2S1-03-10,3,4929191
M2S1-03-10,3,4929192
M2S1-03-10,5,4929193
M2S1-03-11,3,4903097
M2S1-03-11,3,4912445
M2S1-03-11,3,4912448
M2S1-03-11,5,4912468
M2S1-03-11,3,4929194
M2S1-03-11,1,4929195
M2S1-03-11,3,4929196
M2S1-03-11,3,4929197
M2S1-03-11,3,4929198
M2S1-03-12,2,4903094
M2S1-03-12,3,4903095
M2S1-03-12,3,4912449
M2S1-03-12,3,4912450
M2S1-03-12,3,4912451
M2S1-03-12,5,4912452
M2S1-03-12,3,4929199
M2S1-03-12,1,4929200
M2S1-03-12,3,4929201
M2S1-03-12,3,4929202
M2S1-03-12,5,4929204
M2S1-03-13,3,4912453
M2S1-03-13,2,4912454
M2S1-03-13,3,4912455
M2S1-03-13,3,4912457
M2S1-03-13,3,4929205
M2S1-03-13,1,4929206
M2S1-03-13,3,4929207
M2S1-03-13,5,4929208
M2S1-03-14,3,4929209
M2S1-03-14,3,4929210
M2S1-03-14,3,4929211
M2S1-03-14,5,4929212
M2S1-03-14,5,4929213
M2S1-03-15,3,4929209
M2S1-03-15,3,4929210
M2S1-03-15,3,4929211
M2S1-03-15,5,4929212
M2S1-03-15,5,4929213
M2S1-04-01,1,4903156
M2S1-04-01,1,4912543
M2S1-04-01,1,4912544
M2S1-04-01,1,4929302
M2S1-04-01,1,4929303
M2S1-04-01,1,4929304
M2S1-04-02,3,4903157
M2S1-04-02,1,4903158
M2S1-04-02,3,4912545
M2S1-04-02,1,4912546
M2S1-04-02,3,4929305
M2S1-04-02,1,4929306
M2S1-04-02,1,4929307
M2S1-04-02,3,4929308
M2S1-04-03,1,4903159
M2S1-04-03,1,4903160
M2S1-04-03,3,4903161
M2S1-04-03,3,4903162
M2S1-04-03,2,4912547
M2S1-04-03,1,4912548
M2S1-04-03,1,4912549
M2S1-04-03,3,4912550
M2S1-04-03,2,4929309
M2S1-04-03,1,4929310
M2S1-04-03,1,4929311
M2S1-04-03,1,4929312
M2S1-04-03,3,4929313
M2S1-04-04,2,4903163
M2S1-04-04,3,4903164
M2S1-04-04,3,4903165
M2S1-04-04,3,4903166
M2S1-04-04,3,4903167
M2S1-04-04,3,4903168
M2S1-04-04,3,4903169
M2S1-04-04,2,4912551
M2S1-04-04,1,4912552
M2S1-04-04,3,4912554
M2S1-04-04,3,4912555
M2S1-04-04,3,4929314
M2S1-04-04,3,4929315
M2S1-04-04,3,4929316
M2S1-04-04,5,4929317
M2S1-04-04,5,4929318
M2S1-04-05,3,4903170
M2S1-04-05,3,4903171
M2S1-04-05,3,4903172
M2S1-04-05,3,4903173
M2S1-04-05,3,4912558
M2S1-04-05,3,4912560
M2S1-04-05,3,4912561
M2S1-04-05,3,4912562
M2S1-04-05,3,4912608
M2S1-04-05,4,4912613
M2S1-04-05,1,4929319
M2S1-04-05,1,4929320
M2S1-04-05,3,4929321
M2S1-04-05,3,4929322
M2S1-04-05,5,4929323
M2S1-04-06,2,4903174
M2S1-04-06,2,4912563
M2S1-04-06,1,4912564
M2S1-04-06,2,4912565
M2S1-04-06,3,4912566
M2S1-04-06,2,4929324
M2S1-04-06,1,4929325
M2S1-04-06,3,4929326
M2S1-04-06,3,4929327
M2S1-04-06,5,4929328
M2S1-04-07,1,4903175
M2S1-04-07,1,4903177
M2S1-04-07,2,4903178
M2S1-04-07,2,4903179
M2S1-04-07,3,4903180
M2S1-04-07,1,4912568
M2S1-04-07,3,4912570
M2S1-04-07,2,4929329
M2S1-04-07,1,4929330
M2S1-04-07,1,4929331
M2S1-04-07,3,4929333
M2S1-04-07,3,4929334
M2S1-04-07,3,4929335
M2S1-04-08,1,4903176
M2S1-04-08,2,4912567
M2S1-04-08,3,4912569
M2S1-04-08,1,4929336
M2S1-04-08,1,4929337
M2S1-04-08,1,4929338
M2S1-04-08,3,4929339
M2S1-04-09,1,4903181
M2S1-04-09,2,4903182
M2S1-04-09,3,4903183
M2S1-04-09,3,4903184
M2S1-04-09,2,4912571
M2S1-04-09,3,4912572
M2S1-04-09,3,4912574
M2S1-04-09,3,4912575
M2S1-04-09,3,4912576
M2S1-04-09,3,4912577
M2S1-04-09,3,4912578
M2S1-04-09,3,4929340
M2S1-04-09,1,4929341
M2S1-04-09,1,4929342
M2S1-04-09,3,4929343
M2S1-04-09,3,4929344
M2S1-04-10,3,4903185
M2S1-04-10,3,4903186
M2S1-04-10,3,4903187
M2S1-04-10,3,4903188
M2S1-04-10,3,4912579
M2S1-04-10,3,4912580
M2S1-04-10,3,4912581
M2S1-04-10,3,4912582
M2S1-04-10,3,4912583
M2S1-04-10,3,4912584
M2S1-04-10,3,4912585
M2S1-04-10,3,4929345
M2S1-04-10,3,4929346
M2S1-04-10,3,4929347
M2S1-04-10,3,4929348
M2S1-04-10,3,4929350
M2S1-04-11,3,4903202
M2S1-04-11,3,4903203
M2S1-04-11,4,4903204
M2S1-04-11,3,4903205
M2S1-04-11,3,4912596
M2S1-04-11,3,4912597
M2S1-04-11,3,4912598
M2S1-04-11,3,4912599
M2S1-04-11,3,4929351
M2S1-04-11,3,4929352
M2S1-04-11,3,4929354
M2S1-04-11,5,4929355
M2S1-04-11,5,4929357
M2S1-04-12,3,4903206
M2S1-04-12,3,4903207
M2S1-04-12,3,4903208
M2S1-04-12,3,4912592
M2S1-04-12,3,4912593
M2S1-04-12,3,4912595
M2S1-04-12,3,4912600
M2S1-04-12,3,4912601
M2S1-04-12,3,4912602
M2S1-04-12,3,4912603
M2S1-04-12,3,4929359
M2S1-04-12,3,4929361
M2S1-04-12,3,4929362
M2S1-04-12,3,4929364
M2S1-04-12,5,4929367
M2S1-04-13,3,4903209
M2S1-04-13,3,4912604
M2S1-04-13,3,4912605
M2S1-04-13,3,4912606
M2S1-04-13,3,4912607
M2S1-04-13,3,4929368
M2S1-04-13,3,4929370
M2S1-04-13,3,4929373
M2S1-04-14,3,4903210
M2S1-04-14,4,4903211
M2S1-04-14,4,4903212
M2S1-04-14,3,4912594
M2S1-04-14,4,4912614
M2S1-04-14,4,4912615
M2S1-04-14,4,4912616
M2S1-04-14,5,4912617
M2S1-04-14,3,4929375
M2S1-04-14,3,4929376
M2S1-04-14,5,4929378
M2S1-04-15,4,4903213
M2S1-04-15,4,4929379
M2S1-04-15,5,4929381
M2S1-04-15,5,4929383
M2S1-05-01,2,4903214
M2S1-05-01,3,4903215
M2S1-05-01,3,4912653
M2S1-05-01,2,4912655
M2S1-05-01,3,4912656
M2S1-05-01,3,4912658
M2S1-05-01,2,4929450
M2S1-05-01,3,4929451
M2S1-05-01,3,4929452
M2S1-05-01,3,4929454
M2S1-05-01,3,4929455
M2S1-05-01,3,4929457
M2S1-05-01,3,4929458
M2S1-05-02,3,4903218
M2S1-05-02,2,4912659
M2S1-05-02,2,4912660
M2S1-05-02,3,4912661
M2S1-05-02,2,4929479
M2S1-05-02,1,4929480
M2S1-05-02,3,4929482
M2S1-05-03,3,4903216
M2S1-05-03,2,4912662
M2S1-05-03,2,4912663
M2S1-05-03,3,4912664
M2S1-05-03,3,4912665
M2S1-05-03,2,4929460
M2S1-05-03,1,4929461
M2S1-05-03,3,4929462
M2S1-05-03,5,4929463
M2S1-05-04,3,4903217
M2S1-05-04,2,4903221
M2S1-05-04,3,4903222
M2S1-05-04,2,4912666
M2S1-05-04,2,4912667
M2S1-05-04,3,4912668
M2S1-05-04,3,4912669
M2S1-05-04,2,4929464
M2S1-05-04,3,4929465
M2S1-05-04,3,4929466
M2S1-05-04,3,4929468
M2S1-05-04,3,4929469
M2S1-05-04,3,4929471
M2S1-05-04,3,4929472
M2S1-05-04,3,4929474
M2S1-05-04,3,4929517
M2S1-05-04,3,4929518
M2S1-05-04,3,4929520
M2S1-05-04,3,4929522
M2S1-05-05,3,4903223
M2S1-05-05,3,4912670
M2S1-05-05,3,4912671
M2S1-05-05,3,4912672
M2S1-05-05,3,4912673
M2S1-05-05,3,4929475
M2S1-05-05,3,4929476
M2S1-05-05,3,4929477
M2S1-05-05,5,4929478
M2S1-05-06,3,4903224
M2S1-05-06,3,4903225
M2S1-05-06,3,4903226
M2S1-05-06,3,4912674
M2S1-05-06,3,4912675
M2S1-05-06,3,4912676
M2S1-05-06,3,4912677
M2S1-05-06,3,4912678
M2S1-05-06,2,4912679
M2S1-05-06,3,4912680
M2S1-05-06,3,4929483
M2S1-05-06,3,4929484
M2S1-05-06,3,4929489
M2S1-05-06,5,4929491
M2S1-05-06,3,4929494
M2S1-05-06,3,4929496
M2S1-05-06,3,4929498
M2S1-05-07,3,4903227
M2S1-05-07,3,4903228
M2S1-05-07,3,4903229
M2S1-05-07,3,4912681
M2S1-05-07,3,4912682
M2S1-05-07,4,4912683
M2S1-05-07,4,4912684
M2S1-05-07,3,4929499
M2S1-05-07,3,4929500
M2S1-05-07,5,4929503
M2S1-05-08,2,4903219
M2S1-05-08,2,4903220
M2S1-05-08,3,4912685
M2S1-05-08,1,4912686
M2S1-05-08,2,4912687
M2S1-05-08,3,4912688
M2S1-05-08,3,4929504
M2S1-05-08,3,4929507
M2S1-05-08,3,4929509
M2S1-05-08,3,4929511
M2S1-05-08,3,4929513
M2S1-05-08,5,4929514
M2S1-05-09,3,4903230
M2S1-05-09,3,4912689
M2S1-05-09,3,4912690
M2S1-05-09,3,4912691
M2S1-05-09,3,4912692
M2S1-05-09,3,4929524
M2S1-05-09,3,4929526
M2S1-05-09,3,4929528
M2S1-05-10,3,4903231
M2S1-05-10,4,4903232
M2S1-05-10,3,4912701
M2S1-05-10,3,4912702
M2S1-05-10,3,4912703
M2S1-05-10,3,4929530
M2S1-05-10,3,4929533
M2S1-05-10,3,4929534
M2S1-05-10,3,4929537
M2S1-05-11,3,4912704
M2S1-05-11,3,4912705
M2S1-05-11,5,4912706
M2S1-05-11,3,4929538
M2S1-05-11,3,4929540
M2S1-05-12,3,4903233
M2S1-05-12,4,4903234
M2S1-05-12,3,4912693
M2S1-05-12,3,4912694
M2S1-05-12,4,4912695
M2S1-05-12,5,4912696
M2S1-05-12,3,4929547
M2S1-05-12,3,4929549
M2S1-05-12,5,4929550
M2S1-05-13,3,4903235
M2S1-05-13,3,4912697
M2S1-05-13,3,4912698
M2S1-05-13,3,4912699
M2S1-05-13,3,4912700
M2S1-05-13,3,4929542
M2S1-05-13,3,4929543
M2S1-05-13,3,4929545
M2S1-06-01,1,4903406
M2S1-06-01,1,4903407
M2S1-06-01,3,4903408
M2S1-06-01,1,4912770
M2S1-06-01,1,4912771
M2S1-06-01,1,4912772
M2S1-06-01,1,4930548
M2S1-06-01,3,4930550
M2S1-06-01,3,4930551
M2S1-06-01,3,4930552
M2S1-06-01,3,4930553
M2S1-06-01,3,4930555
M2S1-06-02,1,4903409
M2S1-06-02,3,4903413
M2S1-06-02,3,4903414
M2S1-06-02,2,4912773
M2S1-06-02,1,4912774
M2S1-06-02,1,4912775
M2S1-06-02,2,4912776
M2S1-06-02,1,4930556
M2S1-06-02,3,4930558
M2S1-06-02,2,4930562
M2S1-06-02,1,4930563
M2S1-06-02,3,4930565
M2S1-06-02,3,4930573
M2S1-06-03,1,4903415
M2S1-06-03,1,4903416
M2S1-06-03,3,4903417
M2S1-06-03,3,4903418
M2S1-06-03,1,4912777
M2S1-06-03,1,4912778
M2S1-06-03,3,4912779
M2S1-06-03,3,4912780
M2S1-06-03,3,4930574
M2S1-06-03,1,4930576
M2S1-06-03,3,4930577
M2S1-06-03,3,4930578
M2S1-06-04,2,4903419
M2S1-06-04,1,4903420
M2S1-06-04,1,4912781
M2S1-06-04,2,4912782
M2S1-06-04,2,4912783
M2S1-06-04,2,4930579
M2S1-06-04,3,4930580
M2S1-06-04,5,4930581
M2S1-06-04,2,4930583
M2S1-06-04,1,4930584
M2S1-06-04,3,4930585
M2S1-06-04,3,4930590
M2S1-06-05,3,4903421
M2S1-06-05,3,4903422
M2S1-06-05,3,4903423
M2S1-06-05,3,4903424
M2S1-06-05,3,4912784
M2S1-06-05,3,4912785
M2S1-06-05,3,4912786
M2S1-06-05,3,4912787
M2S1-06-05,3,4930595
M2S1-06-05,3,4930596
M2S1-06-05,3,4930597
M2S1-06-05,3,4930599
M2S1-06-05,5,4930600
M2S1-06-06,1,4903428
M2S1-06-06,2,4903429
M2S1-06-06,3,4903430
M2S1-06-06,2,4912788
M2S1-06-06,2,4912789
M2S1-06-06,2,4912790
M2S1-06-06,2,4912791
M2S1-06-06,2,4912792
M2S1-06-06,2,4912793
M2S1-06-06,3,4912794
M2S1-06-06,2,4930668
M2S1-06-06,1,4930669
M2S1-06-06,1,4930671
M2S1-06-06,3,4930672
M2S1-06-06,3,4930673
M2S1-06-06,3,4930674
M2S1-06-07,1,4903428
M2S1-06-07,2,4903429
M2S1-06-07,3,4903430
M2S1-06-07,2,4912795
M2S1-06-07,1,4912796
M2S1-06-07,2,4912797
M2S1-06-07,2,4912798
M2S1-06-07,2,4912799
M2S1-06-07,2,4912800
M2S1-06-07,2,4912801
M2S1-06-07,2,4930660
M2S1-06-07,1,4930661
M2S1-06-07,3,4930663
M2S1-06-07,3,4930664
M2S1-06-07,3,4930665
M2S1-06-07,5,4930666
M2S1-06-08,2,4903460
M2S1-06-08,3,4903461
M2S1-06-08,3,4903462
M2S1-06-08,3,4912802
M2S1-06-08,2,4912803
M2S1-06-08,2,4912804
M2S1-06-08,2,4912805
M2S1-06-08,3,4912806
M2S1-06-08,3,4912807
M2S1-06-08,2,4930675
M2S1-06-08,3,4930677
M2S1-06-08,3,4930678
M2S1-06-08,3,4930680
M2S1-06-09,2,4903463
M2S1-06-09,2,4903464
M2S1-06-09,2,4903465
M2S1-06-09,3,4903466
M2S1-06-09,3,4903467
M2S1-06-09,3,4903468
M2S1-06-09,3,4903469
M2S1-06-09,3,4912808
M2S1-06-09,2,4912809
M2S1-06-09,2,4912810
M2S1-06-09,2,4912811
M2S1-06-09,3,4912812
M2S1-06-09,3,4912813
M2S1-06-09,3,4912850
M2S1-06-09,3,4912851
M2S1-06-09,3,4912852
M2S1-06-09,4,4912853
M2S1-06-09,2,4930681
M2S1-06-09,1,4930682
M2S1-06-09,3,4930684
M2S1-06-09,5,4930685
M2S1-06-09,2,4930686
M2S1-06-09,1,4930688
M2S1-06-09,3,4930689
M2S1-06-09,3,4930690
M2S1-06-09,5,4930691
M2S1-06-10,2,4912814
M2S1-06-10,2,4912815
M2S1-06-10,2,4912816
M2S1-06-10,4,4912817
M2S1-06-10,2,4930693
M2S1-06-10,3,4930694
M2S1-06-10,5,4930695
M2S1-06-11,1,4903470
M2S1-06-11,2,4903471
M2S1-06-11,3,4903472
M2S1-06-11,2,4903473
M2S1-06-11,2,4903474
M2S1-06-11,3,4912818
M2S1-06-11,2,4912819
M2S1-06-11,2,4912820
M2S1-06-11,2,4912821
M2S1-06-11,3,4912822
M2S1-06-11,3,4912823
M2S1-06-11,3,4930697
M2S1-06-11,3,4930698
M2S1-06-11,3,4930699
M2S1-06-11,3,4930700
M2S1-06-11,5,4930702
M2S1-06-12,3,4903441
M2S1-06-12,3,4903442
M2S1-06-12,3,4903443
M2S1-06-12,3,4912824
M2S1-06-12,3,4912825
M2S1-06-12,3,4912826
M2S1-06-12,3,4912827
M2S1-06-12,1,4930703
M2S1-06-12,1,4930704
M2S1-06-12,3,4930706
M2S1-06-12,3,4930707
M2S1-06-13,3,4903444
M2S1-06-13,3,4903445
M2S1-06-13,3,4903446
M2S1-06-13,3,4912828
M2S1-06-13,3,4912829
M2S1-06-13,3,4912830
M2S1-06-13,5,4930708
M2S1-06-13,3,4930710
M2S1-06-13,3,4930711
M2S1-06-13,3,4930712
M2S1-06-13,5,4930713
M2S1-06-14,2,4903447
M2S1-06-14,3,4903448
M2S1-06-14,4,4903449
M2S1-06-14,3,4912831
M2S1-06-14,2,4912832
M2S1-06-14,3,4912833
M2S1-06-14,4,4912834
M2S1-06-14,2,4930715
M2S1-06-14,3,4930716
M2S1-06-14,3,4930718
M2S1-06-14,3,4930719
M2S1-06-15,3,4903450
M2S1-06-15,3,4903451
M2S1-06-15,3,4903452
M2S1-06-15,3,4912835
M2S1-06-15,3,4912836
M2S1-06-15,3,4912837
M2S1-06-15,3,4930737
M2S1-06-15,3,4930739
M2S1-06-15,5,4930740
M2S1-06-16,3,4903457
M2S1-06-16,3,4903458
M2S1-06-16,3,4903459
M2S1-06-16,3,4912838
M2S1-06-16,3,4912839
M2S1-06-16,3,4912840
M2S1-06-16,4,4912841
M2S1-06-16,3,4930721
M2S1-06-16,3,4930723
M2S1-06-16,3,4930724
M2S1-06-16,3,4930736
M2S1-06-17,2,4903480
M2S1-06-17,2,4903481
M2S1-06-17,2,4903482
M2S1-06-17,2,4912842
M2S1-06-17,2,4912843
M2S1-06-17,2,4912844
M2S1-06-17,3,4912845
M2S1-06-17,2,4930742
M2S1-06-17,1,4930744
M2S1-06-17,3,4930745
M2S1-06-17,5,4930747
M2S1-06-18,2,4903483
M2S1-06-18,2,4903484
M2S1-06-18,3,4903485
M2S1-06-18,3,4912846
M2S1-06-18,2,4912847
M2S1-06-18,2,4912848
M2S1-06-18,3,4912849
M2S1-06-18,2,4930748
M2S1-06-18,3,4930750
M2S1-06-18,3,4930752
M2S1-06-18,3,4930753
M2S1-06-18,5,4930755
M2S1-06-19,3,4912854
M2S1-06-19,4,4912855
M2S1-06-19,5,4912856
M2S1-07-01,3,4912900
M2S1-07-01,2,4912901
M2S1-07-01,2,4912902
M2S1-07-01,3,4912903
M2S1-07-01,2,4930810
M2S1-07-01,1,4930811
M2S1-07-01,3,4930812
M2S1-07-01,5,4930813
M2S1-07-02,3,4912904
M2S1-07-02,3,4912905
M2S1-07-02,3,4912906
M2S1-07-02,3,4912907
M2S1-07-02,3,4930814
M2S1-07-02,3,4930816
M2S1-07-02,3,4930817
M2S1-07-02,3,4930818
M2S1-07-02,5,4930819
M2S1-07-03,3,4912908
M2S1-07-03,2,4912909
M2S1-07-03,3,4912910
M2S1-07-03,3,4930820
M2S1-07-03,1,4930821
M2S1-07-03,3,4930822
M2S1-07-03,5,4930823
M2S1-07-04,2,4903489
M2S1-07-04,2,4903490
M2S1-07-04,2,4903491
M2S1-07-04,2,4903492
M2S1-07-04,2,4903493
M2S1-07-04,2,4912911
M2S1-07-04,2,4912912
M2S1-07-04,2,4912913
M2S1-07-04,3,4912914
M2S1-07-04,2,4930824
M2S1-07-04,3,4930825
M2S1-07-04,3,4930826
M2S1-07-04,3,4930827
M2S1-07-04,5,4930828
M2S1-07-04,3,4930829
M2S1-07-04,3,4930830
M2S1-07-04,5,4930831
M2S1-07-04,3,4930832
M2S1-07-04,1,4930833
M2S1-07-04,3,4930834
M2S1-07-04,3,4930835
M2S1-07-04,5,4930836
M2S1-07-05,2,4903494
M2S1-07-05,2,4903495
M2S1-07-05,3,4930837
M2S1-07-05,1,4930838
M2S1-07-05,3,4930839
M2S1-07-05,5,4930840
M2S1-07-06,3,4912940
M2S1-07-06,2,4912941
M2S1-07-06,3,4912942
M2S1-07-06,4,4912943
M2S1-07-06,3,4930841
M2S1-07-06,3,4930842
M2S1-07-06,5,4930844
M2S1-07-06,5,4930845
M2S1-07-07,2,4903496
M2S1-07-07,3,4903497
M2S1-07-07,3,4903498
M2S1-07-07,3,4903499
M2S1-07-07,3,4912915
M2S1-07-07,2,4912916
M2S1-07-07,3,4912917
M2S1-07-07,4,4912918
M2S1-07-07,3,4930846
M2S1-07-07,3,4930847
M2S1-07-07,3,4930848
M2S1-07-07,3,4930849
M2S1-07-08,3,4903500
M2S1-07-08,3,4903501
M2S1-07-08,3,4903502
M2S1-07-08,3,4912944
M2S1-07-08,3,4912945
M2S1-07-08,3,4912946
M2S1-07-08,3,4912947
M2S1-07-08,3,4930851
M2S1-07-08,3,4930853
M2S1-07-08,3,4930854
M2S1-07-08,3,4930855
M2S1-07-08,3,4930856
M2S1-07-08,3,4930858
M2S1-07-09,3,4903520
M2S1-07-09,3,4903521
M2S1-07-09,4,4912948
M2S1-07-09,4,4912949
M2S1-07-09,4,4912950
M2S1-07-09,4,4912951
M2S1-07-09,4,4930860
M2S1-07-09,3,4930865
M2S1-07-09,5,4930866
M2S1-07-09,5,4930867
M2S1-07-10,3,4903522
M2S1-07-10,3,4912952
M2S1-07-10,3,4912953
M2S1-07-10,3,4912954
M2S1-07-10,4,4912955
M2S1-07-10,4,4930868
M2S1-07-10,1,4930870
M2S1-07-10,3,4930871
M2S1-07-10,5,4930872
M2S1-07-10,5,4930873
M2S1-07-11,3,4903523
M2S1-07-11,3,4903524
M2S1-07-11,3,4903525
M2S1-07-11,3,4912956
M2S1-07-11,3,4912957
M2S1-07-11,3,4912958
M2S1-07-11,3,4912959
M2S1-07-11,3,4930874
M2S1-07-11,3,4930875
M2S1-07-11,3,4930876
M2S1-07-11,3,4930877
M2S1-07-12,2,4903503
M2S1-07-12,3,4903504
M2S1-07-12,3,4912919
M2S1-07-12,3,4930878
M2S1-07-12,3,4930880
M2S1-07-12,3,4930881
M2S1-07-12,3,4930882
M2S1-07-12,5,4930883
M2S1-07-13,3,4912920
M2S1-07-13,3,4912921
M2S1-07-13,4,4912922
M2S1-07-13,3,4930884
M2S1-07-13,3,4930885
M2S1-07-13,5,4930887
M2S1-07-14,3,4903506
M2S1-07-14,3,4912924
M2S1-07-14,3,4912925
M2S1-07-14,3,4930888
M2S1-07-14,3,4930889
M2S1-07-14,5,4930890
M2S1-07-15,3,4903505
M2S1-07-15,3,4912923
M2S1-07-15,3,4912926
M2S1-07-15,3,4930891
M2S1-07-15,3,4930893
M2S1-07-15,5,4930894
M2S1-07-16,4,4912927
M2S1-07-16,4,4912928
M2S1-07-16,4,4912929
M2S1-07-16,4,4930895
M2S1-07-16,3,4930897
M2S1-07-16,5,4930898
M2S1-07-17,3,4912930
M2S1-07-17,3,4912931
M2S1-07-17,4,4912932
M2S1-07-17,3,4930900
M2S1-07-17,3,4930902
M2S1-07-17,5,4930903
M2S1-07-18,5,4903508
M2S1-07-18,4,4912960
M2S1-07-18,4,4912961
M2S1-07-18,5,4912962
M2S1-07-18,3,4930904
M2S1-07-18,3,4930905
M2S1-07-18,5,4930907
M2S1-07-19,3,4903512
M2S1-07-19,3,4930910
M2S1-07-20,3,4903509
M2S1-07-20,3,4903510
M2S1-07-20,4,4903511
M2S1-07-20,4,4903513
M2S1-07-20,3,4912933
M2S1-07-20,3,4912934
M2S1-07-20,4,4912935
M2S1-07-20,5,4912936
M2S1-07-20,3,4912937
M2S1-07-20,3,4912938
M2S1-07-20,3,4912939
M2S1-07-20,3,4930908
M2S1-07-20,3,4930909
M2S1-07-20,5,4930911
M2S1-07-20,3,4930913
M2S1-07-20,3,4930914
M2S1-07-20,5,4930915
M2S1-07-21,3,4903517
M2S1-07-21,3,4903518
M2S1-07-21,4,4903519
M2S1-07-21,3,4912963
M2S1-07-21,3,4912964
M2S1-07-21,4,4912965
M2S1-07-21,3,4930917
M2S1-07-21,5,4930918
M2S1-07-21,5,4930919
M2S1-08-01,3,4903572
M2S1-08-01,3,4903573
M2S1-08-01,3,4913050
M2S1-08-01,3,4913052
M2S1-08-01,3,4913054
M2S1-08-01,3,4930986
M2S1-08-01,3,4930988
M2S1-08-01,5,4930989
M2S1-08-02,1,4903574
M2S1-08-02,1,4903575
M2S1-08-02,2,4903576
M2S1-08-02,3,4903577
M2S1-08-02,2,4913056
M2S1-08-02,1,4913057
M2S1-08-02,2,4913059
M2S1-08-02,3,4913061
M2S1-08-02,3,4930990
M2S1-08-02,3,4930991
M2S1-08-02,3,4930993
M2S1-08-02,5,4930994
M2S1-08-02,3,4930996
M2S1-08-02,3,4930997
M2S1-08-02,5,4930998
M2S1-08-03,1,4903582
M2S1-08-03,3,4903583
M2S1-08-03,1,4913062
M2S1-08-03,1,4913064
M2S1-08-03,3,4913066
M2S1-08-03,1,4930999
M2S1-08-03,1,4931001
M2S1-08-03,3,4931002
M2S1-08-03,3,4931003
M2S1-08-04,3,4903584
M2S1-08-04,3,4913068
M2S1-08-04,3,4931004
M2S1-08-04,3,4931005
M2S1-08-05,2,4903585
M2S1-08-05,2,4903586
M2S1-08-05,3,4903587
M2S1-08-05,2,4903588
M2S1-08-05,2,4931006
M2S1-08-05,1,4931008
M2S1-08-05,3,4931009
M2S1-08-05,3,4931010
M2S1-08-05,3,4931011
M2S1-08-06,1,4903589
M2S1-08-06,2,4903590
M2S1-08-06,3,4903591
M2S1-08-06,3,4903592
M2S1-08-06,3,4913070
M2S1-08-06,1,4913072
M2S1-08-06,3,4913073
M2S1-08-06,3,4913075
M2S1-08-06,1,4931012
M2S1-08-06,1,4931014
M2S1-08-06,3,4931015
M2S1-08-06,3,4931016
M2S1-08-06,3,4931017
M2S1-08-06,5,4931018
M2S1-08-07,2,4903593
M2S1-08-07,2,4903594
M2S1-08-07,3,4903595
M2S1-08-07,3,4903596
M2S1-08-07,3,4903597
M2S1-08-07,3,4903598
M2S1-08-07,3,4913077
M2S1-08-07,2,4913079
M2S1-08-07,3,4913080
M2S1-08-07,3,4913082
M2S1-08-07,3,4931019
M2S1-08-07,1,4931020
M2S1-08-07,3,4931021
M2S1-08-07,3,4931022
M2S1-08-07,2,4931023
M2S1-08-07,1,4931024
M2S1-08-07,3,4931025
M2S1-08-07,3,4931027
M2S1-08-07,5,4931028
M2S1-08-08,2,4903603
M2S1-08-08,2,4903604
M2S1-08-08,2,4903605
M2S1-08-08,2,4903606
M2S1-08-08,2,4903607
M2S1-08-08,3,4903608
M2S1-08-08,3,4903609
M2S1-08-08,3,4913084
M2S1-08-08,2,4913086
M2S1-08-08,3,4913091
M2S1-08-08,3,4913094
M2S1-08-08,3,4913096
M2S1-08-08,1,4931029
M2S1-08-08,1,4931030
M2S1-08-08,3,4931032
M2S1-08-08,3,4931033
M2S1-08-08,3,4931034
M2S1-08-08,3,4931036
M2S1-08-08,1,4931037
M2S1-08-08,3,4931038
M2S1-08-08,3,4931039
M2S1-08-08,5,4931040
M2S1-08-09,1,4903617
M2S1-08-09,1,4903618
M2S1-08-09,1,4903619
M2S1-08-09,1,4903620
M2S1-08-09,3,4903621
M2S1-08-09,3,4903622
M2S1-08-09,3,4903623
M2S1-08-09,2,4913097
M2S1-08-09,2,4913100
M2S1-08-09,2,4913101
M2S1-08-09,3,4913103
M2S1-08-09,3,4913105
M2S1-08-09,2,4931041
M2S1-08-09,1,4931042
M2S1-08-09,3,4931046
M2S1-08-09,3,4931047
M2S1-08-10,1,4903624
M2S1-08-10,1,4903625
M2S1-08-10,2,4903626
M2S1-08-10,2,4913107
M2S1-08-10,2,4913118
M2S1-08-10,2,4913120
M2S1-08-10,2,4931049
M2S1-08-10,1,4931050
M2S1-08-10,3,4931051
M2S1-08-10,3,4931052
M2S1-08-10,3,4931054
M2S1-08-10,3,4931055
M2S1-08-10,3,4931061
M2S1-08-10,1,4931062
M2S1-08-10,3,4931064
M2S1-08-10,3,4931065
M2S1-08-10,5,4931066
M2S1-08-11,3,4903627
M2S1-08-11,3,4913122
M2S1-08-11,3,4913124
M2S1-08-11,3,4931056
M2S1-08-11,3,4931057
M2S1-08-11,3,4931059
M2S1-08-11,5,4931060
M2S1-08-12,1,4903610
M2S1-08-12,1,4903611
M2S1-08-12,3,4903612
M2S1-08-12,1,4913126
M2S1-08-12,3,4913127
M2S1-08-12,3,4931067
M2S1-08-12,1,4931069
M2S1-08-12,1,4931070
M2S1-08-12,3,4931071
M2S1-08-12,5,4931072
M2S1-08-13,2,4903613
M2S1-08-13,3,4903614
M2S1-08-13,4,4903615
M2S1-08-13,3,4903616
M2S1-08-13,3,4913129
M2S1-08-13,3,4913131
M2S1-08-13,4,4913133
M2S1-08-13,3,4913193
M2S1-08-13,3,4913194
M2S1-08-13,4,4913195
M2S1-08-13,3,4931074
M2S1-08-13,3,4931075
M2S1-08-13,3,4931077
M2S1-08-13,3,4931079
M2S1-08-13,5,4931081
M2S1-08-13,3,4931082
M2S1-08-13,3,4931083
M2S1-08-13,5,4931085
M2S1-08-13,5,4931086
M2S1-09-01,2,4903631
M2S1-09-01,2,4903632
M2S1-09-01,2,4903633
M2S1-09-01,2,4903634
M2S1-09-01,4,4903635
M2S1-09-01,2,4913135
M2S1-09-01,3,4913136
M2S1-09-01,3,4913138
M2S1-09-01,5,4913196
M2S1-09-01,5,4913197
M2S1-09-01,5,4913198
M2S1-09-01,3,4931165
M2S1-09-01,3,4931166
M2S1-09-01,3,4931167
M2S1-09-01,3,4931168
M2S1-09-01,5,4931169
M2S1-09-01,2,4931170
M2S1-09-01,3,4931172
M2S1-09-01,3,4931173
M2S1-09-01,3,4931174
M2S1-09-01,5,4931175
M2S1-09-02,2,4903639
M2S1-09-02,2,4903640
M2S1-09-02,2,4903641
M2S1-09-02,2,4903642
M2S1-09-02,3,4903643
M2S1-09-02,3,4913140
M2S1-09-02,2,4913141
M2S1-09-02,3,4913143
M2S1-09-02,4,4913145
M2S1-09-02,3,4931177
M2S1-09-02,1,4931178
M2S1-09-02,3,4931179
M2S1-09-02,5,4931180
M2S1-09-02,3,4931181
M2S1-09-02,1,4931183
M2S1-09-02,3,4931184
M2S1-09-02,3,4931185
M2S1-09-03,3,4903645
M2S1-09-03,3,4903646
M2S1-09-03,3,4913147
M2S1-09-03,3,4913149
M2S1-09-03,3,4913151
M2S1-09-03,3,4913152
M2S1-09-03,2,4931188
M2S1-09-03,1,4931189
M2S1-09-03,3,4931190
M2S1-09-03,3,4931191
M2S1-09-04,1,4903628
M2S1-09-04,2,4903629
M2S1-09-04,2,4903630
M2S1-09-04,3,4903647
M2S1-09-04,3,4903648
M2S1-09-04,3,4903649
M2S1-09-04,3,4903650
M2S1-09-04,3,4913154
M2S1-09-04,3,4913156
M2S1-09-04,3,4913158
M2S1-09-04,3,4931156
M2S1-09-04,3,4931157
M2S1-09-04,3,4931158
M2S1-09-04,2,4931159
M2S1-09-04,1,4931161
M2S1-09-04,3,4931162
M2S1-09-04,3,4931164
M2S1-09-04,3,4931193
M2S1-09-04,3,4931194
M2S1-09-04,3,4931196
M2S1-09-04,5,4931197
M2S1-09-05,2,4903652
M2S1-09-05,2,4903653
M2S1-09-05,3,4903654
M2S1-09-05,1,4913296
M2S1-09-05,2,4913297
M2S1-09-05,3,4913298
M2S1-09-05,3,4913299
M2S1-09-05,3,4931198
M2S1-09-05,3,4931200
M2S1-09-05,3,4931201
M2S1-09-05,3,4931202
M2S1-09-06,3,4903655
M2S1-09-06,3,4903656
M2S1-09-06,3,4903657
M2S1-09-06,3,4913300
M2S1-09-06,3,4913301
M2S1-09-06,3,4913302
M2S1-09-06,3,4913303
M2S1-09-06,3,4931204
M2S1-09-06,3,4931205
M2S1-09-06,3,4931206
M2S1-09-06,3,4931208
M2S1-09-07,2,4903658
M2S1-09-07,2,4903659
M2S1-09-07,3,4903660
M2S1-09-07,2,4913304
M2S1-09-07,2,4913305
M2S1-09-07,3,4913306
M2S1-09-07,3,4913307
M2S1-09-07,3,4931209
M2S1-09-07,3,4931210
M2S1-09-07,3,4931212
M2S1-09-07,3,4931213
M2S1-09-07,3,4931214
M2S1-09-08,2,4903661
M2S1-09-08,2,4903662
M2S1-09-08,2,4903663
M2S1-09-08,2,4913308
M2S1-09-08,3,4913309
M2S1-09-08,3,4913310
M2S1-09-08,3,4913311
M2S1-09-08,2,4931215
M2S1-09-08,3,4931216
M2S1-09-08,3,4931218
M2S1-09-08,5,4931219
M2S1-09-09,3,4903671
M2S1-09-09,3,4913162
M2S1-09-09,3,4913164
M2S1-09-09,3,4913166
M2S1-09-09,3,4931221
M2S1-09-09,5,4931225
M2S1-09-10,2,4903670
M2S1-09-10,3,4931226
M2S1-09-10,3,4931227
M2S1-09-10,3,4931229
M2S1-09-11,3,4903672
M2S1-09-11,3,4913179
M2S1-09-11,3,4913180
M2S1-09-11,3,4931230
M2S1-09-11,3,4931232
M2S1-09-12,3,4931236
M2S1-09-13,3,4903675
M2S1-09-13,2,4913183
M2S1-09-13,4,4913184
M2S1-09-13,4,4931239
M2S1-09-13,3,4931241
M2S1-09-13,5,4931245
M2S1-09-14,3,4913185
M2S1-09-14,3,4913186
M2S1-09-14,4,4913187
M2S1-09-14,3,4931247
M2S1-09-14,3,4931251
M2S1-09-14,5,4931254
M2S1-09-15,3,4931255
M2S1-09-15,1,4931256
M2S1-09-15,5,4931259
M2S1-09-15,5,4931260
M2S1-09-16,3,4903676
M2S1-09-16,3,4913191
M2S1-09-16,3,4913192
M2S1-09-16,3,4931261
M2S1-09-16,3,4931264
M2S1-10-01,2,4903725
M2S1-10-01,2,4903726
M2S1-10-01,2,4903730
M2S1-10-01,2,4903731
M2S1-10-01,3,4903732
M2S1-10-01,3,4913275
M2S1-10-01,1,4913276
M2S1-10-01,2,4913277
M2S1-10-01,3,4913278
M2S1-10-01,3,4931333
M2S1-10-01,1,4931334
M2S1-10-01,3,4931335
M2S1-10-01,3,4931336
M2S1-10-01,2,4931341
M2S1-10-01,3,4931345
M2S1-10-01,3,4931346
M2S1-10-01,3,4931347
M2S1-10-02,2,4903727
M2S1-10-02,2,4903728
M2S1-10-02,3,4903729
M2S1-10-02,1,4903733
M2S1-10-02,3,4903734
M2S1-10-02,3,4903735
M2S1-10-02,3,4903736
M2S1-10-02,3,4913279
M2S1-10-02,2,4913280
M2S1-10-02,3,4913281
M2S1-10-02,3,4913282
M2S1-10-02,2,4931337
M2S1-10-02,1,4931338
M2S1-10-02,1,4931339
M2S1-10-02,3,4931340
M2S1-10-03,2,4931348
M2S1-10-03,3,4931349
M2S1-10-03,3,4931350
M2S1-10-03,5,4931351
M2S1-10-04,2,4903747
M2S1-10-04,2,4903748
M2S1-10-04,2,4903749
M2S1-10-04,2,4903750
M2S1-10-04,3,4903751
M2S1-10-04,3,4903753
M2S1-10-04,3,4913286
M2S1-10-04,1,4913287
M2S1-10-04,2,4913288
M2S1-10-04,2,4913289
M2S1-10-04,2,4913290
M2S1-10-04,2,4913291
M2S1-10-04,2,4913292
M2S1-10-04,3,4931352
M2S1-10-04,3,4931353
M2S1-10-04,3,4931354
M2S1-10-04,3,4931355
M2S1-10-04,5,4931356
M2S1-10-05,3,4903752
M2S1-10-05,3,4913293
M2S1-10-05,3,4913294
M2S1-10-05,3,4913295
M2S1-10-05,3,4931357
M2S1-10-05,3,4931358
M2S1-10-05,5,4931359
M2S1-10-06,3,4903744
M2S1-10-06,3,4903745
M2S1-10-06,5,4903746
M2S1-10-06,5,4913283
M2S1-10-06,3,4913284
M2S1-10-06,4,4913285
M2S1-10-06,3,4931360
M2S1-10-06,3,4931361
M2S1-10-06,3,4931362
M2S1-10-06,3,4931363
M2S1-10-06,5,4931364
M2S1-10-06,5,4931365
M2S1-10-07,2,4903754
M2S1-10-07,2,4903755
M2S1-10-07,5,4903756
M2S1-10-07,2,4913312
M2S1-10-07,2,4913313
M2S1-10-07,3,4913314
M2S1-10-07,3,4913315
M2S1-10-07,3,4931377
M2S1-10-07,3,4931378
M2S1-10-07,5,4931379
M2S1-10-08,2,4903760
M2S1-10-08,3,4903761
M2S1-10-08,3,4903762
M2S1-10-08,2,4913316
M2S1-10-08,3,4913317
M2S1-10-08,3,4913318
M2S1-10-08,3,4913319
M2S1-10-08,3,4931380
M2S1-10-08,1,4931381
M2S1-10-08,3,4931382
M2S1-10-08,3,4931383
M2S1-10-08,5,4931384
M2S1-10-09,3,4903763
M2S1-10-09,3,4903764
M2S1-10-09,3,4903765
M2S1-10-09,3,4903766
M2S1-10-09,3,4913320
M2S1-10-09,3,4913321
M2S1-10-09,3,4913322
M2S1-10-09,3,4913323
M2S1-10-09,3,4931385
M2S1-10-09,3,4931386
M2S1-10-09,3,4931387
M2S1-10-09,3,4931388
M2S1-10-09,3,4931389
M2S1-10-10,3,4913324
M2S1-10-10,3,4913325
M2S1-10-10,3,4913326
M2S1-10-10,4,4913327
M2S1-10-10,3,4931390
M2S1-10-10,3,4931392
M2S1-10-10,3,4931393
M2S1-10-10,5,4931395
M2S1-10-11,2,4903775
M2S1-10-11,2,4903776
M2S1-10-11,2,4903777
M2S1-10-11,2,4913328
M2S1-10-11,2,4913329
M2S1-10-11,2,4913330
M2S1-10-11,2,4913331
M2S1-10-11,2,4931397
M2S1-10-11,1,4931398
M2S1-10-11,1,4931399
M2S1-10-11,3,4931401
M2S1-10-12,3,4903770
M2S1-10-12,3,4903771
M2S1-10-12,3,4903772
M2S1-10-12,3,4913332
M2S1-10-12,3,4913333
M2S1-10-12,3,4913334
M2S1-10-12,3,4913335
M2S1-10-12,4,4913336
M2S1-10-12,3,4931366
M2S1-10-12,3,4931369
M2S1-10-12,5,4931371
M2S1-10-12,2,4931402
M2S1-10-12,1,4931403
M2S1-10-12,3,4931404
M2S1-10-12,3,4931405
M2S1-10-12,5,4931407
M2S1-10-12,5,4931408
M2S1-10-13,4,4913340
M2S1-10-13,4,4913341
M2S1-10-13,4,4913342
M2S1-10-13,3,4931372
M2S1-10-13,3,4931373
M2S1-10-13,5,4931376
M2S1-10-14,4,4903773
M2S1-10-14,4,4903774
M2S1-10-14,4,4913343
M2S1-10-14,4,4913344
M2S1-10-14,4,4913345
M2S1-10-14,4,4931409
M2S1-10-14,3,4931410
M2S1-10-14,5,4931411
M2S1-10-15,4,4903780
M2S1-10-15,4,4913339
M2S1-10-15,4,4931412
HSTA-01-01,3,4928847
HSTA-01-02,3,4921919
HSTA-01-03,3,4922065
HSTA-01-04,5,4928872
HSTA-01-04,5,4921927
HSTA-01-05,3,4922068
HSTA-01-06,3,4921934
HSTA-01-07,3,4921558
HSTA-01-08,3,4922073
HSTA-01-09,4,4921941
HSTA-01-11,3,4929070
HSTA-02-01,5,4929643
HSTA-02-02,5,4929650
HSTA-02-03,3,4921982
HSTA-02-04,3,4921592
HSTA-02-05,3,4921596
HSTA-02-06,4,4913641
HSTA-02-07,3,4929681
HSTA-02-07,3,4921612
HSTA-02-09,2,4913632
HSTA-02-09,3,4921998
HSTA-02-10,3,4921615
HSTA-03-01,1,4922023
HSTA-03-02,4,4922027
HSTA-03-03,3,4922030
HSTA-03-04,3,4922035
HSTA-03-05,3,4922038
HSTA-03-06,3,4921671
HSTA-03-07,2,4913737
HSTA-03-08,3,4929811
HSTA-03-08,3,4922152
HSTA-03-09,3,4922154
HSTA-03-11,3,4929822
HSTA-03-11,4,4922161
HSTA-03-12,2,4922097
HSTA-03-13,3,4929833
HSTA-03-13,1,4922167
HSTA-03-14,4,4913759
HSTA-03-15,5,4929848
HSTA-03-15,3,4922175
HSTA-04-01,3,4913826
HSTA-04-02,2,4913827
HSTA-04-03,3,4929911
HSTA-04-03,3,4921721
HSTA-04-04,3,4913836
HSTA-04-04,5,4922209
HSTA-04-05,3,4913843
HSTA-04-06,5,4929930
HSTA-04-07,3,4929933
HSTA-04-08,5,4929942
HSTA-04-09,3,4929946
H1S2-03-08,,2885858
H1S2-03-08,,2885859
H1S2-03-08,,2468994
H1S2-03-09,,2885863
H1S2-03-09,,2885864
H1S2-03-09,,2885865
H1S2-03-09,,2579427
H1S2-03-09,,2579435
H1S2-03-09,,2579841
H1S2-03-09,,2598170
H1S2-03-09,,2598167
H1S2-03-09,,2598164
H1S2-03-09,,2469515
H1S2-03-10,,2885866
H1S2-03-10,,2885867
H1S2-03-10,,2885868
H1S2-03-10,,2598525
H1S2-03-10,,2598195
H1S2-03-10,,2598191
H1S2-03-10,,2469513
H1S2-03-11,,2579888
H1S2-03-11,,2579890
H1S2-03-11,,2579895
H1S2-03-11,,2469512
H1S2-03-11,,2885869
H1S2-03-11,,2885870
H1S2-03-11,,2885871
H1S2-03-11,,2579847
H1S2-03-11,,2579858
H1S2-03-11,,2579871
H1S2-03-11,,2579881
H1S2-03-11,,2598189
H1S2-03-11,,2598188
H1S2-03-11,,2598538
H1S2-03-12,,2885872
H1S2-03-12,,2885873
H1S2-03-12,,2598534
H1S2-03-12,,2598533
H1S2-03-12,,2469523
H1S2-03-13,,2885874
H1S2-03-13,,2885875
H1S2-03-13,,2885876
H1S2-03-13,,2579916
H1S2-03-13,,2579917
H1S2-03-13,,2579919
H1S2-03-13,,2469540
H1S2-03-13,,2469538
H1S2-03-13,,2469537
H1S2-03-13,,2469535
H1S2-03-13,,2469546
H1S2-03-13,,2598529
H1S2-03-13,,2598553
H1S2-03-13,,2598551
H1S2-03-13,,2598549
H1S2-03-13,,2598562
H1S2-03-14,,2885877
H1S2-03-14,,2885878
H1S2-03-14,,2885882
H1S2-03-14,,2885883
H1S2-03-14,,2579949
H1S2-03-14,,2579954
H1S2-03-14,,2579958
H1S2-03-15,,2885879
H1S2-03-15,,2885880
H1S2-03-15,,2885881
H1S2-03-15,,2579938
H1S2-03-15,,2579942
H1S2-03-15,,2579945
H1S2-03-15,,2469551
H1S2-03-15,,2469571
H1S2-03-15,,2598569
H1S2-03-15,,2598567
H1S2-03-15,,2579900
H1S2-03-15,,2469526
H1S2-03-16,,2885884
H1S2-03-16,,2885885
H1S2-03-16,,2885886
H1S2-03-16,,2885887
H1S2-03-16,,2579927
H1S2-03-16,,2579931
H1S2-03-16,,2579933
H1S2-03-16,,2579935
H1S2-03-16,,2469542
H1S2-03-16,,2469562
H1S2-03-16,,2469559
H1S2-03-16,,2469555
H1S2-03-16,,2598558
H1S2-03-16,,2598556
H1S2-03-16,,2598571
H1S2-03-17,,2885888
H1S2-03-17,,2885889
H1S2-03-17,,2885890
H1S2-03-17,,2885891
H1S2-03-17,,2885891
H1S2-03-17,,2579962
H1S2-03-17,,2579967
H1S2-03-17,,2471384
H1S2-03-17,,2471392
H1S2-03-17,,2471388
H1S2-03-17,,2598581
H1S2-03-17,,2598580
H1S2-03-18,,2885892
H1S2-03-18,,2885893
H1S2-03-18,,2579971
H1S2-03-18,,2579977
H1S2-03-18,,2579985
H1S2-03-18,,2471402
H1S2-03-18,,2471396
H1S2-03-18,,2598587
H1S2-03-18,,2598585
H1S2-03-19,,2885894
H1S2-03-19,,2885895
H1S2-03-19,,2885896
H1S2-03-19,,2580015
H1S2-03-19,,2580023
H1S2-03-19,,2471416
H1S2-03-19,,2471412
H1S2-03-19,,2471832
H1S2-03-19,,2598584
H1S2-03-19,,2598594
H1S2-03-19,,2579992
H1S2-03-19,,2580002
H1S2-03-20,,2885897
H1S2-03-20,,2885898
H1S2-03-20,,2471830
H1S2-03-20,,2471826
H1S2-03-20,,2598592
H1S2-03-20,,2598591
H1S2-03-20,,2580007
H1S2-03-21,,2885900
H1S2-03-21,,2885901
H1S2-03-21,,2885902
H1S2-03-21,,2580077
H1S2-03-21,,2580083
H1S2-03-21,,2580090
H1S2-03-21,,2471844
H1S2-03-21,,2598589
H1S2-03-22,,2885903
H1S2-03-22,,2885904
H1S2-03-22,,2885905
H1S2-03-22,,2885906
H1S2-03-22,,2885907
H1S2-03-22,,2580056
H1S2-03-22,,2580059
H1S2-03-22,,2580067
H1S2-03-22,,2580070
H1S2-03-22,,2471842
H1S2-03-22,,2598601
H1S2-03-22,,2598600
H1S2-03-23,,2885908
H1S2-03-23,,2885909
H1S2-03-23,,2885910
H1S2-03-23,,2885911
H1S2-03-23,,2885912
H1S2-03-23,,2580029
H1S2-03-23,,2580036
H1S2-03-23,,2580041
H1S2-03-23,,2580047
H1S2-03-23,,2598599
H1S2-03-23,,2598598
H1S2-03-23,,2598596
H1S2-03-23,,2471845
H1S2-03-23,,2471838
H1S2-03-24,,2885913
H1S2-03-24,,2885914
H1S2-03-24,,2885915
H1S2-03-24,,2885916
H1S2-03-24,,2580096
H1S2-03-25,,2885917
H1S2-03-25,,2885918
H1S2-03-25,,2885919
H1S2-03-25,,2580120
H1S2-03-25,,2580125
H1S2-03-25,,2580129
H1S2-03-25,,2471863
H1S2-03-25,,2598603
H1S2-03-26,,2885920
H1S2-03-26,,2885921
H1S2-03-26,,2885922
H1S2-03-26,,2885923
H1S2-03-26,,2580101
H1S2-03-26,,2580110
H1S2-03-26,,2471857
H1S2-03-26,,2471855
H1S2-03-26,,2598609
H1S2-03-26,,2598606
H1S2-03-27,,2885924
H1S2-03-27,,2885925
H1S2-03-27,,2885926
H1S2-03-27,,2580114
H1S2-03-27,,2471851
H1S2-03-27,,2471849
H1S2-03-27,,2598608
H1S2-03-27,,2598605
H1S2-03-28,,2885927
H1S2-03-28,,2885928
H1S2-03-28,,2580107
H1S2-03-29,,2885929
H1S2-03-29,,2885930
H1S2-03-29,,2885931
H1S2-03-29,,2580132
H1S2-03-29,,2580136
H1S2-03-29,,2580139
H1S2-03-29,,2471861
H1S2-03-29,,2598610
H1S2-03-29,,2598934
H1S2-04-01,,2886024
H1S2-04-01,,2886025
H1S2-04-01,,2886026
H1S2-04-01,,2664479
H1S2-04-01,,2664487
H1S2-04-01,,2570501
H1S2-04-01,,2570510
H1S2-04-01,,2625077
H1S2-04-01,,2625144
H1S2-04-01,,2625141
H1S2-04-01,,2625150
H1S2-04-01,,2625265
H1S2-04-02,,2886027
H1S2-04-02,,2886028
H1S2-04-02,,2886029
H1S2-04-02,,2886030
H1S2-04-02,,2664495
H1S2-04-02,,2664498
H1S2-04-02,,2664506
H1S2-04-02,,2664512
H1S2-04-02,,2625130
H1S2-04-03,,2886031
H1S2-04-03,,2886032
H1S2-04-03,,2886033
H1S2-04-03,,2887617
H1S2-04-03,,2664519
H1S2-04-03,,2664526
H1S2-04-03,,2570499
H1S2-04-03,,2570508
H1S2-04-03,,2625133
H1S2-04-03,,2625128
H1S2-04-04,,2887618
H1S2-04-04,,2887619
H1S2-04-04,,2887620
H1S2-04-04,,2625126
H1S2-04-04,,2625182
H1S2-04-04,,2625178
H1S2-04-05,,2887621
H1S2-04-05,,2887622
H1S2-04-05,,2887623
H1S2-04-05,,2887624
H1S2-04-05,,2664530
H1S2-04-05,,2664535
H1S2-04-05,,2570503
H1S2-04-05,,2570514
H1S2-04-05,,2570512
H1S2-04-05,,2625173
H1S2-04-05,,2625160
H1S2-04-05,,2625155
H1S2-04-06,,2887625
H1S2-04-06,,2887626
H1S2-04-06,,2664539
H1S2-04-06,,2664543
H1S2-04-06,,2664544
H1S2-04-06,,2625242
H1S2-04-06,,2625284
H1S2-04-06,,2625283
H1S2-04-07,,2887627
H1S2-04-07,,2887628
H1S2-04-07,,2887629
H1S2-04-07,,2664550
H1S2-04-07,,2664553
H1S2-04-07,,2664555
H1S2-04-07,,2664559
H1S2-04-07,,2570539
H1S2-04-07,,2570534
H1S2-04-07,,2570532
H1S2-04-07,,2625272
H1S2-04-07,,2625299
H1S2-04-07,,2625295
H1S2-04-08,,2887630
H1S2-04-08,,2887631
H1S2-04-08,,2887632
H1S2-04-08,,2664561
H1S2-04-08,,2664827
H1S2-04-08,,2625281
H1S2-04-09,,2887633
H1S2-04-09,,2887634
H1S2-04-09,,2887635
H1S2-04-09,,2887636
H1S2-04-09,,2570551
H1S2-04-09,,2570549
H1S2-04-09,,2570546
H1S2-04-09,,2625294
H1S2-04-09,,2625292
H1S2-04-09,,2625286
H1S2-04-10,,2887637
H1S2-04-10,,2887638
H1S2-04-10,,2887639
H1S2-04-10,,2887640
H1S2-04-10,,2887641
H1S2-04-10,,2664831
H1S2-04-10,,2664832
H1S2-04-10,,2664836
H1S2-04-10,,2664839
H1S2-04-10,,2664866
H1S2-04-10,,2664868
H1S2-04-10,,2664870
H1S2-04-10,,2664872
H1S2-04-10,,2664879
H1S2-04-10,,2664882
H1S2-04-10,,2570653
H1S2-04-10,,2570651
H1S2-04-10,,2570677
H1S2-04-10,,2625692
H1S2-04-10,,2625691
H1S2-04-10,,2625687
H1S2-04-10,,2625720
H1S2-04-11,,2887642
H1S2-04-11,,2887643
H1S2-04-11,,2887644
H1S2-04-11,,2664841
H1S2-04-11,,2664845
H1S2-04-11,,2664847
H1S2-04-11,,2664861
H1S2-04-11,,2625729
H1S2-04-11,,2625727
H1S2-04-12,,2887645
H1S2-04-12,,2887646
H1S2-04-12,,2887647
H1S2-04-12,,2887648
H1S2-04-12,,2664863
H1S2-04-12,,2664865
H1S2-04-12,,2570686
H1S2-04-12,,2571042
H1S2-04-13,,2664896
H1S2-04-13,,2664900
H1S2-04-13,,2664901
H1S2-04-13,,2664903
H1S2-04-13,,2625742
H1S2-04-13,,2625741
H1S2-04-13,,2625740
H1S2-04-13,,2625738
H1S2-04-13,,2887649
H1S2-04-13,,2887652
H1S2-04-13,,2570682
H1S2-04-13,,2570690
H1S2-04-13,,2571051
H1S2-04-13,,2625733
H1S2-04-13,,2625734
H1S2-04-14,,2887653
H1S2-04-14,,2887654
H1S2-04-14,,2887655
H1S2-04-14,,2887656
H1S2-04-14,,2664885
H1S2-04-14,,2664889
H1S2-04-14,,2664891
H1S2-04-14,,2664894
H1S2-04-14,,2570675
H1S2-04-14,,2570671
H1S2-04-14,,2570688
H1S2-04-14,,2625718
H1S2-04-14,,2625716
H1S2-04-14,,2625714
H1S2-04-14,,2625710
H1S2-04-15,,2887657
H1S2-04-15,,2887658
H1S2-04-15,,2664905
H1S2-04-15,,2664911
H1S2-04-15,,2664913
H1S2-04-15,,2571050
H1S2-04-15,,2571047
H1S2-04-15,,2625746
H1S2-04-15,,2625744
H1S2-04-15,,2625758
H1S2-04-16,,2887659
H1S2-04-16,,2887660
H1S2-04-16,,2887661
H1S2-04-16,,2887663
H1S2-04-16,,2664915
H1S2-04-16,,2664920
H1S2-04-16,,2664922
H1S2-04-16,,2664925
H1S2-04-16,,2573503
H1S2-04-16,,2573502
H1S2-04-16,,2573522
H1S2-04-16,,2573520
H1S2-04-16,,2625757
H1S2-04-16,,2625755
H1S2-04-16,,2625762
H1S2-04-17,,2887664
H1S2-04-17,,2887665
H1S2-04-17,,2887683
H1S2-04-17,,2887687
H1S2-04-17,,2664941
H1S2-04-17,,2664947
H1S2-04-17,,2665294
H1S2-04-17,,2665298
H1S2-04-17,,2625761
H1S2-04-17,,2625760
H1S2-04-17,,2625772
H1S2-04-18,,2887688
H1S2-04-18,,2887690
H1S2-04-18,,2887713
H1S2-04-18,,2887714
H1S2-04-18,,2665300
H1S2-04-18,,2665305
H1S2-04-18,,2665309
H1S2-04-18,,2665312
H1S2-04-18,,2625770
H1S2-04-18,,2625768
H1S2-04-18,,2625766
H1S2-04-19,,2664929
H1S2-04-19,,2664932
H1S2-04-19,,2664936
H1S2-04-19,,2664939
H1S2-04-19,,2887719
H1S2-04-19,,2887720
H1S2-04-20,,2887715
H1S2-04-20,,2887716
H1S2-04-20,,2887717
H1S2-04-20,,2887718
H1S2-04-20,,2887723
H1S2-04-20,,2887724
H1S2-04-20,,2887725
H1S2-04-20,,2887726
H1S2-04-20,,2887727
H1S2-04-20,,2665314
H1S2-04-20,,2665316
H1S2-04-20,,2665318
H1S2-04-20,,2665320
H1S2-04-20,,2573519
H1S2-04-20,,2573518
H1S2-04-20,,2573527
H1S2-04-20,,2573524
H1S2-04-20,,2573537
H1S2-04-20,,2625781
H1S2-04-20,,2625779
H1S2-04-20,,2625778
H1S2-04-20,,2625788
H1S2-04-21,,2887728
H1S2-04-21,,2887729
H1S2-04-21,,2665330
H1S2-04-21,,2665333
H1S2-04-21,,2665335
H1S2-04-21,,2573541
H1S2-04-21,,2573560
H1S2-04-21,,2625795
H1S2-04-21,,2625794
H1S2-04-22,,2887733
H1S2-04-22,,2887734
H1S2-04-22,,2887735
H1S2-04-22,,2887736
H1S2-04-22,,2665322
H1S2-04-22,,2665324
H1S2-04-22,,2665326
H1S2-04-22,,2665328
H1S2-04-22,,2573528
H1S2-04-22,,2573545
H1S2-04-22,,2573543
H1S2-04-22,,2625786
H1S2-04-22,,2625783
H1S2-04-22,,2625801
H1S2-04-23,,2887737
H1S2-04-23,,2887738
H1S2-04-23,,2887740
H1S2-04-23,,2887741
H1S2-04-23,,2887744
H1S2-04-23,,2887746
H1S2-04-23,,2887750
H1S2-04-24,,2887752
H1S2-04-24,,2887753
H1S2-04-24,,2887754
H1S2-04-24,,2887743
H1S2-05-01,,2888214
H1S2-05-01,,2888215
H1S2-05-01,,2888216
H1S2-05-01,,2888217
H1S2-05-01,,2888218
H1S2-05-01,,2888219
H1S2-05-01,,2670542
H1S2-05-01,,2670544
H1S2-05-01,,2670546
H1S2-05-01,,2670548
H1S2-05-01,,2573898
H1S2-05-01,,2573894
H1S2-05-01,,2573892
H1S2-05-01,,2573888
H1S2-05-01,,2628906
H1S2-05-01,,2628557
H1S2-05-01,,2628555
H1S2-05-01,,2628553
H1S2-05-02,,2888220
H1S2-05-02,,2888221
H1S2-05-02,,2888222
H1S2-05-02,,2888223
H1S2-05-02,,2670550
H1S2-05-02,,2670551
H1S2-05-02,,2670553
H1S2-05-03,,2888224
H1S2-05-03,,2888225
H1S2-05-03,,2670555
H1S2-05-03,,2670557
H1S2-05-03,,2670558
H1S2-05-03,,2628913
H1S2-05-03,,2628911
H1S2-05-03,,2628910
H1S2-05-03,,2573916
H1S2-05-04,,2888226
H1S2-05-04,,2888227
H1S2-05-04,,2888228
H1S2-05-04,,2888229
H1S2-05-04,,2670560
H1S2-05-04,,2670562
H1S2-05-04,,2670564
H1S2-05-04,,2670565
H1S2-05-04,,2573911
H1S2-05-04,,2573934
H1S2-05-04,,2628921
H1S2-05-05,,2888230
H1S2-05-05,,2888231
H1S2-05-05,,2888232
H1S2-05-05,,2888233
H1S2-05-05,,2670567
H1S2-05-05,,2670569
H1S2-05-05,,2670573
H1S2-05-05,,2573913
H1S2-05-05,,2628922
H1S2-05-05,,2628924
H1S2-05-06,,2888234
H1S2-05-06,,2888235
H1S2-05-06,,2670571
H1S2-05-07,,2888236
H1S2-05-07,,2888237
H1S2-05-07,,2888238
H1S2-05-07,,2670574
H1S2-05-07,,2670575
H1S2-05-07,,2670576
H1S2-05-07,,2628919
H1S2-05-08,,2888240
H1S2-05-08,,2888241
H1S2-05-08,,2888242
H1S2-05-08,,2670580
H1S2-05-08,,2628917
H1S2-05-08,,2628933
H1S2-05-09,,2888249
H1S2-05-09,,2888250
H1S2-05-09,,2888252
H1S2-05-09,,2670578
H1S2-05-10,,2888246
H1S2-05-10,,2888247
H1S2-05-10,,2888248
H1S2-05-10,,2670582
H1S2-05-10,,2670584
H1S2-05-10,,2573929
H1S2-05-10,,2573977
H1S2-05-10,,2628931
H1S2-05-10,,2628929
H1S2-05-11,,2888253
H1S2-05-11,,2888254
H1S2-05-11,,2888255
H1S2-05-11,,2573927
H1S2-05-11,,2628928
H1S2-05-12,,2888243
H1S2-05-12,,2888244
H1S2-05-12,,2888245
H1S2-05-12,,2888256
H1S2-05-12,,2888257
H1S2-05-12,,2888258
H1S2-05-13,,2888259
H1S2-05-13,,2888260
H1S2-05-13,,2670926
H1S2-05-13,,2670927
H1S2-05-13,,2670929
H1S2-05-13,,2577160
H1S2-05-13,,2628954
H1S2-05-14,,2888261
H1S2-05-14,,2888262
H1S2-05-14,,2888263
H1S2-05-14,,2670921
H1S2-05-14,,2670923
H1S2-05-14,,2670924
H1S2-05-14,,2577107
H1S2-05-14,,2577105
H1S2-05-14,,2577122
H1S2-05-14,,2577118
H1S2-05-14,,2577116
H1S2-05-14,,2577129
H1S2-05-14,,2577127
H1S2-05-14,,2628936
H1S2-05-14,,2628950
H1S2-05-14,,2628949
H1S2-05-14,,2628926
H1S2-05-15,,2888264
H1S2-05-15,,2888265
H1S2-05-15,,2888266
H1S2-05-15,,2670934
H1S2-05-15,,2670936
H1S2-05-15,,2670938
H1S2-05-15,,2577143
H1S2-05-15,,2628956
H1S2-05-16,,2888267
H1S2-05-16,,2888268
H1S2-05-16,,2888269
H1S2-05-16,,2888270
H1S2-05-16,,2670940
H1S2-05-16,,2670942
H1S2-05-16,,2670943
H1S2-05-16,,2670945
H1S2-05-16,,2628947
H1S2-05-16,,2628945
H1S2-05-16,,2628943
H1S2-05-16,,2628959
H1S2-05-17,,2888271
H1S2-05-17,,2888272
H1S2-05-17,,2670930
H1S2-05-17,,2670931
H1S2-05-17,,2670933
H1S2-05-17,,2628942
H1S2-05-18,,2888273
H1S2-05-18,,2888274
H1S2-05-18,,2888275
H1S2-05-18,,2670947
H1S2-05-18,,2670949
H1S2-05-18,,2670950
H1S2-05-18,,2577145
H1S2-05-18,,2628958
H1S2-05-19,,2888280
H1S2-05-19,,2888281
H1S2-05-19,,2888282
H1S2-05-19,,2670952
H1S2-05-19,,2670961
H1S2-05-19,,2670967
H1S2-05-19,,2628940
H1S2-05-19,,2628939
H1S2-05-19,,2628938
H1S2-05-20,,2888276
H1S2-05-20,,2888277
H1S2-05-20,,2888278
H1S2-05-20,,2670973
H1S2-05-20,,2670978
H1S2-05-20,,2628952
H1S2-05-20,,2628966
H1S2-05-21,,2888283
H1S2-05-21,,2888284
H1S2-05-21,,2888285
H1S2-05-21,,2888286
H1S2-05-21,,2671013
H1S2-05-21,,2671015
H1S2-05-21,,2671017
H1S2-05-21,,2671019
H1S2-05-21,,2579425
H1S2-05-21,,2579829
H1S2-05-21,,2579825
H1S2-05-21,,2628979
H1S2-05-21,,2628977
H1S2-05-21,,2628975
H1S2-05-22,,2671022
H1S2-05-22,,2671024
H1S2-05-22,,2671027
H1S2-05-23,,2888287
H1S2-05-23,,2888288
H1S2-05-23,,2888289
H1S2-05-23,,2888290
H1S2-05-23,,2670982
H1S2-05-23,,2670986
H1S2-05-23,,2670990
H1S2-05-23,,2670994
H1S2-05-23,,2577154
H1S2-05-23,,2577174
H1S2-05-23,,2577173
H1S2-05-23,,2628965
H1S2-05-23,,2628963
H1S2-05-23,,2628961
H1S2-05-23,,2628973
H1S2-05-24,,2888291
H1S2-05-24,,2888292
H1S2-05-24,,2888293
H1S2-05-24,,2888294
H1S2-05-24,,2670998
H1S2-05-24,,2671000
H1S2-05-24,,2671002
H1S2-05-24,,2628972
H1S2-05-24,,2628970
H1S2-05-24,,2628968
H1S2-05-24,,2628980
H1S2-05-24,,2577167
H1S2-05-24,,2579819
H1S2-05-25,,2888295
H1S2-05-25,,2888296
H1S2-05-25,,2888297
H1S2-05-25,,2671004
H1S2-05-25,,2671007
H1S2-05-25,,2671009
H1S2-05-25,,2671011
H1S2-05-25,,2579433
H1S2-06-01,,2888360
H1S2-06-01,,2888361
H1S2-06-01,,2676728
H1S2-06-02,,2888362
H1S2-06-02,,2888363
H1S2-06-02,,2888364
H1S2-06-02,,2888365
H1S2-06-02,,2888366
H1S2-06-02,,2888367
H1S2-06-03,,2888368
H1S2-06-03,,2888369
H1S2-06-03,,2888370
H1S2-06-03,,2888371
H1S2-06-03,,2629368
H1S2-06-03,,2629366
H1S2-06-03,,2629364
H1S2-06-03,,2629362
H1S2-06-03,,2676730
H1S2-06-03,,2676732
H1S2-06-03,,2676734
H1S2-06-03,,2579984
H1S2-06-03,,2579979
H1S2-06-04,,2888372
H1S2-06-04,,2888373
H1S2-06-04,,2888374
H1S2-06-04,,2888378
H1S2-06-04,,2888379
H1S2-06-04,,2888380
H1S2-06-04,,2629361
H1S2-06-04,,2629380
H1S2-06-04,,2629378
H1S2-06-04,,2629376
H1S2-06-04,,2676735
H1S2-06-04,,2676737
H1S2-06-04,,2676741
H1S2-06-04,,2579991
H1S2-06-05,,2888375
H1S2-06-05,,2888376
H1S2-06-05,,2888377
H1S2-06-05,,2676739
H1S2-06-05,,2579989
H1S2-06-06,,2888381
H1S2-06-06,,2888382
H1S2-06-06,,2888383
H1S2-06-06,,2888384
H1S2-06-06,,2676743
H1S2-06-06,,2676744
H1S2-06-06,,2676746
H1S2-06-06,,2676748
H1S2-06-06,,2629375
H1S2-06-06,,2629373
H1S2-06-06,,2629387
H1S2-06-07,,2888385
H1S2-06-07,,2888386
H1S2-06-07,,2888387
H1S2-06-07,,2677092
H1S2-06-07,,2677094
H1S2-06-07,,2677096
H1S2-06-07,,2582414
H1S2-06-07,,2582417
H1S2-06-07,,2582428
H1S2-06-07,,2582424
H1S2-06-07,,2582435
H1S2-06-07,,2582434
H1S2-06-07,,2582432
H1S2-06-07,,2582430
H1S2-06-07,,2582450
H1S2-06-07,,2629392
H1S2-06-07,,2629390
H1S2-06-07,,2629389
H1S2-06-07,,2629404
H1S2-06-07,,2629403
H1S2-06-07,,2629385
H1S2-06-08,,2888388
H1S2-06-08,,2888389
H1S2-06-08,,2888390
H1S2-06-08,,2888391
H1S2-06-08,,2677097
H1S2-06-08,,2677099
H1S2-06-08,,2677101
H1S2-06-08,,2629383
H1S2-06-09,,2888392
H1S2-06-09,,2888393
H1S2-06-09,,2888394
H1S2-06-09,,2677104
H1S2-06-09,,2677108
H1S2-06-09,,2677110
H1S2-06-09,,2677111
H1S2-06-09,,2582448
H1S2-06-09,,2582445
H1S2-06-09,,2582468
H1S2-06-09,,2629401
H1S2-06-09,,2629399
H1S2-06-09,,2629808
H1S2-06-10,,2888395
H1S2-06-10,,2888396
H1S2-06-10,,2677113
H1S2-06-10,,2677115
H1S2-06-10,,2677117
H1S2-06-10,,2629806
H1S2-06-10,,2629804
H1S2-06-11,,2888397
H1S2-06-11,,2888398
H1S2-06-11,,2888399
H1S2-06-11,,2888400
H1S2-06-11,,2677119
H1S2-06-11,,2677120
H1S2-06-11,,2677122
H1S2-06-11,,2677124
H1S2-06-11,,2629382
H1S2-06-11,,2629397
H1S2-06-11,,2629396
H1S2-06-11,,2629394
H1S2-06-12,,2888401
H1S2-06-12,,2888402
H1S2-06-12,,2888403
H1S2-06-12,,2888404
H1S2-06-12,,2888405
H1S2-06-12,,2677140
H1S2-06-12,,2677142
H1S2-06-12,,2677144
H1S2-06-12,,2677145
H1S2-06-12,,2629837
H1S2-06-12,,2629834
H1S2-06-12,,2629832
H1S2-06-12,,2629829
H1S2-06-12,,2582938
H1S2-06-13,,2888406
H1S2-06-13,,2888407
H1S2-06-13,,2888409
H1S2-06-13,,2888410
H1S2-06-13,,2677126
H1S2-06-13,,2677128
H1S2-06-13,,2677129
H1S2-06-13,,2677131
H1S2-06-13,,2582457
H1S2-06-13,,2582477
H1S2-06-13,,2582565
H1S2-06-13,,2629802
H1S2-06-13,,2629801
H1S2-06-13,,2629821
H1S2-06-13,,2629820
H1S2-06-13,,2629817
H1S2-06-13,,2629816
H1S2-06-13,,2629814
H1S2-06-13,,2582465
H1S2-06-13,,2582461
H1S2-06-14,,2888411
H1S2-06-14,,2888412
H1S2-06-14,,2888413
H1S2-06-14,,2888414
H1S2-06-14,,2677133
H1S2-06-14,,2677135
H1S2-06-14,,2677137
H1S2-06-14,,2677138
H1S2-06-14,,2582463
H1S2-06-15,,2677149
H1S2-06-15,,2677151
H1S2-07-01,,2888470
H1S2-07-01,,2888471
H1S2-07-01,,2888472
H1S2-07-01,,2693783
H1S2-07-01,,2693785
H1S2-07-01,,2693786
H1S2-07-01,,2584184
H1S2-07-01,,2584183
H1S2-07-01,,2584206
H1S2-07-01,,2629921
H1S2-07-01,,2629916
H1S2-07-01,,2629914
H1S2-07-01,,2629911
H1S2-07-02,,2888477
H1S2-07-02,,2888478
H1S2-07-02,,2888479
H1S2-07-02,,2693788
H1S2-07-02,,2693790
H1S2-07-02,,2693791
H1S2-07-02,,2693793
H1S2-07-02,,2584204
H1S2-07-02,,2584203
H1S2-07-02,,2584200
H1S2-07-02,,2584198
H1S2-07-02,,2584195
H1S2-07-02,,2629909
H1S2-07-02,,2629907
H1S2-07-02,,2630278
H1S2-07-02,,2630277
H1S2-07-02,,2630275
H1S2-07-03,,2888473
H1S2-07-03,,2888474
H1S2-07-03,,2888475
H1S2-07-03,,2888476
H1S2-07-03,,2693810
H1S2-07-03,,2693812
H1S2-07-03,,2693814
H1S2-07-03,,2693815
H1S2-07-03,,2584211
H1S2-07-03,,2584209
H1S2-07-03,,2584222
H1S2-07-03,,2630292
H1S2-07-03,,2630290
H1S2-07-03,,2630287
H1S2-07-03,,2630309
H1S2-07-04,,2888480
H1S2-07-04,,2888481
H1S2-07-04,,2888482
H1S2-07-04,,2693801
H1S2-07-04,,2693805
H1S2-07-04,,2629939
H1S2-07-04,,2629936
H1S2-07-04,,2629934
H1S2-07-04,,2630295
H1S2-07-05,,2888483
H1S2-07-05,,2888484
H1S2-07-05,,2888486
H1S2-07-05,,2584220
H1S2-07-05,,2584230
H1S2-07-05,,2630306
H1S2-07-05,,2630304
H1S2-07-05,,2630303
H1S2-07-06,,2888487
H1S2-07-06,,2888488
H1S2-07-06,,2888489
H1S2-07-06,,2693806
H1S2-07-06,,2693808
H1S2-07-06,,2630337
H1S2-07-06,,2630334
H1S2-07-06,,2630361
H1S2-07-06,,2584254
H1S2-07-07,,2888490
H1S2-07-07,,2888491
H1S2-07-07,,2888492
H1S2-07-07,,2693794
H1S2-07-07,,2693796
H1S2-07-07,,2693798
H1S2-07-07,,2693799
H1S2-07-07,,2584228
H1S2-07-07,,2584226
H1S2-07-07,,2584223
H1S2-07-07,,2630327
H1S2-07-07,,2630323
H1S2-07-07,,2630322
H1S2-07-08,,2888493
H1S2-07-08,,2888494
H1S2-07-08,,2888495
H1S2-07-08,,2888496
H1S2-07-08,,2693816
H1S2-07-08,,2693818
H1S2-07-08,,2693820
H1S2-07-08,,2584240
H1S2-07-08,,2584236
H1S2-07-08,,2630320
H1S2-07-08,,2630315
H1S2-07-08,,2630341
H1S2-07-09,,2693823
H1S2-07-09,,2693830
H1S2-07-10,,2888497
H1S2-07-10,,2888498
H1S2-07-10,,2888499
H1S2-07-10,,2888500
H1S2-07-10,,2888501
H1S2-07-10,,2888502
H1S2-07-10,,2888503
H1S2-07-10,,2693832
H1S2-07-10,,2693834
H1S2-07-10,,2693835
H1S2-07-10,,2693837
H1S2-07-10,,2584769
H1S2-07-10,,2584764
H1S2-07-10,,2584792
H1S2-07-10,,2584786
H1S2-07-10,,2635438
H1S2-07-10,,2635432
H1S2-07-10,,2635427
H1S2-07-10,,2635472
H1S2-07-10,,2635466
H1S2-07-10,,2635464
H1S2-07-10,,2635461
H1S2-07-10,,2635459
H1S2-07-10,,2584806
H1S2-07-10,,2584873
H1S2-07-11,,2888504
H1S2-07-11,,2888505
H1S2-07-11,,2888506
H1S2-07-11,,2888507
H1S2-07-11,,2693839
H1S2-07-11,,2694175
H1S2-07-11,,2694177
H1S2-07-11,,2694178
H1S2-07-11,,2635458
H1S2-07-11,,2635454
H1S2-07-11,,2635492
H1S2-07-11,,2635490
H1S2-07-12,,2694180
H1S2-07-12,,2694182
H1S2-07-12,,2694184
H1S2-07-12,,2694185
H1S2-07-12,,2635487
H1S2-07-12,,2635483
H1S2-07-12,,2635479
H1S2-07-12,,2635513
H1S2-07-12,,2888508
H1S2-07-12,,2888512
H1S2-07-13,,2888513
H1S2-07-13,,2888514
H1S2-07-13,,2888515
H1S2-07-13,,2694195
H1S2-07-13,,2694196
H1S2-07-13,,2694197
H1S2-07-13,,2694199
H1S2-07-13,,2635077
H1S2-07-13,,2635075
H1S2-07-13,,2635447
H1S2-07-13,,2635441
H1S2-07-14,,2888516
H1S2-07-14,,2888517
H1S2-07-14,,2888518
H1S2-07-14,,2888519
H1S2-07-14,,2694201
H1S2-07-14,,2694203
H1S2-07-14,,2694204
H1S2-07-14,,2694206
H1S2-07-14,,2584903
H1S2-07-14,,2584895
H1S2-07-14,,2584890
H1S2-07-14,,2635512
H1S2-07-14,,2635510
H1S2-07-14,,2635508
H1S2-07-14,,2635503
H1S2-07-15,,2888520
H1S2-07-15,,2888521
H1S2-07-15,,2888522
H1S2-07-15,,2888523
H1S2-07-15,,2888524
H1S2-07-15,,2694208
H1S2-07-15,,2694209
H1S2-07-15,,2694211
H1S2-07-15,,2694539
H1S2-07-15,,2584678
H1S2-07-15,,2584675
H1S2-07-15,,2584674
H1S2-07-15,,2584670
H1S2-07-15,,2584724
H1S2-07-15,,2584720
H1S2-07-15,,2584718
H1S2-07-15,,2635088
H1S2-07-15,,2635086
H1S2-07-15,,2635081
H1S2-07-15,,2635079
H1S2-07-15,,2693827
H1S2-07-15,,2693829
H1S2-07-15,,2595644
H1S2-07-15,,2595642
H1S2-07-15,,2595640
H1S2-07-15,,2595635
H1S2-07-15,,2635501
H1S2-07-15,,2635526
H1S2-07-16,,2888525
H1S2-07-16,,2888526
H1S2-07-16,,2888527
H1S2-07-16,,2888528
H1S2-07-16,,2595637
H1S2-07-16,,2595661
H1S2-07-16,,2595659
H1S2-07-17,,2888529
H1S2-07-17,,2888530
H1S2-07-17,,2888531
H1S2-07-17,,2888532
H1S2-07-17,,2888533
H1S2-07-17,,2694541
H1S2-07-17,,2694551
H1S2-07-17,,2694555
H1S2-07-17,,2694559
H1S2-07-17,,2635524
H1S2-07-17,,2635527
H1S2-07-18,,2888534
H1S2-07-18,,2888535
H1S2-07-18,,2888536
H1S2-07-18,,2888537
H1S2-07-18,,2888538
H1S2-07-18,,2888539
H1S2-07-18,,2694560
H1S2-07-18,,2694562
H1S2-07-18,,2694564
H1S2-07-18,,2635522
H1S2-07-18,,2635520
H1S2-07-18,,2635519
H1S2-07-18,,2635517
H1S2-07-18,,2595672
H1S2-07-18,,2595666
H1S2-07-18,,2596007
H1S2-07-19,,2694565
H1S2-07-19,,2694567
H1S2-07-19,,2694569
H1S2-07-19,,2694571
H1S2-07-19,,2635515
H1S2-07-19,,2635539
H1S2-07-19,,2635537
H1S2-07-19,,2635536
H1S2-07-19,,2888540
H1S2-07-19,,2888543
H1S2-07-19,,2888544
H1S2-07-20,,2888545
H1S2-07-20,,2888546
H1S2-07-20,,2888547
H1S2-07-20,,2694573
H1S2-07-20,,2694574
H1S2-07-20,,2694576
H1S2-07-20,,2694578
H1S2-07-20,,2635532
H1S2-07-20,,2635531
H1S2-07-20,,2635529
H1S2-07-20,,2635554
H1S2-07-21,,2888548
H1S2-07-21,,2888549
H1S2-07-21,,2888550
H1S2-07-21,,2694617
H1S2-07-21,,2694620
H1S2-07-21,,2694622
H1S2-07-22,,2888551
H1S2-07-22,,2888552
H1S2-07-22,,2888553
H1S2-07-22,,2888554
H1S2-07-22,,2888555
H1S2-07-22,,2888556
H1S2-07-22,,2694580
H1S2-07-22,,2694581
H1S2-07-22,,2694583
H1S2-07-22,,2694585
H1S2-07-22,,2635552
H1S2-07-22,,2635550
H1S2-07-22,,2635549
H1S2-07-22,,2635547
H1S2-07-22,,2596019
H1S2-07-23,,2888557
H1S2-07-23,,2888558
H1S2-07-23,,2888559
H1S2-07-23,,2888560
H1S2-07-23,,2888561
H1S2-07-23,,2694587
H1S2-07-23,,2694588
H1S2-07-23,,2694590
H1S2-07-23,,2694592
H1S2-07-23,,2693839
H1S2-07-23,,2596006
H1S2-07-23,,2596004
H1S2-07-23,,2596012
H1S2-07-23,,2635545
H1S2-07-23,,2635543
H1S2-07-24,,2635568
H1S2-07-24,,2635565
H1S2-07-24,,2635561
H1S2-07-24,,2694596
H1S2-07-24,,2694599
H1S2-07-24,,2596017
H1S2-07-24,,2635566
H1S2-07-24,,2635559
H1S2-07-24,,2635563
H1S2-07-25,,2888566
H1S2-07-25,,2888567
H1S2-07-25,,2888568
H1S2-07-25,,2694603
H1S2-07-25,,2694606
H1S2-07-25,,2694608
H1S2-07-26,,2888569
H1S2-07-26,,2888570
H1S2-07-26,,2888571
H1S2-07-26,,2888572
H1S2-07-26,,2694610
H1S2-07-26,,2694611
H1S2-07-26,,2694613
H1S2-07-26,,2694615
H1S2-07-27,,2888573
H1S2-07-27,,2888574
H1S2-07-27,,2888575
H1S2-07-27,,2694624
H1S2-07-27,,2694626
H1S2-07-27,,2694629
HSU2-01-01,,4925320
HSU2-01-01,,4925321
HSU2-01-01,,4925322
HSU2-01-01,,4925323
HSU2-01-01,,4925324
HSU2-01-01,,3070728
HSU2-01-01,,3070729
HSU2-01-01,,3070730
HSU2-01-01,,3070731
HSU2-01-01,,2849898
HSU2-01-01,,2849899
HSU2-01-01,,2849900
HSU2-01-01,,2851318
HSU2-01-01,,2851319
HSU2-01-01,,2851320
HSU2-01-01,,2851321
HSU2-01-01,,2851324
HSU2-01-01,,2851325
HSU2-01-02,,4925325
HSU2-01-02,,4925326
HSU2-01-02,,4925327
HSU2-01-02,,4925328
HSU2-01-02,,3070732
HSU2-01-02,,3070733
HSU2-01-02,,3070734
HSU2-01-02,,3070739
HSU2-01-02,,2822622
HSU2-01-02,,2822623
HSU2-01-02,,2822624
HSU2-01-02,,2822625
HSU2-01-02,,2849873
HSU2-01-02,,2849874
HSU2-01-02,,2849875
HSU2-01-02,,2849876
HSU2-01-02,,2822647
HSU2-01-02,,2822649
HSU2-01-02,,2822650
HSU2-01-02,,2822651
HSU2-01-02,,2849877
HSU2-01-02,,2849878
HSU2-01-02,,2849879
HSU2-01-02,,2849880
HSU2-01-02,,2851317
HSU2-01-02,,2851322
HSU2-01-02,,2851323
HSU2-01-02,,2851326
HSU2-01-02,,2851327
HSU2-01-03,,4925333
HSU2-01-03,,4925334
HSU2-01-03,,4925335
HSU2-01-03,,4925336
HSU2-01-03,,3070740
HSU2-01-03,,3070741
HSU2-01-03,,2851331
HSU2-01-03,,2851332
HSU2-01-03,,2851333
HSU2-01-04,,4925337
HSU2-01-04,,4925338
HSU2-01-04,,4925339
HSU2-01-04,,4925340
HSU2-01-04,,4925341
HSU2-01-04,,4925342
HSU2-01-04,,2822691
HSU2-01-04,,2849905
HSU2-01-04,,2849906
HSU2-01-04,,2849907
HSU2-01-04,,3070742
HSU2-01-04,,3070743
HSU2-01-04,,3070744
HSU2-01-04,,3070745
HSU2-01-04,,3070746
HSU2-01-04,,3070747
HSU2-01-04,,3070748
HSU2-01-04,,2851334
HSU2-01-04,,2851335
HSU2-01-04,,2851336
HSU2-01-04,,2851337
HSU2-01-04,,2851340
HSU2-01-05,,4925349
HSU2-01-05,,4925350
HSU2-01-05,,3070749
HSU2-01-05,,2851341
HSU2-01-06,,4925351
HSU2-01-06,,4925352
HSU2-01-06,,4925353
HSU2-01-06,,4925354
HSU2-01-06,,4925355
HSU2-01-06,,3070750
HSU2-01-06,,3070751
HSU2-01-06,,3070752
HSU2-01-06,,3070753
HSU2-01-06,,2822791
HSU2-01-06,,2849908
HSU2-01-06,,2851342
HSU2-01-06,,2851344
HSU2-01-06,,2851345
HSU2-01-07,,4925356
HSU2-01-07,,4925357
HSU2-01-07,,4925358
HSU2-01-07,,4925359
HSU2-01-07,,3070754
HSU2-01-07,,3070755
HSU2-01-07,,3070756
HSU2-01-07,,2822794
HSU2-01-07,,2822798
HSU2-01-07,,2849909
HSU2-01-07,,2849910
HSU2-01-07,,2851343
HSU2-01-08,,4925360
HSU2-01-08,,4925361
HSU2-01-08,,4925362
HSU2-01-08,,4925363
HSU2-01-08,,4925370
HSU2-01-08,,3070757
HSU2-01-08,,3070758
HSU2-01-08,,3070759
HSU2-01-08,,3070760
HSU2-01-08,,2822800
HSU2-01-08,,2822801
HSU2-01-08,,2822802
HSU2-01-08,,2822803
HSU2-01-08,,2849911
HSU2-01-08,,2849912
HSU2-01-08,,2849913
HSU2-01-08,,2849914
HSU2-01-08,,2851346
HSU2-01-08,,2851347
HSU2-01-08,,2851348
HSU2-01-09,,2822809
HSU2-01-09,,2822813
HSU2-01-09,,2849915
HSU2-01-09,,2849916
HSU2-01-09,,2849917
HSU2-01-09,,2851349
HSU2-01-09,,2851350
HSU2-01-09,,2851351
HSU2-01-09,,2851352
HSU2-01-09,,4925372
HSU2-01-09,,4925373
HSU2-01-09,,4925375
HSU2-01-09,,3070761
HSU2-01-09,,3070762
HSU2-01-09,,3070765
HSU2-01-10,,2822830
HSU2-01-10,,2822831
HSU2-01-10,,2849918
HSU2-01-10,,2849919
HSU2-01-10,,2849920
HSU2-01-10,,4925378
HSU2-01-10,,4925380
HSU2-01-10,,4925381
HSU2-01-10,,3070763
HSU2-01-10,,3070764
HSU2-01-10,,2851353
HSU2-01-10,,2851354
HSU2-01-10,,2851356
HSU2-01-11,,4925383
HSU2-01-11,,4925385
HSU2-01-11,,4925386
HSU2-01-11,,4925387
HSU2-01-11,,4925393
HSU2-01-11,,3070766
HSU2-01-11,,3070769
HSU2-01-11,,3070770
HSU2-01-11,,3070773
HSU2-01-11,,2822856
HSU2-01-11,,2849921
HSU2-01-11,,2851357
HSU2-01-11,,2851361
HSU2-01-11,,2851363
HSU2-01-11,,2851366
HSU2-01-12,,4925395
HSU2-01-12,,4925396
HSU2-01-12,,4925397
HSU2-01-12,,3070767
HSU2-01-12,,3070768
HSU2-01-12,,3070771
HSU2-01-12,,3070772
HSU2-01-12,,2822918
HSU2-01-12,,2849922
HSU2-01-12,,2849923
HSU2-01-12,,2851358
HSU2-01-12,,2851359
HSU2-01-12,,2851368
HSU2-01-13,,4925398
HSU2-01-13,,4925399
HSU2-01-13,,4925400
HSU2-01-13,,4925401
HSU2-01-13,,4925402
HSU2-01-13,,4925403
HSU2-01-13,,3070780
HSU2-01-13,,3070781
HSU2-01-13,,3070782
HSU2-01-13,,3070783
HSU2-01-13,,2822940
HSU2-01-13,,2849924
HSU2-01-13,,2849926
HSU2-01-13,,2851370
HSU2-01-13,,2851373
HSU2-01-13,,2851376
HSU2-01-13,,2851380
HSU2-01-13,,2851382
HSU2-01-13,,2851384
HSU2-01-14,,4925405
HSU2-01-14,,4925406
HSU2-01-14,,4925407
HSU2-01-14,,3070784
HSU2-01-14,,3070785
HSU2-01-14,,3070786
HSU2-01-14,,3070787
HSU2-01-14,,2822964
HSU2-01-14,,2822972
HSU2-01-14,,2849929
HSU2-01-14,,2849932
HSU2-01-14,,2849935
HSU2-01-14,,2851385
HSU2-01-14,,2851386
HSU2-01-14,,2851387
HSU2-01-15,,4925329
HSU2-01-15,,4925330
HSU2-01-15,,4925331
HSU2-01-15,,4925332
HSU2-01-15,,3070794
HSU2-01-15,,3070795
HSU2-01-15,,3070788
HSU2-01-15,,2851328
HSU2-01-15,,2851329
HSU2-01-15,,2851330
HSU2-01-15,,4925377
HSU2-01-15,,4925382
HSU2-01-15,,2851355
HSU2-01-16,,4925409
HSU2-01-16,,4925410
HSU2-01-16,,4925411
HSU2-01-16,,4925412
HSU2-01-16,,4925413
HSU2-01-16,,3070789
HSU2-01-16,,3070790
HSU2-01-16,,3070791
HSU2-01-16,,2851388
HSU2-01-16,,2851389
HSU2-01-16,,2851390
HSU2-02-01,,3071444
HSU2-02-01,,3071447
HSU2-02-01,,3071449
HSU2-02-01,,4925476
HSU2-02-01,,4925477
HSU2-02-01,,4925479
HSU2-02-01,,4925481
HSU2-02-02,,3071461
HSU2-02-02,,3071463
HSU2-02-02,,4925480
HSU2-02-02,,4925483
HSU2-02-03,,4925484
HSU2-02-03,,4925486
HSU2-02-03,,4925487
HSU2-02-03,,4925488
HSU2-02-03,,2822999
HSU2-02-03,,2849967
HSU2-02-03,,3071451
HSU2-02-03,,3071453
HSU2-02-03,,3071454
HSU2-02-03,,2851407
HSU2-02-03,,2851405
HSU2-02-03,,2851409
HSU2-02-04,,4925489
HSU2-02-04,,4925490
HSU2-02-04,,4925491
HSU2-02-04,,4925493
HSU2-02-04,,3071458
HSU2-02-04,,3071459
HSU2-02-04,,2851410
HSU2-02-04,,2851411
HSU2-02-05,,3071465
HSU2-02-05,,3071466
HSU2-02-05,,3071467
HSU2-02-05,,3071468
HSU2-02-05,,3071469
HSU2-02-05,,3071470
HSU2-02-05,,3071471
HSU2-02-05,,3071472
HSU2-02-05,,2823016
HSU2-02-05,,2849974
HSU2-02-05,,2849975
HSU2-02-05,,2849981
HSU2-02-05,,4925495
HSU2-02-05,,4925496
HSU2-02-05,,4925506
HSU2-02-05,,4925507
HSU2-02-05,,4925508
HSU2-02-06,,3071492
HSU2-02-06,,3071493
HSU2-02-06,,4925498
HSU2-02-06,,4925500
HSU2-02-06,,4925502
HSU2-02-06,,4925504
HSU2-02-06,,4925509
HSU2-02-07,,4925511
HSU2-02-07,,4925515
HSU2-02-07,,4925516
HSU2-02-07,,3071473
HSU2-02-07,,3071474
HSU2-02-07,,3071475
HSU2-02-08,,4925518
HSU2-02-08,,4925519
HSU2-02-08,,4925520
HSU2-02-08,,4925521
HSU2-02-08,,3071476
HSU2-02-08,,3071477
HSU2-02-08,,3071478
HSU2-02-08,,3071479
HSU2-02-09,,4925522
HSU2-02-09,,4925523
HSU2-02-09,,4925524
HSU2-02-09,,4925525
HSU2-02-09,,3071480
HSU2-02-09,,3071481
HSU2-02-09,,3071482
HSU2-02-09,,2823022
HSU2-02-09,,2849988
HSU2-02-09,,2849989
HSU2-02-10,,4925526
HSU2-02-10,,4925527
HSU2-02-10,,4925528
HSU2-02-10,,4925529
HSU2-02-10,,3071483
HSU2-02-10,,3071484
HSU2-02-10,,3071485
HSU2-02-11,,4925530
HSU2-02-11,,4925531
HSU2-02-11,,4925532
HSU2-02-11,,4925533
HSU2-02-11,,3071486
HSU2-02-11,,3071487
HSU2-02-11,,3071488
HSU2-02-11,,3071489
HSU2-02-11,,2823034
HSU2-02-11,,2849993
HSU2-02-11,,2849994
HSU2-02-11,,2851432
HSU2-02-11,,2851434
HSU2-02-12,,4925534
HSU2-02-12,,4925535
HSU2-02-12,,4925536
HSU2-02-12,,4925537
HSU2-02-12,,4925538
HSU2-02-12,,3071495
HSU2-02-12,,3071496
HSU2-02-12,,2849995
HSU2-02-12,,2851433
HSU2-02-13,,4925539
HSU2-02-13,,4925540
HSU2-02-13,,3071490
HSU2-02-13,,3071491
HSU2-03-01,,4925599
HSU2-03-01,,4925600
HSU2-03-01,,4925601
HSU2-03-01,,3078528
HSU2-03-01,,3078529
HSU2-03-01,,3078530
HSU2-03-01,,3078531
HSU2-03-02,,4925602
HSU2-03-02,,4925603
HSU2-03-02,,4925604
HSU2-03-02,,4925605
HSU2-03-03,,4925606
HSU2-03-03,,4925607
HSU2-03-03,,4925608
HSU2-03-03,,3078532
HSU2-03-03,,3078533
HSU2-03-03,,3078534
HSU2-03-03,,3078535
HSU2-03-03,,2834139
HSU2-03-03,,2850015
HSU2-03-03,,2850016
HSU2-03-03,,2850017
HSU2-03-03,,2851454
HSU2-03-03,,2851456
HSU2-03-03,,2851457
HSU2-03-04,,4925609
HSU2-03-04,,4925610
HSU2-03-04,,4925611
HSU2-03-04,,4925612
HSU2-03-04,,4925613
HSU2-03-04,,3078536
HSU2-03-04,,3078537
HSU2-03-04,,3078538
HSU2-03-04,,3078539
HSU2-03-04,,2834140
HSU2-03-04,,2834141
HSU2-03-04,,2850018
HSU2-03-04,,2850019
HSU2-03-04,,2850020
HSU2-03-04,,2851458
HSU2-03-04,,2851459
HSU2-03-04,,2851460
HSU2-03-04,,2851461
HSU2-03-05,,4925614
HSU2-03-05,,4925615
HSU2-03-05,,4925616
HSU2-03-05,,4925617
HSU2-03-05,,4925618
HSU2-03-05,,3078540
HSU2-03-05,,3078541
HSU2-03-05,,3078542
HSU2-03-05,,3078543
HSU2-03-05,,2834142
HSU2-03-05,,2834143
HSU2-03-05,,2834144
HSU2-03-05,,2850021
HSU2-03-05,,2850022
HSU2-03-05,,2850023
HSU2-03-05,,2850024
HSU2-03-05,,2851462
HSU2-03-05,,2851463
HSU2-03-05,,2851464
HSU2-03-05,,2851465
HSU2-03-06,,4925524
HSU2-03-06,,4925620
HSU2-03-06,,4925621
HSU2-03-06,,4925622
HSU2-03-06,,3078544
HSU2-03-06,,3078547
HSU2-03-06,,3078548
HSU2-03-06,,3078549
HSU2-03-06,,2834146
HSU2-03-06,,2850025
HSU2-03-06,,2850026
HSU2-03-06,,2851466
HSU2-03-06,,2851467
HSU2-03-06,,2851468
HSU2-03-07,,4925623
HSU2-03-07,,4925624
HSU2-03-07,,4925625
HSU2-03-07,,4925626
HSU2-03-07,,4925627
HSU2-03-07,,3078550
HSU2-03-07,,3078551
HSU2-03-07,,3078552
HSU2-03-07,,2834147
HSU2-03-07,,2850029
HSU2-03-07,,2851469
HSU2-03-07,,2851470
HSU2-03-07,,2851471
HSU2-03-08,,4925628
HSU2-03-08,,4925629
HSU2-03-08,,4925630
HSU2-03-08,,4925631
HSU2-03-08,,4925632
HSU2-03-08,,3078553
HSU2-03-08,,3078554
HSU2-03-08,,3078555
HSU2-03-08,,3078556
HSU2-03-08,,3078557
HSU2-03-08,,3078558
HSU2-03-08,,2851472
HSU2-03-08,,2851473
HSU2-03-08,,2851474
HSU2-03-08,,2834148
HSU2-03-09,,4925637
HSU2-03-09,,4925638
HSU2-03-09,,3078559
HSU2-03-09,,3078560
HSU2-03-10,,4925639
HSU2-03-10,,4925640
HSU2-03-10,,4925641
HSU2-03-11,,4925642
HSU2-03-11,,4925643
HSU2-03-11,,4925645
HSU2-03-11,,3078561
HSU2-03-11,,3078562
HSU2-03-11,,3078563
HSU2-03-11,,3078564
HSU2-03-11,,2834149
HSU2-03-11,,2834150
HSU2-03-11,,2850036
HSU2-03-11,,2850037
HSU2-03-11,,2850043
HSU2-03-11,,2851477
HSU2-03-11,,2851480
HSU2-03-11,,2851488
HSU2-03-12,,4925646
HSU2-03-12,,4925647
HSU2-03-12,,4925648
HSU2-03-12,,4925651
HSU2-03-12,,3078565
HSU2-03-12,,3078567
HSU2-03-12,,3078568
HSU2-03-12,,2834151
HSU2-03-12,,2834152
HSU2-03-12,,2850038
HSU2-03-12,,2850039
HSU2-03-12,,2851479
HSU2-03-12,,2851486
HSU2-03-13,,4925652
HSU2-03-13,,4925653
HSU2-03-13,,3078566
HSU2-03-13,,2850040
HSU2-03-13,,2850041
HSU2-03-13,,2850042
HSU2-03-14,,4925656
HSU2-03-14,,4925657
HSU2-03-14,,4925659
HSU2-03-14,,3078569
HSU2-03-14,,3078570
HSU2-03-14,,3078571
HSU2-03-14,,3078572
HSU2-03-14,,2834153
HSU2-03-14,,2851490
HSU2-03-14,,2851492
HSU2-03-15,,4925660
HSU2-03-15,,4925661
HSU2-03-15,,4925662
HSU2-03-15,,3078573
HSU2-03-15,,3078574
HSU2-03-15,,3078575
HSU2-03-15,,3078576
HSU2-03-15,,2851499
HSU2-03-15,,2851500
HSU2-03-15,,2851510
HSU2-03-15,,2850044
HSU2-03-15,,2850046
HSU2-03-16,,4925633
HSU2-03-16,,4925634
HSU2-03-16,,4925635
HSU2-03-16,,4925636
HSU2-03-16,,3078581
HSU2-03-16,,3078582
HSU2-03-16,,3078583
HSU2-03-16,,3078584
HSU2-03-16,,2834158
HSU2-03-16,,2850048
HSU2-03-16,,2850049
HSU2-03-16,,2851511
HSU2-03-16,,2851513
HSU2-03-16,,2851515
HSU2-03-17,,4925663
HSU2-03-17,,4925664
HSU2-03-17,,4925665
HSU2-03-17,,4925666
HSU2-03-17,,3078589
HSU2-03-17,,3078590
HSU2-03-17,,3078591
HSU2-03-17,,3078592
HSU2-03-17,,2834154
HSU2-03-17,,2850045
HSU2-03-17,,2850047
HSU2-03-17,,2851494
HSU2-03-17,,2851497
HSU2-03-18,,4925667
HSU2-03-18,,4925668
HSU2-03-18,,4925669
HSU2-03-18,,4925671
HSU2-03-18,,3078577
HSU2-03-18,,3078578
HSU2-03-18,,3078579
HSU2-03-18,,3078580
HSU2-03-18,,2851482
HSU2-03-18,,2851484
HSU2-03-19,,3078593
HSU2-03-19,,3078594
HSU2-03-19,,3078595
HSU2-03-19,,4925672
HSU2-03-19,,4925673
HSU2-03-19,,4925674
HSU2-03-20,,4925678
HSU2-03-20,,4925679
HSU2-03-20,,3078585
HSU2-03-20,,3078586
HSU2-03-20,,2834159
HSU2-03-20,,2850050
HSU2-03-20,,2851517
HSU2-03-21,,4925680
HSU2-03-21,,4925681
HSU2-03-21,,4925682
HSU2-03-21,,3078587
HSU2-03-21,,3078588
HSU2-03-21,,2850051
HSU2-03-21,,2850052
HSU2-03-21,,2851519
HSU2-03-21,,2851521
HSU2-04-01,,4925740
HSU2-04-01,,4925741
HSU2-04-01,,4925742
HSU2-04-01,,4925743
HSU2-04-01,,3078730
HSU2-04-01,,3078731
HSU2-04-02,,4925744
HSU2-04-02,,4925746
HSU2-04-02,,4925748
HSU2-04-02,,3078732
HSU2-04-02,,3078733
HSU2-04-02,,2850081
HSU2-04-03,,4925749
HSU2-04-03,,4925750
HSU2-04-03,,4925751
HSU2-04-03,,4925752
HSU2-04-03,,4925753
HSU2-04-03,,4925754
HSU2-04-03,,3078734
HSU2-04-03,,3078735
HSU2-04-03,,3078736
HSU2-04-03,,3078737
HSU2-04-03,,2834297
HSU2-04-03,,2850075
HSU2-04-03,,2850077
HSU2-04-03,,2850082
HSU2-04-03,,2851548
HSU2-04-03,,2851552
HSU2-04-03,,2851553
HSU2-04-03,,2851555
HSU2-04-03,,2851556
HSU2-04-04,,4925755
HSU2-04-04,,4925756
HSU2-04-04,,4925757
HSU2-04-04,,4925758
HSU2-04-04,,3078738
HSU2-04-04,,3078739
HSU2-04-04,,3078740
HSU2-04-04,,3078741
HSU2-04-04,,2834299
HSU2-04-04,,2850076
HSU2-04-04,,2850079
HSU2-04-04,,2851547
HSU2-04-04,,2851551
HSU2-04-05,,4925759
HSU2-04-05,,4925761
HSU2-04-05,,4925762
HSU2-04-05,,4925763
HSU2-04-05,,3078742
HSU2-04-05,,3078743
HSU2-04-05,,3078744
HSU2-04-05,,2834300
HSU2-04-05,,2850080
HSU2-04-05,,2851554
HSU2-04-06,,4925764
HSU2-04-06,,4925765
HSU2-04-06,,4925766
HSU2-04-06,,4925767
HSU2-04-06,,4925769
HSU2-04-06,,4925770
HSU2-04-06,,4925772
HSU2-04-06,,4925774
HSU2-04-06,,4925775
HSU2-04-06,,3078745
HSU2-04-06,,3078746
HSU2-04-06,,3078747
HSU2-04-06,,3078748
HSU2-04-06,,3078750
HSU2-04-06,,3078751
HSU2-04-06,,3078752
HSU2-04-06,,3078754
HSU2-04-06,,2834305
HSU2-04-06,,2834308
HSU2-04-06,,2850083
HSU2-04-06,,2850084
HSU2-04-06,,2850085
HSU2-04-06,,2851557
HSU2-04-06,,2851558
HSU2-04-06,,2851559
HSU2-04-06,,2851560
HSU2-04-06,,2851561
HSU2-04-07,,4925779
HSU2-04-07,,4925780
HSU2-04-07,,4925781
HSU2-04-07,,2850086
HSU2-04-07,,2851562
HSU2-04-08,,4925782
HSU2-04-08,,4925783
HSU2-04-08,,4925784
HSU2-04-08,,4925785
HSU2-04-08,,4925786
HSU2-04-08,,4925787
HSU2-04-08,,3078755
HSU2-04-08,,3078756
HSU2-04-08,,3078758
HSU2-04-08,,3078759
HSU2-04-08,,2834314
HSU2-04-08,,2850087
HSU2-04-08,,2850088
HSU2-04-08,,2850089
HSU2-04-08,,2850090
HSU2-04-08,,2851565
HSU2-04-08,,2851566
HSU2-04-08,,2851568
HSU2-04-08,,2851569
HSU2-04-08,,2851570
HSU2-04-08,,2851571
HSU2-04-09,,4925795
HSU2-04-09,,4925797
HSU2-04-09,,4925798
HSU2-04-09,,3078760
HSU2-04-09,,3078761
HSU2-04-09,,3078762
HSU2-04-09,,2834318
HSU2-04-09,,2850091
HSU2-04-09,,2850092
HSU2-04-09,,2850093
HSU2-04-09,,2851572
HSU2-04-09,,2851573
HSU2-04-09,,2851574
HSU2-04-10,,4925799
HSU2-04-10,,4925800
HSU2-04-10,,4925801
HSU2-04-10,,4925802
HSU2-04-11,,4925804
HSU2-04-11,,4925805
HSU2-04-11,,4925806
HSU2-04-11,,4925808
HSU2-04-11,,4925812
HSU2-04-11,,4925813
HSU2-04-11,,3078763
HSU2-04-11,,3078764
HSU2-04-11,,3078765
HSU2-04-11,,3078766
HSU2-04-11,,3078767
HSU2-04-11,,3078768
HSU2-04-12,,4925814
HSU2-04-12,,4925815
HSU2-04-12,,4925816
HSU2-04-12,,3078769
HSU2-04-12,,3078770
HSU2-04-12,,3078771
HSU2-04-13,,4925817
HSU2-04-13,,4925818
HSU2-04-13,,4925820
HSU2-04-13,,4925821
HSU2-04-13,,4925822
HSU2-04-13,,3078772
HSU2-04-13,,3078773
HSU2-04-13,,3078774
HSU2-04-13,,2834319
HSU2-04-13,,2850094
HSU2-04-13,,2850095
HSU2-04-13,,2850097
HSU2-04-13,,2851575
HSU2-04-13,,2851576
HSU2-04-13,,2851577
HSU2-04-14,,4925825
HSU2-04-14,,4925826
HSU2-04-14,,4925827
HSU2-04-14,,4925829
HSU2-04-14,,4925830
HSU2-04-14,,4925831
HSU2-04-14,,4925832
HSU2-04-14,,4925833
HSU2-04-14,,4925834
HSU2-04-14,,4925835
HSU2-04-14,,3078775
HSU2-04-14,,3078776
HSU2-04-14,,3078778
HSU2-04-14,,3078779
HSU2-04-14,,3078780
HSU2-04-14,,3078781
HSU2-04-14,,2834324
HSU2-04-14,,2850098
HSU2-04-14,,2850099
HSU2-04-14,,2850102
HSU2-04-14,,2851578
HSU2-04-14,,2851579
HSU2-04-14,,2851580
HSU2-04-14,,2851581
HSU2-04-14,,2851582
HSU2-04-14,,2851583
HSU2-04-15,,4925776
HSU2-04-15,,4925777
HSU2-04-15,,4925778
HSU2-04-15,,3078782
HSU2-04-15,,3078784
HSU2-04-15,,3078785
HSU2-04-15,,3078787
HSU2-04-16,,4925788
HSU2-04-16,,4925789
HSU2-04-16,,4925791
HSU2-04-16,,4925793
HSU2-04-16,,3078788
HSU2-04-16,,3078789
HSU2-04-16,,3078790
HSU2-05-01,,4925890
HSU2-05-01,,4925891
HSU2-05-01,,4925892
HSU2-05-01,,4925893
HSU2-05-01,,3079007
HSU2-05-01,,3079008
HSU2-05-01,,3079009
HSU2-05-01,,3079010
HSU2-05-01,,2851591
HSU2-05-01,,2851592
HSU2-05-01,,2851593
HSU2-05-01,,2834325
HSU2-05-01,,2850137
HSU2-05-02,,4925894
HSU2-05-02,,4925895
HSU2-05-02,,4925896
HSU2-05-02,,4925897
HSU2-05-02,,4925898
HSU2-05-02,,4925899
HSU2-05-02,,3079011
HSU2-05-02,,3079012
HSU2-05-02,,3079013
HSU2-05-02,,3079014
HSU2-05-02,,3079015
HSU2-05-02,,3079016
HSU2-05-02,,2850143
HSU2-05-02,,2851596
HSU2-05-02,,2851597
HSU2-05-02,,2851599
HSU2-05-03,,4925900
HSU2-05-03,,4925901
HSU2-05-03,,4925902
HSU2-05-03,,4925903
HSU2-05-03,,3079017
HSU2-05-03,,3079018
HSU2-05-03,,3079019
HSU2-05-03,,3079020
HSU2-05-03,,2851598
HSU2-05-04,,4925905
HSU2-05-04,,4925906
HSU2-05-04,,4925908
HSU2-05-04,,2851594
HSU2-05-04,,2851595
HSU2-05-04,,2850140
HSU2-05-05,,4925909
HSU2-05-05,,4925910
HSU2-05-05,,4925912
HSU2-05-05,,4925913
HSU2-05-05,,4925916
HSU2-05-05,,3079021
HSU2-05-05,,3079022
HSU2-05-05,,3079023
HSU2-05-05,,2850149
HSU2-05-05,,2851600
HSU2-05-05,,2851601
HSU2-05-06,,4925917
HSU2-05-06,,4925918
HSU2-05-06,,4925919
HSU2-05-06,,4925920
HSU2-05-06,,4925921
HSU2-05-06,,4925923
HSU2-05-06,,3079025
HSU2-05-06,,3079026
HSU2-05-06,,3079027
HSU2-05-06,,3079028
HSU2-05-06,,2834331
HSU2-05-06,,2850150
HSU2-05-06,,2850151
HSU2-05-06,,2850152
HSU2-05-06,,2851604
HSU2-05-06,,2851605
HSU2-05-06,,2851606
HSU2-05-06,,2851607
HSU2-05-07,,4925924
HSU2-05-07,,4925925
HSU2-05-07,,4925926
HSU2-05-07,,4925927
HSU2-05-07,,4925929
HSU2-05-07,,4925931
HSU2-05-07,,3079024
HSU2-05-07,,2851602
HSU2-05-07,,2851603
HSU2-05-08,,4925932
HSU2-05-08,,4925934
HSU2-05-08,,4925935
HSU2-05-08,,3079079
HSU2-05-08,,3079080
HSU2-05-09,,4925937
HSU2-05-09,,4925938
HSU2-05-09,,4925939
HSU2-05-09,,4925940
HSU2-05-09,,4925941
HSU2-05-09,,3079034
HSU2-05-09,,3079035
HSU2-05-09,,3079036
HSU2-05-09,,2834350
HSU2-05-09,,2850153
HSU2-05-09,,2850154
HSU2-05-09,,2851608
HSU2-05-09,,2851609
HSU2-05-09,,2851610
HSU2-05-09,,2851611
HSU2-05-10,,4925942
HSU2-05-10,,4925943
HSU2-05-10,,4925944
HSU2-05-10,,4925945
HSU2-05-10,,4925946
HSU2-05-10,,4925947
HSU2-05-10,,3079037
HSU2-05-10,,3079038
HSU2-05-10,,3079039
HSU2-05-10,,3079040
HSU2-05-10,,3079041
HSU2-05-10,,3079081
HSU2-05-10,,3079082
HSU2-05-10,,2851612
HSU2-05-10,,2851613
HSU2-05-11,,4925948
HSU2-05-11,,4925949
HSU2-05-11,,4925950
HSU2-05-11,,3079042
HSU2-05-11,,3079043
HSU2-05-11,,3079044
HSU2-05-11,,3079045
HSU2-05-11,,2834353
HSU2-05-11,,2850162
HSU2-05-11,,2850167
HSU2-05-11,,2851614
HSU2-05-12,,4925951
HSU2-05-12,,4925952
HSU2-05-12,,4925953
HSU2-05-12,,3079046
HSU2-05-12,,3079047
HSU2-05-12,,3079048
HSU2-05-12,,2834354
HSU2-05-12,,2850164
HSU2-05-12,,2851615
HSU2-05-12,,2851616
HSU2-05-13,,4925954
HSU2-05-13,,4925955
HSU2-05-13,,4925956
HSU2-05-13,,3079049
HSU2-05-13,,3079050
HSU2-05-13,,3079051
HSU2-05-13,,2834355
HSU2-05-13,,2850172
HSU2-05-13,,2850176
HSU2-05-13,,2851617
HSU2-05-13,,2851618
HSU2-05-13,,2851619
HSU2-05-14,,4925960
HSU2-05-14,,4925961
HSU2-05-14,,3079052
HSU2-05-14,,3079053
HSU2-05-14,,2834356
HSU2-05-14,,2850183
HSU2-05-14,,2851620
HSU2-05-15,,4925963
HSU2-05-15,,4925988
HSU2-05-15,,4925964
HSU2-05-15,,3079054
HSU2-05-15,,3079055
HSU2-05-15,,2834358
HSU2-05-15,,2850184
HSU2-05-15,,2851621
HSU2-05-15,,2851622
HSU2-05-16,,4925965
HSU2-05-16,,4925966
HSU2-05-16,,4925967
HSU2-05-16,,4925968
HSU2-05-16,,4925969
HSU2-05-16,,4925970
HSU2-05-16,,3079056
HSU2-05-16,,3079057
HSU2-05-16,,3079059
HSU2-05-16,,3079061
HSU2-05-16,,2834359
HSU2-05-16,,2834360
HSU2-05-16,,2850185
HSU2-05-16,,2850186
HSU2-05-16,,2850187
HSU2-05-16,,2850188
HSU2-05-16,,2851623
HSU2-05-16,,2851624
HSU2-05-16,,2851625
HSU2-05-16,,2851626
HSU2-05-17,,4925971
HSU2-05-17,,4925972
HSU2-05-17,,4925973
HSU2-05-17,,4925974
HSU2-05-17,,4925975
HSU2-05-17,,3079063
HSU2-05-17,,3079064
HSU2-05-17,,3079065
HSU2-05-17,,3079068
HSU2-05-17,,2834376
HSU2-05-17,,2850195
HSU2-05-17,,2850196
HSU2-05-17,,2850197
HSU2-05-17,,2851627
HSU2-05-17,,2851628
HSU2-05-17,,2851629
HSU2-05-18,,3079074
HSU2-05-19,,4925976
HSU2-05-19,,4925977
HSU2-05-19,,4925978
HSU2-05-19,,4925979
HSU2-05-19,,4925980
HSU2-05-19,,4925981
HSU2-05-19,,2834377
HSU2-05-19,,2850198
HSU2-05-19,,2850199
HSU2-05-19,,2851630
HSU2-05-19,,2851631
HSU2-05-19,,2851632
HSU2-05-19,,2851633
HSU2-05-19,,2851634
HSU2-05-19,,2851635
HSU2-05-19,,3079072
HSU2-05-19,,3079078
HSU2-05-19,,3079071
HSU2-05-19,,3079076
HSU2-05-20,,4925982
HSU2-05-20,,4925983
HSU2-05-20,,2834378
HSU2-05-20,,2850200
HSU2-05-20,,2850201
HSU2-05-20,,2851636
HSU2-05-20,,2851637
HSU2-05-20,,2851638
HSU2-05-20,,3079075
HSU2-06-01,,4926395
HSU2-06-01,,4926397
HSU2-06-01,,4926399
HSU2-06-01,,4926400
HSU2-06-01,,4926401
HSU2-06-01,,4926402
HSU2-06-01,,3079204
HSU2-06-01,,3079205
HSU2-06-01,,3079206
HSU2-06-01,,3079207
HSU2-06-01,,2851652
HSU2-06-01,,2851653
HSU2-06-01,,2851654
HSU2-06-01,,2851659
HSU2-06-01,,2851660
HSU2-06-01,,2851661
HSU2-06-01,,2834386
HSU2-06-01,,2834387
HSU2-06-01,,2850224
HSU2-06-01,,2851655
HSU2-06-01,,2851656
HSU2-06-01,,2851657
HSU2-06-02,,4926403
HSU2-06-02,,4926404
HSU2-06-02,,4926406
HSU2-06-02,,4926408
HSU2-06-02,,4926410
HSU2-06-02,,3079208
HSU2-06-02,,3079209
HSU2-06-02,,3079210
HSU2-06-02,,3079211
HSU2-06-02,,2834388
HSU2-06-02,,2850226
HSU2-06-02,,2851662
HSU2-06-02,,2851663
HSU2-06-02,,2851664
HSU2-06-03,,4926412
HSU2-06-03,,4926413
HSU2-06-03,,4926414
HSU2-06-03,,4926415
HSU2-06-03,,4926416
HSU2-06-03,,4926417
HSU2-06-03,,3079212
HSU2-06-03,,3079213
HSU2-06-03,,3079214
HSU2-06-03,,3079215
HSU2-06-04,,4926418
HSU2-06-04,,4926419
HSU2-06-04,,4926421
HSU2-06-04,,4926422
HSU2-06-04,,3079216
HSU2-06-04,,3079217
HSU2-06-04,,3079218
HSU2-06-04,,3079219
HSU2-06-04,,2850225
HSU2-06-05,,4926423
HSU2-06-05,,4926425
HSU2-06-05,,2851658
HSU2-06-06,,4926426
HSU2-06-06,,4926427
HSU2-06-06,,4926429
HSU2-06-06,,4926431
HSU2-06-06,,4926433
HSU2-06-06,,4926434
HSU2-06-06,,4926435
HSU2-06-06,,3079224
HSU2-06-06,,3079225
HSU2-06-06,,3079229
HSU2-06-06,,3079230
HSU2-06-06,,3079231
HSU2-06-06,,3079232
HSU2-06-06,,2834390
HSU2-06-06,,2834391
HSU2-06-06,,2850230
HSU2-06-06,,2850231
HSU2-06-06,,2850232
HSU2-06-06,,2851669
HSU2-06-06,,2851670
HSU2-06-06,,2851671
HSU2-06-06,,2851672
HSU2-06-06,,2851673
HSU2-06-06,,2851674
HSU2-06-06,,2851675
HSU2-06-06,,4926439
HSU2-06-06,,4926440
HSU2-06-06,,4926441
HSU2-06-07,,4926436
HSU2-06-07,,4926437
HSU2-06-07,,3079220
HSU2-06-07,,3079221
HSU2-06-07,,3079222
HSU2-06-07,,3079223
HSU2-06-07,,2834389
HSU2-06-07,,2850227
HSU2-06-07,,2850228
HSU2-06-07,,2850229
HSU2-06-07,,2851665
HSU2-06-07,,2851666
HSU2-06-07,,2851667
HSU2-06-07,,2851668
HSU2-06-07,,2851676
HSU2-06-07,,2851677
HSU2-06-07,,2851678
HSU2-06-07,,4926438
HSU2-06-08,,4926442
HSU2-06-08,,4926443
HSU2-06-08,,4926444
HSU2-06-08,,4926445
HSU2-06-08,,4926446
HSU2-06-08,,4926447
HSU2-06-08,,2851679
HSU2-06-08,,2851680
HSU2-06-08,,2851681
HSU2-06-08,,2851682
HSU2-06-08,,3079233
HSU2-06-08,,3079234
HSU2-06-08,,3079235
HSU2-06-08,,3079237
HSU2-06-08,,3079239
HSU2-06-08,,3079243
HSU2-06-08,,2850235
HSU2-06-08,,2850236
HSU2-06-09,,4926448
HSU2-06-09,,4926450
HSU2-06-09,,3079240
HSU2-06-09,,3079242
HSU2-06-10,,4926688
HSU2-06-10,,4926689
HSU2-06-10,,4926691
HSU2-06-10,,4926693
HSU2-06-10,,4926694
HSU2-06-10,,4926695
HSU2-06-10,,3079245
HSU2-06-10,,3079247
HSU2-06-10,,3079249
HSU2-06-11,,4926696
HSU2-06-11,,4926697
HSU2-06-11,,4926698
HSU2-06-11,,3079250
HSU2-06-11,,3079251
HSU2-06-11,,3079252
HSU2-06-11,,2850241
HSU2-06-11,,2851687
HSU2-06-12,,4926468
HSU2-06-12,,4926469
HSU2-06-12,,4926471
HSU2-06-12,,3079253
HSU2-06-12,,3079254
HSU2-06-12,,3079255
HSU2-06-12,,2850242
HSU2-06-12,,2851685
HSU2-06-12,,2851686
HSU2-06-13,,4926472
HSU2-06-13,,4926473
HSU2-06-13,,3079270
HSU2-06-13,,3079271
HSU2-06-13,,2834394
HSU2-06-13,,2850237
HSU2-06-13,,2851683
HSU2-06-14,,4926474
HSU2-06-14,,4926475
HSU2-06-14,,4926477
HSU2-06-14,,4926478
HSU2-06-14,,3079272
HSU2-06-14,,3079274
HSU2-06-14,,2850238
HSU2-06-14,,2851684
HSU2-06-15,,4926479
HSU2-06-15,,4926480
HSU2-06-15,,2851688
HSU2-06-15,,2851689
HSU2-06-15,,2851690
HSU2-06-15,,3079256
HSU2-06-15,,3079266
HSU2-06-15,,2834399
HSU2-06-15,,2850255
HSU2-06-16,,4926481
HSU2-06-16,,4926482
HSU2-06-16,,4926483
HSU2-06-16,,4926484
HSU2-06-16,,4926485
HSU2-06-16,,4926486
HSU2-06-16,,2851691
HSU2-06-16,,2851692
HSU2-06-16,,2851693
HSU2-06-16,,2851694
HSU2-06-16,,2851695
HSU2-06-16,,2851696
HSU2-06-16,,3079258
HSU2-06-16,,3079260
HSU2-06-16,,3079262
HSU2-06-16,,3079264
HSU2-06-16,,3079268
HSU2-06-16,,2850258
HSU2-07-01,,4926535
HSU2-07-01,,4926536
HSU2-07-01,,4926537
HSU2-07-01,,4926538
HSU2-07-01,,3080027
HSU2-07-01,,3080028
HSU2-07-01,,3080029
HSU2-07-01,,3080030
HSU2-07-01,,2851717
HSU2-07-01,,2851718
HSU2-07-01,,2851719
HSU2-07-01,,2851720
HSU2-07-01,,2848846
HSU2-07-01,,2850280
HSU2-07-01,,2850281
HSU2-07-01,,2850282
HSU2-07-01,,2850283
HSU2-07-02,,4926539
HSU2-07-02,,4926540
HSU2-07-02,,4926541
HSU2-07-02,,2851724
HSU2-07-02,,2851725
HSU2-07-02,,2851726
HSU2-07-02,,2851727
HSU2-07-02,,3080031
HSU2-07-02,,3080032
HSU2-07-02,,2848848
HSU2-07-02,,2850285
HSU2-07-02,,2850286
HSU2-07-03,,4926542
HSU2-07-03,,4926543
HSU2-07-03,,4926544
HSU2-07-03,,4926545
HSU2-07-03,,2851721
HSU2-07-03,,2851722
HSU2-07-03,,2851723
HSU2-07-03,,3080033
HSU2-07-03,,3080034
HSU2-07-03,,3080035
HSU2-07-03,,3080036
HSU2-07-03,,3080037
HSU2-07-03,,2848847
HSU2-07-03,,2850284
HSU2-07-03,,2850287
HSU2-07-04,,4926546
HSU2-07-04,,4926547
HSU2-07-04,,3080038
HSU2-07-04,,3080039
HSU2-07-04,,3080040
HSU2-07-05,,4926548
HSU2-07-05,,4926549
HSU2-07-05,,4926550
HSU2-07-05,,3080041
HSU2-07-05,,3080042
HSU2-07-05,,3080043
HSU2-07-05,,3080044
HSU2-07-05,,2851728
HSU2-07-05,,2851729
HSU2-07-05,,2851730
HSU2-07-05,,2851731
HSU2-07-05,,2848850
HSU2-07-05,,2848852
HSU2-07-05,,2848855
HSU2-07-05,,2848863
HSU2-07-05,,2850290
HSU2-07-05,,2850291
HSU2-07-05,,2850292
HSU2-07-05,,2850293
HSU2-07-06,,4926551
HSU2-07-06,,4926552
HSU2-07-06,,4926553
HSU2-07-06,,4926554
HSU2-07-06,,3080045
HSU2-07-06,,3080046
HSU2-07-06,,3080047
HSU2-07-06,,3080048
HSU2-07-06,,2851732
HSU2-07-06,,2851733
HSU2-07-06,,2851734
HSU2-07-06,,2848867
HSU2-07-06,,2848869
HSU2-07-06,,2850294
HSU2-07-06,,2850295
HSU2-07-06,,2850296
HSU2-07-06,,2850297
HSU2-07-07,,4926555
HSU2-07-07,,4926556
HSU2-07-07,,4926557
HSU2-07-07,,4926558
HSU2-07-07,,2851743
HSU2-07-07,,2851744
HSU2-07-07,,2851745
HSU2-07-07,,2851746
HSU2-07-07,,2848876
HSU2-07-07,,2850299
HSU2-07-07,,2850300
HSU2-07-07,,3080049
HSU2-07-07,,3080050
HSU2-07-07,,3080051
HSU2-07-07,,3080052
HSU2-07-07,,3080053
HSU2-07-08,,4926559
HSU2-07-08,,4926560
HSU2-07-08,,4926561
HSU2-07-08,,3080055
HSU2-07-08,,3080056
HSU2-07-08,,3080057
HSU2-07-08,,3080058
HSU2-07-08,,2851740
HSU2-07-08,,2851741
HSU2-07-08,,2851742
HSU2-07-09,,4926563
HSU2-07-09,,4926564
HSU2-07-09,,4926565
HSU2-07-09,,4926566
HSU2-07-09,,3080059
HSU2-07-09,,3080060
HSU2-07-09,,3080061
HSU2-07-09,,3080062
HSU2-07-09,,2851735
HSU2-07-09,,2851736
HSU2-07-09,,2851737
HSU2-07-10,,4926567
HSU2-07-10,,4926568
HSU2-07-10,,4926569
HSU2-07-10,,4926571
HSU2-07-10,,3080063
HSU2-07-10,,3080064
HSU2-07-10,,3080065
HSU2-07-11,,4926572
HSU2-07-11,,4926573
HSU2-07-11,,4926574
HSU2-07-11,,3080066
HSU2-07-11,,3080067
HSU2-07-11,,3080068
HSU2-07-11,,2851747
HSU2-07-11,,2851748
HSU2-07-11,,2851749
HSU2-07-12,,4926575
HSU2-07-12,,4926576
HSU2-07-12,,4926577
HSU2-07-12,,4926578
HSU2-07-12,,4926579
HSU2-07-12,,3080069
HSU2-07-12,,3080070
HSU2-07-12,,3080071
HSU2-07-12,,3080072
HSU2-07-12,,3080073
HSU2-07-12,,3080074
HSU2-07-12,,2851750
HSU2-07-12,,2851751
HSU2-07-12,,2851752
HSU2-08-01,,4926632
HSU2-08-01,,4926633
HSU2-08-01,,4926634
HSU2-08-01,,4926635
HSU2-08-01,,4926636
HSU2-08-01,,4926637
HSU2-08-01,,3080204
HSU2-08-01,,3080205
HSU2-08-01,,3080207
HSU2-08-01,,2848886
HSU2-08-01,,2848890
HSU2-08-01,,2848893
HSU2-08-01,,2848895
HSU2-08-01,,2850316
HSU2-08-01,,2850317
HSU2-08-01,,2850318
HSU2-08-01,,2850319
HSU2-08-01,,2850320
HSU2-08-01,,2851770
HSU2-08-01,,2851771
HSU2-08-01,,2851772
HSU2-08-01,,2851773
HSU2-08-02,,4926638
HSU2-08-02,,4926640
HSU2-08-02,,4926641
HSU2-08-02,,4926642
HSU2-08-02,,3080208
HSU2-08-02,,3080210
HSU2-08-02,,3080211
HSU2-08-02,,3080212
HSU2-08-03,,4926643
HSU2-08-03,,4926644
HSU2-08-03,,4926645
HSU2-08-03,,4926646
HSU2-08-03,,3080217
HSU2-08-03,,3080218
HSU2-08-03,,3080219
HSU2-08-03,,3080220
HSU2-08-03,,2848995
HSU2-08-03,,2849001
HSU2-08-03,,2850321
HSU2-08-03,,2850322
HSU2-08-03,,2850323
HSU2-08-03,,2851774
HSU2-08-03,,2851775
HSU2-08-03,,2851776
HSU2-08-03,,2851777
HSU2-08-04,,4926647
HSU2-08-04,,4926648
HSU2-08-04,,4926649
HSU2-08-04,,4926650
HSU2-08-04,,4926651
HSU2-08-04,,3080221
HSU2-08-04,,3080222
HSU2-08-04,,3080223
HSU2-08-04,,3080224
HSU2-08-04,,2849015
HSU2-08-04,,2849018
HSU2-08-04,,2850324
HSU2-08-04,,2850325
HSU2-08-04,,2850326
HSU2-08-04,,2851778
HSU2-08-04,,2851779
HSU2-08-04,,2851781
HSU2-08-04,,2851783
HSU2-08-05,,4926652
HSU2-08-05,,4926653
HSU2-08-05,,4926654
HSU2-08-05,,4926655
HSU2-08-05,,3080225
HSU2-08-05,,3080226
HSU2-08-05,,2851785
HSU2-08-05,,2851786
HSU2-08-05,,2851788
HSU2-08-05,,2849019
HSU2-08-05,,2850327
HSU2-08-05,,2850328
HSU2-08-06,,4926656
HSU2-08-06,,4926658
HSU2-08-06,,4926659
HSU2-08-06,,4926660
HSU2-08-06,,4926661
HSU2-08-06,,4926663
HSU2-08-06,,3080227
HSU2-08-06,,3080228
HSU2-08-06,,3080229
HSU2-08-06,,3080230
HSU2-08-06,,3080231
HSU2-08-06,,3080232
HSU2-08-06,,2851789
HSU2-08-06,,2851792
HSU2-08-06,,2851795
HSU2-08-06,,2851796
HSU2-08-06,,2850329
HSU2-08-06,,2850330
HSU2-08-06,,2850331
HSU2-08-06,,2850332
HSU2-08-07,,4926664
HSU2-08-07,,4926665
HSU2-08-07,,4926666
HSU2-08-07,,4926667
HSU2-08-07,,4926668
HSU2-08-07,,3080233
HSU2-08-07,,3080234
HSU2-08-07,,3080235
HSU2-08-07,,3080236
HSU2-08-07,,2849343
HSU2-08-07,,2849345
HSU2-08-07,,2850391
HSU2-08-07,,2850392
HSU2-08-07,,2850393
HSU2-08-07,,2851847
HSU2-08-07,,2851848
HSU2-08-07,,2851849
HSU2-08-07,,2851850
HSU2-08-08,,4926669
HSU2-08-08,,4926670
HSU2-08-08,,4926671
HSU2-08-08,,4926672
HSU2-08-08,,3080237
HSU2-08-08,,3080238
HSU2-08-08,,3080239
HSU2-08-09,,4926673
HSU2-08-09,,4926674
HSU2-08-09,,4926675
HSU2-08-09,,4926676
HSU2-08-09,,4926677
HSU2-08-09,,4926678
HSU2-08-09,,3080240
HSU2-08-09,,3080241
HSU2-08-09,,3080242
HSU2-08-09,,3080243
HSU2-08-09,,3080244
HSU2-08-09,,2849023
HSU2-08-09,,2850333
HSU2-08-09,,2850334
HSU2-08-09,,2850335
HSU2-08-09,,2850336
HSU2-08-09,,2851797
HSU2-08-09,,2851798
HSU2-08-09,,2851800
HSU2-08-09,,2851801
HSU2-08-10,,4926679
HSU2-08-10,,4926681
HSU2-08-10,,4926682
HSU2-08-10,,4926684
HSU2-08-10,,4926685
HSU2-08-10,,4926686
HSU2-08-10,,3080245
HSU2-08-10,,3080246
HSU2-08-10,,3080247
HSU2-08-10,,3080248
HSU2-08-10,,3080249
HSU2-08-10,,2851803
HSU2-08-10,,2851804
HSU2-08-10,,2851806
HSU2-08-10,,2851809
HSU2-08-10,,2849027
HSU2-08-10,,2850337
HSU2-08-10,,2850338
HSU2-08-11,,4926687
HSU2-08-11,,4926714
HSU2-08-11,,4926715
HSU2-08-11,,3080250
HSU2-08-11,,3080251
HSU2-08-11,,3080252
HSU2-08-11,,2851810
HSU2-08-11,,2851811
HSU2-08-11,,2851812
HSU2-08-11,,2850341
HSU2-08-12,,4926716
HSU2-08-12,,4926717
HSU2-08-12,,4926718
HSU2-08-12,,4926720
HSU2-08-12,,4926721
HSU2-08-12,,3080263
HSU2-08-12,,3080264
HSU2-08-12,,3080265
HSU2-08-12,,3080266
HSU2-08-12,,3080267
HSU2-08-12,,3080268
HSU2-08-12,,2851813
HSU2-08-12,,2851814
HSU2-08-12,,2851815
HSU2-08-12,,2851816
HSU2-08-12,,4926725
HSU2-08-12,,4926726
HSU2-08-12,,2849059
HSU2-08-12,,2850342
HSU2-08-12,,2850343
HSU2-08-12,,2851821
HSU2-08-12,,2851822
HSU2-08-13,,4926722
HSU2-08-13,,4926723
HSU2-08-13,,4926724
HSU2-08-13,,3080269
HSU2-08-13,,3080270
HSU2-08-13,,3080273
HSU2-08-13,,2851817
HSU2-08-13,,2851818
HSU2-08-13,,2851819
HSU2-08-13,,4926727
HSU2-08-13,,4926729
HSU2-08-13,,4926730
HSU2-08-13,,2851820
HSU2-08-14,,4926731
HSU2-08-14,,4926732
HSU2-08-14,,4926733
HSU2-08-14,,4926734
HSU2-08-14,,4926735
HSU2-08-14,,3080254
HSU2-08-14,,3080258
HSU2-08-14,,2849066
HSU2-08-14,,2850350
HSU2-08-14,,2850352
HSU2-08-14,,2850353
HSU2-08-14,,2851823
HSU2-08-14,,2851824
HSU2-08-15,,4926736
HSU2-08-15,,4926737
HSU2-08-15,,4926738
HSU2-08-15,,4926739
HSU2-08-15,,3080253
HSU2-08-15,,3080255
HSU2-08-15,,3080256
HSU2-08-15,,3080257
HSU2-08-15,,3080259
HSU2-08-15,,2849065
HSU2-08-15,,2850349
HSU2-08-15,,2851835
HSU2-08-15,,2851825
HSU2-08-15,,2851826
HSU2-08-16,,4926820
HSU2-08-16,,4926821
HSU2-08-16,,4926822
HSU2-08-16,,4926823
HSU2-08-16,,3080260
HSU2-08-16,,3080261
HSU2-08-16,,3080262
HSU2-09-01,,4926781
HSU2-09-01,,4926782
HSU2-09-01,,4926783
HSU2-09-01,,4926784
HSU2-09-01,,4926785
HSU2-09-01,,4926786
HSU2-09-01,,4926787
HSU2-09-01,,4926788
HSU2-09-01,,4926789
HSU2-09-01,,4926791
HSU2-09-01,,3080334
HSU2-09-01,,3080335
HSU2-09-01,,3080336
HSU2-09-01,,3080337
HSU2-09-01,,3080338
HSU2-09-01,,3080339
HSU2-09-01,,2851843
HSU2-09-01,,2851844
HSU2-09-01,,2851845
HSU2-09-01,,2851846
HSU2-09-01,,2850390
HSU2-09-02,,4926792
HSU2-09-02,,4926793
HSU2-09-02,,4926794
HSU2-09-02,,4926795
HSU2-09-02,,4926796
HSU2-09-02,,3080340
HSU2-09-02,,3080341
HSU2-09-02,,3080342
HSU2-09-02,,3080343
HSU2-09-02,,2851851
HSU2-09-02,,2851852
HSU2-09-02,,2851853
HSU2-09-02,,2851865
HSU2-09-03,,4926797
HSU2-09-03,,4926799
HSU2-09-03,,4926800
HSU2-09-03,,4926801
HSU2-09-03,,4926802
HSU2-09-03,,3080344
HSU2-09-03,,3080345
HSU2-09-03,,3080346
HSU2-09-03,,3080347
HSU2-09-03,,2849353
HSU2-09-03,,2849356
HSU2-09-03,,2850394
HSU2-09-03,,2850396
HSU2-09-03,,2850398
HSU2-09-03,,2850400
HSU2-09-03,,2850401
HSU2-09-03,,2851854
HSU2-09-03,,2851855
HSU2-09-03,,2851856
HSU2-09-04,,3080348
HSU2-09-04,,3080349
HSU2-09-04,,3080350
HSU2-09-05,,4926803
HSU2-09-05,,4926804
HSU2-09-05,,4926805
HSU2-09-05,,4926806
HSU2-09-05,,4926807
HSU2-09-05,,3080351
HSU2-09-05,,3080352
HSU2-09-05,,3080353
HSU2-09-05,,3080354
HSU2-09-05,,3080355
HSU2-09-05,,3080356
HSU2-09-05,,2849362
HSU2-09-05,,2850402
HSU2-09-05,,2850403
HSU2-09-05,,2850404
HSU2-09-05,,2851857
HSU2-09-05,,2851858
HSU2-09-05,,2851859
HSU2-09-05,,2851860
HSU2-09-06,,4926808
HSU2-09-06,,4926809
HSU2-09-06,,4926810
HSU2-09-06,,4926811
HSU2-09-06,,4926812
HSU2-09-06,,3080357
HSU2-09-06,,3080358
HSU2-09-06,,3080359
HSU2-09-06,,3080360
HSU2-09-06,,3080361
HSU2-09-06,,2849368
HSU2-09-06,,2850405
HSU2-09-06,,2850406
HSU2-09-06,,2850407
HSU2-09-06,,2851861
HSU2-09-06,,2851862
HSU2-09-06,,2851863
HSU2-09-07,,4926813
HSU2-09-07,,4926814
HSU2-09-07,,4926815
HSU2-09-07,,3080362
HSU2-09-07,,3080363
HSU2-09-07,,3080364
HSU2-09-07,,2849371
HSU2-09-07,,2850408
HSU2-09-07,,2850409
HSU2-09-07,,2851864
HSU2-09-08,,4926816
HSU2-09-08,,4926817
HSU2-09-08,,4926818
HSU2-09-08,,4926819
HSU2-09-08,,3080382
HSU2-09-08,,3080383
HSU2-09-08,,2850410
HSU2-09-08,,2851866
HSU2-09-09,,4926824
HSU2-09-09,,4926825
HSU2-09-09,,4926826
HSU2-09-09,,4926827
HSU2-09-09,,3080385
HSU2-09-09,,2849489
HSU2-09-09,,2850413
HSU2-09-09,,2851868
HSU2-09-09,,2851869
HSU2-09-10,,4926828
HSU2-09-10,,4926829
HSU2-09-10,,4926830
HSU2-09-10,,3080384
HSU2-09-10,,3080386
HSU2-09-10,,3080387
HSU2-09-10,,2849487
HSU2-09-10,,2850411
HSU2-09-10,,2851867
HSU2-09-11,,4926831
HSU2-09-11,,4926832
HSU2-09-11,,4926833
HSU2-09-11,,4926834
HSU2-09-11,,4926835
HSU2-09-11,,4926836
HSU2-09-11,,3080365
HSU2-09-11,,3080366
HSU2-09-11,,3080367
HSU2-09-11,,3080368
HSU2-09-11,,3080369
HSU2-09-11,,2850428
HSU2-09-11,,2851870
HSU2-09-12,,3080370
HSU2-09-12,,3080371
HSU2-09-12,,3080372
HSU2-09-12,,3080373
HSU2-09-12,,2851877
HSU2-09-12,,2851878
HSU2-09-12,,2851879
HSU2-09-12,,2851880
HSU2-09-12,,4926837
HSU2-09-12,,4926838
HSU2-09-12,,4926842
HSU2-09-12,,4926843
HSU2-09-12,,4926844
HSU2-09-12,,2850430
HSU2-09-12,,2850431
HSU2-09-12,,2850437
HSU2-09-12,,2851871
HSU2-09-12,,2851872
HSU2-09-12,,2851873
HSU2-09-12,,2851874
HSU2-09-12,,2851875
HSU2-09-12,,2851876
HSU2-09-13,,4926845
HSU2-09-13,,4926846
HSU2-09-13,,4926847
HSU2-09-13,,4926848
HSU2-09-13,,4926849
HSU2-09-13,,4926850
HSU2-09-13,,3080374
HSU2-09-13,,3080378
HSU2-09-13,,3080379
HSU2-09-13,,3080380
HSU2-09-13,,3080381
HSU2-09-13,,2851881
HSU2-09-13,,2851882
HSU2-09-13,,2850468
HCAL-01-01,,4919179
HCAL-01-01,,4919180
HCAL-01-01,,4919181
HCAL-01-01,,4925300
HCAL-01-01,,4925303
HCAL-01-01,,4925306
HCAL-01-01,,4925343
HCAL-01-01,,4925344
HCAL-01-01,,4925345
HCAL-01-01,,4925346
HCAL-01-01,,4925347
HCAL-01-01,,4925348
HCAL-01-01,,4928349
HCAL-01-01,,4928350
HCAL-01-01,,4928351
HCAL-01-02,,4919182
HCAL-01-02,,4919183
HCAL-01-02,,4919184
HCAL-01-02,,4919185
HCAL-01-02,,4928352
HCAL-01-02,,4928353
HCAL-01-02,,4928355
HCAL-01-03,,4919186
HCAL-01-03,,4919187
HCAL-01-03,,4919188
HCAL-01-04,,4919189
HCAL-01-04,,4919190
HCAL-01-04,,4919191
HCAL-01-04,,4925408
HCAL-01-04,,4925417
HCAL-01-04,,4925420
HCAL-01-04,,4925423
HCAL-01-04,,4925475
HCAL-01-04,,4925478
HCAL-01-04,,4925482
HCAL-01-04,,4925485
HCAL-01-04,,4928358
HCAL-01-05,,4919193
HCAL-01-05,,4919194
HCAL-01-05,,4919195
HCAL-01-05,,4919196
HCAL-01-05,,4925492
HCAL-01-05,,4925494
HCAL-01-05,,4925497
HCAL-01-05,,4925501
HCAL-01-05,,4928356
HCAL-01-05,,4928357
HCAL-01-06,,4919197
HCAL-01-06,,4919198
HCAL-01-06,,4919199
HCAL-01-07,,4919200
HCAL-01-07,,4919202
HCAL-01-07,,4919203
HCAL-01-07,,4919204
HCAL-01-07,,4925505
HCAL-01-07,,4928359
HCAL-01-07,,4928361
HCAL-01-07,,4928362
HCAL-01-07,,4928363
HCAL-01-08,,4919205
HCAL-01-08,,4919206
HCAL-01-08,,4919207
HCAL-01-08,,4919208
HCAL-01-08,,4919209
HCAL-01-08,,4919210
HCAL-01-08,,4925510
HCAL-01-08,,4925578
HCAL-01-08,,4925586
HCAL-01-08,,4925589
HCAL-01-08,,4928364
HCAL-01-08,,4928366
HCAL-01-09,,4919211
HCAL-01-09,,4919212
HCAL-01-09,,4919213
HCAL-01-09,,4919214
HCAL-01-09,,4925512
HCAL-01-09,,4925582
HCAL-01-09,,4925597
HCAL-01-09,,4928365
HCAL-01-09,,4928367
HCAL-01-10,,4919215
HCAL-01-10,,4919216
HCAL-01-10,,4919217
HCAL-01-10,,4925592
HCAL-01-10,,4928368
HCAL-01-10,,4928369
HCAL-01-10,,4928370
HCAL-01-10,,4928371
HCAL-01-11,,4919218
HCAL-01-11,,4919219
HCAL-01-11,,4919220
HCAL-01-11,,4919221
HCAL-01-11,,4925644
HCAL-01-11,,4925649
HCAL-01-11,,4925670
HCAL-01-11,,4925677
HCAL-01-11,,4928372
HCAL-01-11,,4928373
HCAL-01-11,,4928374
HCAL-01-11,,4928375
HCAL-01-12,,4919222
HCAL-01-12,,4919223
HCAL-01-12,,4919224
HCAL-01-12,,4919225
HCAL-01-12,,4919226
HCAL-01-12,,4919227
HCAL-01-12,,4919228
HCAL-01-12,,4919229
HCAL-01-12,,4925708
HCAL-01-12,,4925687
HCAL-01-12,,4925689
HCAL-01-12,,4928376
HCAL-01-12,,4928377
HCAL-01-12,,4928378
HCAL-01-12,,4928379
HCAL-01-13,,4919230
HCAL-01-13,,4919231
HCAL-01-13,,4919232
HCAL-01-13,,4919233
HCAL-01-13,,4925713
HCAL-01-13,,4925694
HCAL-01-13,,4928385
HCAL-01-13,,4928388
HCAL-01-14,,4919234
HCAL-01-14,,4919235
HCAL-01-14,,4919236
HCAL-01-14,,4919258
HCAL-01-14,,4919259
HCAL-01-14,,4919261
HCAL-01-14,,4925904
HCAL-01-14,,4925907
HCAL-01-14,,4925803
HCAL-01-14,,4925807
HCAL-01-14,,4925819
HCAL-01-14,,4925823
HCAL-01-14,,4925828
HCAL-01-14,,4928402
HCAL-01-14,,4928406
HCAL-01-14,,4928420
HCAL-01-14,,4928426
HCAL-01-14,,4928429
HCAL-01-15,,4919270
HCAL-01-15,,4919271
HCAL-01-15,,4919272
HCAL-01-15,,4919274
HCAL-01-15,,4919312
HCAL-01-15,,4919313
HCAL-01-15,,4925911
HCAL-01-15,,4925914
HCAL-01-15,,4925839
HCAL-01-15,,4925845
HCAL-01-15,,4928443
HCAL-01-15,,4928446
HCAL-01-15,,4928450
HCAL-01-16,,4919315
HCAL-01-16,,4919316
HCAL-01-16,,4919318
HCAL-01-16,,4919320
HCAL-01-16,,4925936
HCAL-01-16,,4925957
HCAL-01-16,,4925958
HCAL-01-16,,4928456
HCAL-01-16,,4928459
HCAL-01-16,,4928464
HCAL-01-17,,4919322
HCAL-01-17,,4919325
HCAL-01-17,,4919327
HCAL-01-17,,4928465
HCAL-01-17,,4928468
HCAL-01-17,,4928472
HCAL-01-17,,4928474
HCAL-01-18,,4919329
HCAL-01-18,,4919331
HCAL-01-18,,4919333
HCAL-01-18,,4919335
HCAL-01-18,,4919337
HCAL-01-18,,4919339
HCAL-01-18,,4919341
HCAL-01-18,,4919342
HCAL-01-18,,4919343
HCAL-01-18,,4925717
HCAL-01-18,,4925697
HCAL-01-18,,4925700
HCAL-01-18,,4928391
HCAL-01-18,,4928396
HCAL-01-18,,4928432
HCAL-01-19,,4928476
HCAL-01-19,,4928477
HCAL-01-19,,4928478
HCAL-02-01,,4919470
HCAL-02-01,,4919471
HCAL-02-01,,4919472
HCAL-02-01,,4919473
HCAL-02-01,,4919474
HCAL-02-01,,4919475
HCAL-02-01,,4926043
HCAL-02-01,,4926049
HCAL-02-01,,4926054
HCAL-02-01,,4926055
HCAL-02-01,,4928512
HCAL-02-01,,4928515
HCAL-02-01,,4928516
HCAL-02-01,,4928517
HCAL-02-01,,4928518
HCAL-02-02,,4919476
HCAL-02-02,,4919477
HCAL-02-02,,4919478
HCAL-02-03,,4919479
HCAL-02-03,,4919480
HCAL-02-03,,4919481
HCAL-02-03,,4926108
HCAL-02-03,,4926868
HCAL-02-03,,4926869
HCAL-02-03,,4926870
HCAL-02-03,,4928520
HCAL-02-03,,4928523
HCAL-02-03,,4928524
HCAL-02-04,,4919482
HCAL-02-04,,4919483
HCAL-02-04,,4919484
HCAL-02-04,,4919485
HCAL-02-04,,4919486
HCAL-02-04,,4926109
HCAL-02-04,,4926873
HCAL-02-04,,4926874
HCAL-02-04,,4926875
HCAL-02-04,,4926876
HCAL-02-04,,4926110
HCAL-02-04,,4926877
HCAL-02-04,,4926878
HCAL-02-04,,4926879
HCAL-02-04,,4928506
HCAL-02-04,,4928509
HCAL-02-04,,4928526
HCAL-02-04,,4928530
HCAL-02-04,,4928540
HCAL-02-04,,4928542
HCAL-02-04,,4928545
HCAL-02-04,,4928546
HCAL-02-05,,4919487
HCAL-02-05,,4919488
HCAL-02-05,,4926042
HCAL-02-05,,4926044
HCAL-02-05,,4926047
HCAL-02-05,,4926051
HCAL-02-05,,4926056
HCAL-02-05,,4928547
HCAL-02-05,,4928550
HCAL-02-06,,4919490
HCAL-02-06,,4919491
HCAL-02-06,,4919493
HCAL-02-06,,4919494
HCAL-02-06,,4926111
HCAL-02-06,,4926880
HCAL-02-06,,4926881
HCAL-02-06,,4928552
HCAL-02-06,,4928553
HCAL-02-06,,4928554
HCAL-02-07,,4919495
HCAL-02-07,,4919496
HCAL-02-07,,4926182
HCAL-02-07,,4926883
HCAL-02-07,,4928555
HCAL-02-07,,4928557
HCAL-02-08,,4919497
HCAL-02-08,,4919498
HCAL-02-08,,4919499
HCAL-02-08,,4919500
HCAL-02-08,,4919501
HCAL-02-09,,4919502
HCAL-02-09,,4919503
HCAL-02-09,,4919504
HCAL-02-09,,4919505
HCAL-02-09,,4919506
HCAL-02-09,,4919507
HCAL-02-09,,4919508
HCAL-02-09,,4926183
HCAL-02-09,,4926184
HCAL-02-09,,4926185
HCAL-02-09,,4926186
HCAL-02-09,,4927075
HCAL-02-09,,4927076
HCAL-02-09,,4927077
HCAL-02-09,,4927079
HCAL-02-09,,4926189
HCAL-02-09,,4927080
HCAL-02-09,,4927081
HCAL-02-09,,4927082
HCAL-02-09,,4927083
HCAL-02-09,,4927084
HCAL-02-09,,4928565
HCAL-02-09,,4928568
HCAL-02-09,,4928569
HCAL-02-10,,4919509
HCAL-02-10,,4919510
HCAL-02-10,,4919511
HCAL-02-10,,4919512
HCAL-02-10,,4919513
HCAL-02-10,,4919514
HCAL-02-10,,4926194
HCAL-02-10,,4927090
HCAL-02-10,,4927091
HCAL-02-10,,4927092
HCAL-02-10,,4928580
HCAL-02-10,,4928581
HCAL-02-10,,4928583
HCAL-02-10,,4928585
HCAL-02-11,,4919515
HCAL-02-11,,4919516
HCAL-02-11,,4919517
HCAL-02-11,,4919518
HCAL-02-11,,4919519
HCAL-02-11,,4919520
HCAL-02-11,,4919521
HCAL-02-11,,4919522
HCAL-02-11,,4926190
HCAL-02-11,,4926192
HCAL-02-11,,4927087
HCAL-02-11,,4927088
HCAL-02-11,,4927089
HCAL-02-11,,4928571
HCAL-02-11,,4928572
HCAL-02-11,,4928573
HCAL-02-11,,4928577
HCAL-02-11,,4928578
HCAL-02-12,,4919192
HCAL-02-12,,4919262
HCAL-02-12,,4919263
HCAL-02-12,,4919265
HCAL-02-12,,4919266
HCAL-02-12,,4919268
HCAL-02-12,,4919523
HCAL-02-12,,4919524
HCAL-02-12,,4919525
HCAL-02-12,,4926107
HCAL-02-12,,4928409
HCAL-02-12,,4928415
HCAL-02-12,,4928570
HCAL-02-13,,4919526
HCAL-02-13,,4919527
HCAL-02-13,,4919528
HCAL-02-13,,4919529
HCAL-02-13,,4926198
HCAL-02-13,,4927098
HCAL-02-13,,4928618
HCAL-02-13,,4928619
HCAL-02-14,,4919530
HCAL-02-14,,4919531
HCAL-02-14,,4919532
HCAL-02-14,,4919534
HCAL-02-14,,4926197
HCAL-02-14,,4927096
HCAL-02-14,,4928601
HCAL-02-15,,4919535
HCAL-02-15,,4919536
HCAL-02-15,,4919537
HCAL-02-15,,4919538
HCAL-02-15,,4928617
HCAL-02-16,,4919539
HCAL-02-16,,4919540
HCAL-02-16,,4919541
HCAL-02-16,,4919542
HCAL-02-16,,4919543
HCAL-02-16,,4926201
HCAL-02-16,,4927099
HCAL-02-16,,4928620
HCAL-02-16,,4928621
HCAL-02-17,,4919544
HCAL-02-17,,4919545
HCAL-02-17,,4919546
HCAL-02-17,,4919547
HCAL-02-17,,4927097
HCAL-02-17,,4928608
HCAL-02-18,,4919548
HCAL-02-18,,4919549
HCAL-02-18,,4919550
HCAL-02-18,,4919551
HCAL-02-18,,4919552
HCAL-02-18,,4926195
HCAL-02-18,,4926196
HCAL-02-18,,4927093
HCAL-02-18,,4927094
HCAL-02-18,,4927095
HCAL-02-18,,4928590
HCAL-02-18,,4928593
HCAL-02-18,,4928594
HCAL-02-18,,4928598
HCAL-03-01,,4919616
HCAL-03-01,,4919617
HCAL-03-01,,4919618
HCAL-03-01,,4919619
HCAL-03-01,,4919620
HCAL-03-01,,4919621
HCAL-03-01,,4926211
HCAL-03-01,,4926212
HCAL-03-01,,4926214
HCAL-03-01,,4926215
HCAL-03-01,,4927127
HCAL-03-01,,4927128
HCAL-03-01,,4927129
HCAL-03-01,,4927130
HCAL-03-01,,4927131
HCAL-03-01,,4927132
HCAL-03-01,,4927133
HCAL-03-01,,4928650
HCAL-03-01,,4928651
HCAL-03-01,,4928652
HCAL-03-01,,4928655
HCAL-03-02,,4919622
HCAL-03-02,,4919623
HCAL-03-02,,4919624
HCAL-03-02,,4919625
HCAL-03-02,,4919626
HCAL-03-02,,4926219
HCAL-03-02,,4926220
HCAL-03-02,,4927134
HCAL-03-02,,4927135
HCAL-03-02,,4927136
HCAL-03-02,,4927137
HCAL-03-02,,4927138
HCAL-03-02,,4928656
HCAL-03-02,,4928661
HCAL-03-02,,4928664
HCAL-03-02,,4928673
HCAL-03-03,,4919627
HCAL-03-03,,4919628
HCAL-03-03,,4919629
HCAL-03-03,,4919630
HCAL-03-03,,4919631
HCAL-03-03,,4919633
HCAL-03-03,,4919634
HCAL-03-03,,4926221
HCAL-03-03,,4926222
HCAL-03-03,,4926223
HCAL-03-03,,4926224
HCAL-03-03,,4927145
HCAL-03-03,,4927146
HCAL-03-03,,4927147
HCAL-03-03,,4927148
HCAL-03-03,,4927149
HCAL-03-03,,4927150
HCAL-03-03,,4928677
HCAL-03-03,,4928683
HCAL-03-03,,4928689
HCAL-03-03,,4928693
HCAL-03-03,,4928696
HCAL-03-03,,4928703
HCAL-03-03,,4928708
HCAL-03-04,,4919635
HCAL-03-04,,4919636
HCAL-03-04,,4919637
HCAL-03-04,,4919638
HCAL-03-04,,4919639
HCAL-03-04,,4919640
HCAL-03-04,,4919645
HCAL-03-04,,4919646
HCAL-03-04,,4919647
HCAL-03-04,,4919648
HCAL-03-04,,4919649
HCAL-03-04,,4919650
HCAL-03-04,,4926227
HCAL-03-04,,4926228
HCAL-03-04,,4926229
HCAL-03-04,,4927151
HCAL-03-04,,4927152
HCAL-03-04,,4927153
HCAL-03-04,,4927154
HCAL-03-04,,4927155
HCAL-03-04,,4928712
HCAL-03-04,,4928719
HCAL-03-04,,4928722
HCAL-03-04,,4928725
HCAL-03-05,,4919641
HCAL-03-05,,4919643
HCAL-03-05,,4919644
HCAL-03-05,,4919651
HCAL-03-05,,4919652
HCAL-03-05,,4919653
HCAL-03-05,,4919654
HCAL-03-05,,4919655
HCAL-03-05,,4926230
HCAL-03-05,,4926231
HCAL-03-05,,4927156
HCAL-03-05,,4927157
HCAL-03-05,,4927158
HCAL-03-05,,4927159
HCAL-03-05,,4928812
HCAL-03-05,,4928814
HCAL-03-05,,4928816
HCAL-03-06,,4919632
HCAL-03-06,,4919642
HCAL-03-06,,4919656
HCAL-03-06,,4919658
HCAL-03-06,,4919659
HCAL-03-06,,4919660
HCAL-03-06,,4919662
HCAL-03-06,,4926232
HCAL-03-06,,4927160
HCAL-03-06,,4927161
HCAL-03-06,,4927162
HCAL-03-06,,4928817
HCAL-03-06,,4928819
HCAL-03-06,,4928821
HCAL-03-07,,4919663
HCAL-03-07,,4919664
HCAL-03-07,,4919666
HCAL-03-07,,4919667
HCAL-03-07,,4926235
HCAL-03-07,,4927166
HCAL-03-07,,4927167
HCAL-03-07,,4928827
HCAL-03-07,,4928830
HCAL-03-07,,4928833
HCAL-03-08,,4919668
HCAL-03-08,,4919669
HCAL-03-08,,4919670
HCAL-03-08,,4919671
HCAL-03-08,,4919672
HCAL-03-08,,4919673
HCAL-03-08,,4928825
HCAL-03-09,,4919674
HCAL-03-09,,4919675
HCAL-03-09,,4919676
HCAL-03-09,,4919677
HCAL-03-09,,4926236
HCAL-03-09,,4926237
HCAL-03-09,,4927168
HCAL-03-09,,4927169
HCAL-03-09,,4927170
HCAL-03-09,,4927171
HCAL-03-09,,4927172
HCAL-03-09,,4927173
HCAL-03-09,,4928838
HCAL-03-09,,4928843
HCAL-03-09,,4928846
HCAL-03-09,,4928848
HCAL-03-09,,4928866
HCAL-03-10,,4919678
HCAL-03-10,,4919679
HCAL-03-10,,4919680
HCAL-03-10,,4919681
HCAL-03-10,,4919682
HCAL-03-10,,4919683
HCAL-03-10,,4926238
HCAL-03-10,,4926239
HCAL-03-10,,4926240
HCAL-03-10,,4926241
HCAL-03-10,,4927174
HCAL-03-10,,4927175
HCAL-03-10,,4927176
HCAL-03-10,,4927177
HCAL-03-10,,4927178
HCAL-03-10,,4926244
HCAL-03-10,,4927179
HCAL-03-10,,4927180
HCAL-03-10,,4927181
HCAL-03-10,,4928852
HCAL-03-10,,4928856
HCAL-03-10,,4928859
HCAL-03-10,,4928861
HCAL-03-10,,4928864
HCAL-03-10,,4928874
HCAL-03-10,,4928877
HCAL-03-11,,4919684
HCAL-03-11,,4919685
HCAL-03-11,,4919686
HCAL-03-11,,4926245
HCAL-03-11,,4927182
HCAL-03-11,,4927183
HCAL-03-11,,4928881
HCAL-03-11,,4928885
HCAL-03-11,,4928888
HCAL-04-01,,4919754
HCAL-04-01,,4919755
HCAL-04-01,,4919756
HCAL-04-01,,4919757
HCAL-04-01,,4919758
HCAL-04-02,,4919759
HCAL-04-02,,4919760
HCAL-04-02,,4919761
HCAL-04-02,,4919762
HCAL-04-02,,4926247
HCAL-04-02,,4927204
HCAL-04-02,,4927205
HCAL-04-02,,4927206
HCAL-04-02,,4928953
HCAL-04-02,,4928960
HCAL-04-02,,4928963
HCAL-04-02,,4928965
HCAL-04-03,,4919763
HCAL-04-03,,4919764
HCAL-04-03,,4919765
HCAL-04-03,,4919766
HCAL-04-03,,4919767
HCAL-04-03,,4919768
HCAL-04-03,,4926248
HCAL-04-03,,4926249
HCAL-04-03,,4926250
HCAL-04-03,,4927207
HCAL-04-03,,4927208
HCAL-04-03,,4927209
HCAL-04-03,,4927210
HCAL-04-03,,4928968
HCAL-04-03,,4928971
HCAL-04-03,,4928973
HCAL-04-03,,4928976
HCAL-04-04,,4919769
HCAL-04-04,,4919770
HCAL-04-04,,4919771
HCAL-04-04,,4919777
HCAL-04-04,,4919778
HCAL-04-04,,4919779
HCAL-04-04,,4919780
HCAL-04-04,,4926263
HCAL-04-04,,4927221
HCAL-04-04,,4927222
HCAL-04-04,,4929027
HCAL-04-04,,4929029
HCAL-04-04,,4929031
HCAL-04-05,,4919772
HCAL-04-05,,4919773
HCAL-04-05,,4919774
HCAL-04-05,,4919775
HCAL-04-05,,4919776
HCAL-04-05,,4926262
HCAL-04-05,,4927219
HCAL-04-05,,4927220
HCAL-04-05,,4929016
HCAL-04-05,,4929021
HCAL-04-05,,4929024
HCAL-04-06,,4919781
HCAL-04-06,,4919782
HCAL-04-06,,4919783
HCAL-04-06,,4919784
HCAL-04-06,,4919785
HCAL-04-06,,4919786
HCAL-04-06,,4919787
HCAL-04-06,,4926251
HCAL-04-06,,4926252
HCAL-04-06,,4926256
HCAL-04-06,,4927211
HCAL-04-06,,4927212
HCAL-04-06,,4927213
HCAL-04-06,,4927214
HCAL-04-06,,4928983
HCAL-04-06,,4928986
HCAL-04-06,,4928989
HCAL-04-06,,4928992
HCAL-04-07,,4926259
HCAL-04-07,,4926260
HCAL-04-07,,4926261
HCAL-04-07,,4927215
HCAL-04-07,,4927216
HCAL-04-07,,4927217
HCAL-04-07,,4927218
HCAL-04-07,,4928994
HCAL-04-07,,4928998
HCAL-04-07,,4929002
HCAL-04-07,,4929009
HCAL-04-08,,4919788
HCAL-04-08,,4919790
HCAL-04-08,,4919793
HCAL-04-08,,4919794
HCAL-04-08,,4919795
HCAL-04-08,,4919796
HCAL-04-08,,4929053
HCAL-04-08,,4929058
HCAL-04-08,,4929064
HCAL-04-09,,4919797
HCAL-04-09,,4919798
HCAL-04-09,,4919799
HCAL-04-09,,4919800
HCAL-04-09,,4926264
HCAL-04-09,,4926265
HCAL-04-09,,4927223
HCAL-04-09,,4927224
HCAL-04-09,,4927225
HCAL-04-09,,4927226
HCAL-04-09,,4927227
HCAL-04-09,,4929068
HCAL-04-09,,4929071
HCAL-04-09,,4929075
HCAL-04-09,,4929078
HCAL-04-10,,4919801
HCAL-04-10,,4919802
HCAL-04-10,,4919803
HCAL-04-10,,4919804
HCAL-04-10,,4919805
HCAL-04-10,,4919806
HCAL-04-10,,4919807
HCAL-04-10,,4919808
HCAL-04-10,,4919809
HCAL-04-10,,4919810
HCAL-04-10,,4919811
HCAL-04-10,,4919812
HCAL-04-10,,4919813
HCAL-04-10,,4919814
HCAL-04-10,,4919815
HCAL-04-10,,4926266
HCAL-04-10,,4926267
HCAL-04-10,,4926268
HCAL-04-10,,4926269
HCAL-04-10,,4927228
HCAL-04-10,,4927229
HCAL-04-10,,4927230
HCAL-04-10,,4927231
HCAL-04-10,,4929080
HCAL-04-10,,4929081
HCAL-04-10,,4929084
HCAL-04-10,,4929087
HCAL-04-11,,4919816
HCAL-04-11,,4919817
HCAL-04-11,,4919818
HCAL-04-11,,4919819
HCAL-04-11,,4919820
HCAL-04-11,,4919821
HCAL-04-11,,4919822
HCAL-04-11,,4919823
HCAL-04-11,,4919824
HCAL-04-11,,4926270
HCAL-04-11,,4926271
HCAL-04-11,,4926272
HCAL-04-11,,4927232
HCAL-04-11,,4927233
HCAL-04-11,,4927234
HCAL-04-11,,4927235
HCAL-04-11,,4927236
HCAL-04-11,,4929090
HCAL-04-11,,4929094
HCAL-04-11,,4929214
HCAL-04-11,,4929099
HCAL-04-12,,4919825
HCAL-04-12,,4919826
HCAL-04-12,,4919827
HCAL-04-12,,4919828
HCAL-04-12,,4919829
HCAL-04-12,,4926273
HCAL-04-12,,4927237
HCAL-04-12,,4927239
HCAL-04-12,,4927240
HCAL-04-12,,4927241
HCAL-04-12,,4929225
HCAL-04-12,,4929227
HCAL-04-12,,4929242
HCAL-04-12,,4929249
HCAL-04-13,,4919830
HCAL-04-13,,4919831
HCAL-04-13,,4919832
HCAL-04-13,,4919833
HCAL-04-13,,4919834
HCAL-04-13,,4919835
HCAL-04-13,,4926274
HCAL-04-13,,4927242
HCAL-04-13,,4927243
HCAL-04-13,,4929254
HCAL-04-13,,4929257
HCAL-04-13,,4929270
HCAL-04-14,,4919836
HCAL-04-14,,4919837
HCAL-04-14,,4919838
HCAL-04-14,,4919839
HCAL-04-15,,4919840
HCAL-04-15,,4919841
HCAL-04-15,,4919842
HCAL-04-15,,4919843
HCAL-04-15,,4919844
HCAL-04-15,,4919845
HCAL-04-15,,4919846
HCAL-04-15,,4926283
HCAL-04-15,,4926286
HCAL-04-15,,4926287
HCAL-04-15,,4926288
HCAL-04-15,,4927246
HCAL-04-15,,4927247
HCAL-04-15,,4927248
HCAL-04-15,,4927249
HCAL-04-15,,4927250
HCAL-04-15,,4927251
HCAL-04-15,,4929271
HCAL-04-15,,4929272
HCAL-04-15,,4929273
HCAL-04-15,,4929349
HCAL-04-15,,4929356
HCAL-04-16,,4919847
HCAL-04-16,,4929278
HCAL-04-16,,4929353
HCAL-05-01,,4919925
HCAL-05-01,,4919926
HCAL-05-01,,4919927
HCAL-05-01,,4919928
HCAL-05-01,,4919929
HCAL-05-01,,4919930
HCAL-05-01,,4919931
HCAL-05-01,,4919932
HCAL-05-01,,4926295
HCAL-05-01,,4926296
HCAL-05-01,,4926297
HCAL-05-01,,4926298
HCAL-05-01,,4927277
HCAL-05-01,,4927278
HCAL-05-01,,4927279
HCAL-05-01,,4927280
HCAL-05-01,,4927281
HCAL-05-01,,4929502
HCAL-05-01,,4929505
HCAL-05-01,,4929508
HCAL-05-01,,4929512
HCAL-05-02,,4919935
HCAL-05-02,,4919936
HCAL-05-02,,4919937
HCAL-05-02,,4926299
HCAL-05-02,,4926300
HCAL-05-02,,4926301
HCAL-05-02,,4926302
HCAL-05-02,,4927282
HCAL-05-02,,4927283
HCAL-05-02,,4927284
HCAL-05-02,,4927285
HCAL-05-02,,4927286
HCAL-05-02,,4929516
HCAL-05-02,,4929519
HCAL-05-02,,4929521
HCAL-05-02,,4929525
HCAL-05-03,,4919943
HCAL-05-03,,4919944
HCAL-05-03,,4919945
HCAL-05-03,,4919946
HCAL-05-03,,4919947
HCAL-05-03,,4926303
HCAL-05-03,,4926304
HCAL-05-03,,4927291
HCAL-05-03,,4927295
HCAL-05-03,,4929527
HCAL-05-03,,4929539
HCAL-05-04,,4919948
HCAL-05-04,,4919949
HCAL-05-04,,4919950
HCAL-05-04,,4919951
HCAL-05-04,,4919952
HCAL-05-04,,4919953
HCAL-05-04,,4926305
HCAL-05-04,,4926306
HCAL-05-04,,4927292
HCAL-05-04,,4927293
HCAL-05-04,,4927294
HCAL-05-04,,4929536
HCAL-05-04,,4929546
HCAL-05-05,,4919954
HCAL-05-05,,4919955
HCAL-05-05,,4919956
HCAL-05-05,,4919957
HCAL-05-05,,4926308
HCAL-05-05,,4926309
HCAL-05-05,,4926311
HCAL-05-05,,4926314
HCAL-05-05,,4927298
HCAL-05-05,,4927299
HCAL-05-05,,4927300
HCAL-05-05,,4927301
HCAL-05-05,,4927302
HCAL-05-05,,4929570
HCAL-05-05,,4929571
HCAL-05-05,,4929573
HCAL-05-05,,4929575
HCAL-05-06,,4919938
HCAL-05-06,,4919939
HCAL-05-06,,4919940
HCAL-05-06,,4919941
HCAL-05-06,,4919942
HCAL-05-06,,4926307
HCAL-05-06,,4927296
HCAL-05-06,,4927297
HCAL-05-06,,4929553
HCAL-05-06,,4929556
HCAL-05-06,,4929563
HCAL-05-07,,4919958
HCAL-05-07,,4919959
HCAL-05-07,,4919960
HCAL-05-07,,4919963
HCAL-05-07,,4919964
HCAL-05-07,,4926320
HCAL-05-07,,4926321
HCAL-05-07,,4927303
HCAL-05-07,,4927304
HCAL-05-07,,4927305
HCAL-05-07,,4927306
HCAL-05-07,,4927310
HCAL-05-07,,4929578
HCAL-05-07,,4929582
HCAL-05-07,,4929585
HCAL-05-08,,4919933
HCAL-05-08,,4919934
HCAL-05-08,,4919965
HCAL-05-08,,4919966
HCAL-05-08,,4919967
HCAL-05-08,,4919968
HCAL-05-08,,4929589
HCAL-05-08,,4929599
HCAL-05-08,,4929602
HCAL-05-09,,4919969
HCAL-05-09,,4919970
HCAL-05-09,,4919971
HCAL-05-09,,4919972
HCAL-05-09,,4919973
HCAL-05-09,,4919974
HCAL-05-09,,4926326
HCAL-05-09,,4926327
HCAL-05-09,,4927318
HCAL-05-09,,4927322
HCAL-05-09,,4927323
HCAL-05-09,,4927324
HCAL-05-09,,4927325
HCAL-05-09,,4929605
HCAL-05-09,,4929611
HCAL-05-09,,4929623
HCAL-05-10,,4919975
HCAL-05-10,,4919976
HCAL-05-10,,4919977
HCAL-05-10,,4919978
HCAL-05-10,,4919979
HCAL-05-10,,4926331
HCAL-05-10,,4926332
HCAL-05-10,,4926333
HCAL-05-10,,4927326
HCAL-05-10,,4927327
HCAL-05-10,,4927328
HCAL-05-10,,4927329
HCAL-05-10,,4927330
HCAL-05-10,,4929626
HCAL-05-10,,4929632
HCAL-05-10,,4929637
HCAL-05-10,,4929641
HCAL-05-11,,4919980
HCAL-05-11,,4919981
HCAL-05-11,,4919982
HCAL-05-11,,4926336
HCAL-05-11,,4926337
HCAL-05-11,,4926338
HCAL-05-11,,4927331
HCAL-05-11,,4927332
HCAL-05-11,,4927333
HCAL-05-11,,4927334
HCAL-05-11,,4927335
HCAL-05-11,,4929644
HCAL-05-11,,4929647
HCAL-05-11,,4929652
HCAL-05-12,,4919983
HCAL-05-12,,4919984
HCAL-05-12,,4919985
HCAL-05-12,,4919986
HCAL-05-12,,4919987
HCAL-05-12,,4926339
HCAL-05-12,,4927336
HCAL-05-12,,4927337
HCAL-05-12,,4927338
HCAL-05-12,,4929654
HCAL-05-12,,4929657
HCAL-05-12,,4929661
HCAL-05-12,,4929665
HCAL-05-13,,4919988
HCAL-05-13,,4919989
HCAL-05-13,,4919990
HCAL-05-13,,4919991
HCAL-05-13,,4919992
HCAL-05-13,,4919993
HCAL-05-13,,4926340
HCAL-05-13,,4926341
HCAL-05-13,,4927345
HCAL-05-13,,4927346
HCAL-05-13,,4927347
HCAL-05-13,,4927348
HCAL-05-13,,4927349
HCAL-05-13,,4927350
HCAL-05-13,,4929674
HCAL-05-13,,4929678
HCAL-05-13,,4929687
HCAL-05-13,,4929688
HCAL-06-01,,4920059
HCAL-06-01,,4920060
HCAL-06-01,,4920061
HCAL-06-01,,4920062
HCAL-06-01,,4920063
HCAL-06-01,,4920064
HCAL-06-01,,4920065
HCAL-06-01,,4920066
HCAL-06-01,,4920067
HCAL-06-01,,4920068
HCAL-06-01,,4926344
HCAL-06-01,,4926345
HCAL-06-01,,4927373
HCAL-06-01,,4927374
HCAL-06-01,,4927375
HCAL-06-01,,4927376
HCAL-06-01,,4929756
HCAL-06-01,,4929763
HCAL-06-01,,4929770
HCAL-06-01,,4929777
HCAL-06-01,,4929789
HCAL-06-01,,4929792
HCAL-06-01,,4929799
HCAL-06-02,,4920069
HCAL-06-02,,4920070
HCAL-06-02,,4920071
HCAL-06-02,,4920072
HCAL-06-02,,4920073
HCAL-06-02,,4920074
HCAL-06-02,,4926346
HCAL-06-02,,4927377
HCAL-06-02,,4927378
HCAL-06-02,,4927380
HCAL-06-02,,4927381
HCAL-06-02,,4927382
HCAL-06-02,,4929807
HCAL-06-02,,4929810
HCAL-06-02,,4929814
HCAL-06-02,,4929817
HCAL-06-03,,4920075
HCAL-06-03,,4920076
HCAL-06-03,,4920077
HCAL-06-03,,4920078
HCAL-06-03,,4920079
HCAL-06-03,,4920080
HCAL-06-03,,4926347
HCAL-06-03,,4927383
HCAL-06-03,,4927384
HCAL-06-03,,4929831
HCAL-06-03,,4929837
HCAL-06-03,,4929838
HCAL-06-03,,4929839
HCAL-06-04,,4920081
HCAL-06-04,,4920082
HCAL-06-04,,4920083
HCAL-06-04,,4926348
HCAL-06-04,,4927385
HCAL-06-04,,4927386
HCAL-06-04,,4929845
HCAL-06-04,,4929847
HCAL-06-04,,4929852
HCAL-06-05,,4920084
HCAL-06-05,,4920085
HCAL-06-05,,4920086
HCAL-06-06,,4920087
HCAL-06-06,,4920088
HCAL-06-06,,4920089
HCAL-06-06,,4920093
HCAL-06-06,,4920099
HCAL-06-06,,4920100
HCAL-06-06,,4920101
HCAL-06-06,,4920102
HCAL-06-06,,4920103
HCAL-06-06,,4920104
HCAL-06-06,,4920105
HCAL-06-06,,4920106
HCAL-06-06,,4920107
HCAL-06-07,,4920108
HCAL-06-07,,4920109
HCAL-06-07,,4920110
HCAL-06-07,,4920111
HCAL-06-07,,4926349
HCAL-06-07,,4927403
HCAL-06-07,,4927408
HCAL-06-07,,4927409
HCAL-06-07,,4927411
HCAL-06-07,,4929861
HCAL-06-07,,4929896
HCAL-06-07,,4929902
HCAL-06-07,,4929906
HCAL-06-08,,4920112
HCAL-06-08,,4920113
HCAL-06-08,,4920114
HCAL-06-08,,4920115
HCAL-06-08,,4920116
HCAL-06-08,,4920117
HCAL-06-08,,4927412
HCAL-06-08,,4927440
HCAL-06-08,,4929927
HCAL-06-08,,4929934
HCAL-06-08,,4929938
HCAL-06-08,,4929947
HCAL-06-09,,4920118
HCAL-06-09,,4920119
HCAL-06-09,,4920120
HCAL-06-09,,4920121
HCAL-06-09,,4920122
HCAL-06-09,,4920123
HCAL-06-09,,4920124
HCAL-06-09,,4926350
HCAL-06-09,,4929951
HCAL-06-09,,4929957
HCAL-06-09,,4930060
HCAL-06-10,,4920125
HCAL-06-10,,4920126
HCAL-06-10,,4920127
HCAL-06-10,,4920128
HCAL-06-10,,4920129
HCAL-06-10,,4920130
HCAL-06-10,,4920131
HCAL-06-10,,4920132
HCAL-06-10,,4920133
HCAL-06-10,,4920134
HCAL-06-10,,4920135
HCAL-06-10,,4920136
HCAL-06-10,,4920137
HCAL-06-10,,4920138
HCAL-06-10,,4927441
HCAL-06-10,,4927442
HCAL-06-10,,4927443
HCAL-06-10,,4927444
HCAL-06-10,,4927445
HCAL-06-10,,4927446
HCAL-06-10,,4929960
HCAL-06-10,,4929964
HCAL-06-10,,4929967
HCAL-06-10,,4930016
HCAL-06-10,,4930044
HCAL-06-10,,4930063
HCAL-06-10,,4930077
HCAL-06-10,,4930079
HCAL-06-11,,4920139
HCAL-06-11,,4920140
HCAL-06-11,,4920142
HCAL-06-11,,4920141
HCAL-06-11,,4920143
HCAL-06-11,,4927447
HCAL-06-11,,4930083
HCAL-06-11,,4930089
HCAL-06-11,,4930091
HCAL-06-11,,4930145
HCAL-07-01,,4920208
HCAL-07-01,,4920209
HCAL-07-01,,4920210
HCAL-07-01,,4920211
HCAL-07-01,,4927453
HCAL-07-01,,4930151
HCAL-07-01,,4930153
HCAL-07-01,,4930156
HCAL-07-01,,4930159
HCAL-07-02,,4920212
HCAL-07-02,,4920213
HCAL-07-02,,4920214
HCAL-07-02,,4920215
HCAL-07-02,,4920216
HCAL-07-02,,4926351
HCAL-07-02,,4926352
HCAL-07-02,,4927448
HCAL-07-02,,4927449
HCAL-07-02,,4927450
HCAL-07-02,,4927451
HCAL-07-02,,4927454
HCAL-07-02,,4930160
HCAL-07-02,,4930196
HCAL-07-02,,4930202
HCAL-07-02,,4930205
HCAL-07-03,,4920217
HCAL-07-03,,4920218
HCAL-07-03,,4920220
HCAL-07-03,,4920221
HCAL-07-03,,4920222
HCAL-07-03,,4926355
HCAL-07-03,,4927455
HCAL-07-03,,4927457
HCAL-07-03,,4927459
HCAL-07-03,,4930213
HCAL-07-03,,4930229
HCAL-07-03,,4930233
HCAL-07-04,,4920223
HCAL-07-04,,4920224
HCAL-07-04,,4920225
HCAL-07-04,,4930234
HCAL-07-04,,4930237
HCAL-07-04,,4930243
HCAL-07-04,,4930248
HCAL-07-05,,4920226
HCAL-07-05,,4926356
HCAL-07-05,,4927465
HCAL-07-05,,4927552
HCAL-07-05,,4927556
HCAL-07-05,,4927559
HCAL-07-05,,4930259
HCAL-07-06,,4920227
HCAL-07-06,,4920228
HCAL-07-06,,4926357
HCAL-07-06,,4927560
HCAL-07-06,,4927561
HCAL-07-06,,4927563
HCAL-07-06,,4927564
HCAL-07-06,,4930254
HCAL-07-07,,4920229
HCAL-07-07,,4920230
HCAL-07-07,,4920231
HCAL-07-07,,4920232
HCAL-07-07,,4920233
HCAL-07-07,,4920234
HCAL-07-07,,4926358
HCAL-07-07,,4926359
HCAL-07-07,,4927565
HCAL-07-07,,4927566
HCAL-07-07,,4930265
HCAL-07-07,,4930268
HCAL-07-08,,4920235
HCAL-07-08,,4920236
HCAL-07-08,,4920237
HCAL-07-08,,4920238
HCAL-07-08,,4920239
HCAL-07-08,,4920240
HCAL-07-08,,4920241
HCAL-07-08,,4920242
HCAL-07-08,,4920243
HCAL-07-08,,4920244
HCAL-07-08,,4920245
HCAL-07-08,,4920246
HCAL-07-08,,4920248
HCAL-07-08,,4920249
HCAL-07-08,,4920250
HCAL-07-08,,4926360
HCAL-07-08,,4926361
HCAL-07-08,,4927567
HCAL-07-08,,4927569
HCAL-07-08,,4930272
HCAL-07-08,,4930303
HCAL-07-08,,4930306
HCAL-07-08,,4930309
HCAL-07-08,,4930313
HCAL-07-08,,4930317
HCAL-07-09,,4920251
HCAL-07-09,,4920252
HCAL-07-09,,4920253
HCAL-07-09,,4920254
HCAL-07-09,,4920255
HCAL-07-09,,4920256
HCAL-07-09,,4926364
HCAL-07-09,,4927570
HCAL-07-09,,4927571
HCAL-07-09,,4930322
HCAL-07-09,,4930326
HCAL-07-09,,4930328
HCAL-07-10,,4920257
HCAL-07-10,,4920260
HCAL-07-10,,4920261
HCAL-07-10,,4920262
HCAL-07-10,,4920263
HCAL-07-10,,4920264
HCAL-07-10,,4920265
HCAL-07-10,,4920266
HCAL-07-10,,4926368
HCAL-07-10,,4927701
HCAL-07-10,,4927702
HCAL-07-10,,4927703
HCAL-07-10,,4926369
HCAL-07-10,,4927707
HCAL-07-10,,4927710
HCAL-07-10,,4930360
HCAL-07-10,,4930363
HCAL-07-10,,4930369
HCAL-07-10,,4930372
HCAL-07-10,,4930375
HCAL-07-10,,4930379
HCAL-07-10,,4930383
HCAL-07-11,,4920267
HCAL-07-11,,4920268
HCAL-07-11,,4920270
HCAL-07-11,,4920269
HCAL-07-11,,4920271
HCAL-07-11,,4920272
HCAL-07-11,,4920273
HCAL-07-11,,4920274
HCAL-07-11,,4926372
HCAL-07-11,,4927713
HCAL-07-11,,4927716
HCAL-07-11,,4927719
HCAL-07-11,,4930389
HCAL-07-11,,4930398
HCAL-07-11,,4930402
HCAL-07-11,,4930403
HCAL-07-12,,4920275
HCAL-07-12,,4920276
HCAL-07-12,,4920277
HCAL-07-12,,4920278
HCAL-07-12,,4920279
HCAL-07-12,,4926373
HCAL-07-12,,4927721
HCAL-07-12,,4927723
HCAL-07-12,,4927724
HCAL-07-12,,4930407
HCAL-07-12,,4930421
HCAL-07-12,,4930430
HCAL-07-13,,4920280
HCAL-07-13,,4920281
HCAL-07-13,,4920282
HCAL-07-13,,4920283
HCAL-07-13,,4920285
HCAL-07-13,,4920284
HCAL-07-13,,4926374
HCAL-07-13,,4926376
HCAL-07-13,,4927725
HCAL-07-13,,4927726
HCAL-07-13,,4930433
HCAL-07-13,,4930458
HCAL-07-13,,4930470
HCAL-07-13,,4930476
HCAL-07-13,,4930478
HCAL-07-13,,4930481
HCAL-08-01,,4921658
HCAL-08-01,,4921657
HCAL-08-01,,4920440
HCAL-08-01,,4920445
HCAL-08-01,,4920449
HCAL-08-01,,4926383
HCAL-08-01,,4926384
HCAL-08-01,,4927750
HCAL-08-01,,4927751
HCAL-08-01,,4927752
HCAL-08-01,,4927753
HCAL-08-01,,4927754
HCAL-08-01,,4930560
HCAL-08-01,,4930561
HCAL-08-01,,4930564
HCAL-08-02,,4920452
HCAL-08-02,,4920456
HCAL-08-02,,4920459
HCAL-08-02,,4920462
HCAL-08-02,,4920464
HCAL-08-02,,4920466
HCAL-08-02,,4920469
HCAL-08-02,,4926405
HCAL-08-02,,4926407
HCAL-08-02,,4926411
HCAL-08-02,,4927759
HCAL-08-02,,4927760
HCAL-08-02,,4927777
HCAL-08-02,,4927778
HCAL-08-02,,4927779
HCAL-08-02,,4930566
HCAL-08-02,,4930568
HCAL-08-02,,4930569
HCAL-08-02,,4930570
HCAL-08-03,,4920472
HCAL-08-03,,4920475
HCAL-08-03,,4920478
HCAL-08-03,,4920482
HCAL-08-03,,4920485
HCAL-08-03,,4920488
HCAL-08-03,,4926420
HCAL-08-03,,4926424
HCAL-08-03,,4926428
HCAL-08-03,,4927780
HCAL-08-03,,4927781
HCAL-08-03,,4927782
HCAL-08-03,,4927784
HCAL-08-03,,4927786
HCAL-08-03,,4927788
HCAL-08-03,,4927789
HCAL-08-03,,4930572
HCAL-08-03,,4930575
HCAL-08-03,,4930582
HCAL-08-03,,4930586
HCAL-08-03,,4930587
HCAL-08-03,,4930589
HCAL-08-03,,4930591
HCAL-08-04,,4920490
HCAL-08-04,,4920493
HCAL-08-04,,4920497
HCAL-08-04,,4920500
HCAL-08-04,,4926452
HCAL-08-04,,4927796
HCAL-08-04,,4927798
HCAL-08-04,,4930592
HCAL-08-04,,4930593
HCAL-08-04,,4930598
HCAL-08-05,,4920515
HCAL-08-05,,4920516
HCAL-08-05,,4920517
HCAL-08-05,,4920522
HCAL-08-05,,4920528
HCAL-08-05,,4920531
HCAL-08-05,,4920538
HCAL-08-05,,4920544
HCAL-08-05,,4920549
HCAL-08-05,,4920553
HCAL-08-05,,4920556
HCAL-08-05,,4920560
HCAL-08-05,,4920564
HCAL-08-05,,4926449
HCAL-08-05,,4927800
HCAL-08-05,,4927802
HCAL-08-05,,4927804
HCAL-08-05,,4930603
HCAL-08-05,,4930608
HCAL-08-05,,4930615
HCAL-08-06,,4920567
HCAL-08-06,,4920570
HCAL-08-06,,4920572
HCAL-08-06,,4926453
HCAL-08-06,,4926454
HCAL-08-06,,4926456
HCAL-08-06,,4926457
HCAL-08-06,,4927806
HCAL-08-06,,4927807
HCAL-08-06,,4927813
HCAL-08-06,,4927810
HCAL-08-06,,4927816
HCAL-08-06,,4927818
HCAL-08-06,,4927821
HCAL-08-06,,4927826
HCAL-08-06,,4927831
HCAL-08-06,,4930624
HCAL-08-06,,4930640
HCAL-08-06,,4930644
HCAL-08-06,,4930645
HCAL-08-06,,4930646
HCAL-08-06,,4930647
HCAL-08-06,,4930653
HCAL-08-07,,4920575
HCAL-08-07,,4920578
HCAL-08-07,,4920581
HCAL-08-07,,4920584
HCAL-08-07,,4920586
HCAL-08-07,,4920591
HCAL-08-07,,4926460
HCAL-08-07,,4926461
HCAL-08-07,,4926463
HCAL-08-07,,4927835
HCAL-08-07,,4927838
HCAL-08-07,,4927839
HCAL-08-07,,4927842
HCAL-08-07,,4927845
HCAL-08-07,,4930657
HCAL-08-07,,4930662
HCAL-08-07,,4930667
HCAL-08-08,,4920594
HCAL-08-08,,4920598
HCAL-08-08,,4920601
HCAL-08-08,,4920603
HCAL-08-08,,4920605
HCAL-08-08,,4920608
HCAL-08-08,,4920617
HCAL-08-08,,4926464
HCAL-08-08,,4926465
HCAL-08-08,,4926466
HCAL-08-08,,4927846
HCAL-08-08,,4927847
HCAL-08-08,,4927848
HCAL-08-08,,4930670
HCAL-08-08,,4930676
HCAL-08-08,,4930679
HCAL-08-08,,4930683
HCAL-08-09,,4920612
HCAL-08-09,,4920620
HCAL-08-09,,4920623
HCAL-08-09,,4920627
HCAL-08-09,,4920630
HCAL-08-09,,4920634
HCAL-08-09,,4926467
HCAL-08-09,,4926470
HCAL-08-09,,4926476
HCAL-08-09,,4927849
HCAL-08-09,,4927850
HCAL-08-09,,4927851
HCAL-08-09,,4927860
HCAL-08-09,,4927861
HCAL-08-09,,4930687
HCAL-08-09,,4930692
HCAL-08-09,,4930696
HCAL-08-10,,4920638
HCAL-08-10,,4920641
HCAL-08-10,,4920645
HCAL-08-10,,4926489
HCAL-08-10,,4926493
HCAL-08-10,,4927862
HCAL-08-10,,4927863
HCAL-08-10,,4930701
HCAL-08-10,,4930705
HCAL-08-10,,4930709
HCAL-09-01,,4920805
HCAL-09-01,,4920809
HCAL-09-01,,4920812
HCAL-09-01,,4920815
HCAL-09-01,,4920818
HCAL-09-01,,4926518
HCAL-09-01,,4926521
HCAL-09-01,,4927891
HCAL-09-01,,4927892
HCAL-09-01,,4927903
HCAL-09-01,,4927897
HCAL-09-01,,4930763
HCAL-09-01,,4930779
HCAL-09-01,,4930786
HCAL-09-02,,4920823
HCAL-09-02,,4920825
HCAL-09-02,,4920828
HCAL-09-02,,4920830
HCAL-09-02,,4920832
HCAL-09-02,,4920834
HCAL-09-02,,4926524
HCAL-09-02,,4927893
HCAL-09-02,,4927894
HCAL-09-02,,4927895
HCAL-09-02,,4927896
HCAL-09-02,,4927901
HCAL-09-02,,4927902
HCAL-09-02,,4927905
HCAL-09-02,,4927898
HCAL-09-02,,4930769
HCAL-09-02,,4930772
HCAL-09-02,,4930778
HCAL-09-02,,4930781
HCAL-09-03,,4920820
HCAL-09-03,,4920837
HCAL-09-03,,4926562
HCAL-09-03,,4927908
HCAL-09-03,,4927912
HCAL-09-03,,4927915
HCAL-09-03,,4930789
HCAL-09-03,,4930792
HCAL-09-03,,4930795
HCAL-09-03,,4930797
HCAL-09-04,,4920839
HCAL-09-04,,4920841
HCAL-09-04,,4920843
HCAL-09-04,,4920846
HCAL-09-04,,4926570
HCAL-09-04,,4927918
HCAL-09-04,,4927923
HCAL-09-04,,4927930
HCAL-09-04,,4930804
HCAL-09-04,,4930815
HCAL-09-04,,4930843
HCAL-09-05,,4920849
HCAL-09-05,,4920852
HCAL-09-05,,4920854
HCAL-09-06,,4920856
HCAL-09-06,,4920857
HCAL-09-06,,4920858
HCAL-09-06,,4920859
HCAL-09-06,,4920860
HCAL-09-06,,4920861
HCAL-09-06,,4920862
HCAL-09-06,,4920863
HCAL-09-06,,4920864
HCAL-09-06,,4920865
HCAL-09-06,,4920866
HCAL-09-06,,4920867
HCAL-09-06,,4920868
HCAL-09-06,,4926580
HCAL-09-06,,4926584
HCAL-09-06,,4926588
HCAL-09-06,,4927933
HCAL-09-06,,4927938
HCAL-09-06,,4927950
HCAL-09-06,,4927996
HCAL-09-06,,4928004
HCAL-09-06,,4928006
HCAL-09-06,,4928009
HCAL-09-06,,4930850
HCAL-09-06,,4930852
HCAL-09-06,,4930859
HCAL-09-06,,4930862
HCAL-09-06,,4930869
HCAL-09-06,,4930879
HCAL-09-06,,4930886
HCAL-09-06,,4930892
HCAL-09-07,,4920870
HCAL-09-07,,4920871
HCAL-09-07,,4920873
HCAL-09-07,,4920877
HCAL-09-07,,4920878
HCAL-09-07,,4926606
HCAL-09-07,,4926613
HCAL-09-07,,4928012
HCAL-09-07,,4928016
HCAL-09-07,,4930896
HCAL-09-07,,4930899
HCAL-09-07,,4930901
HCAL-09-07,,4930906
HCAL-09-08,,4920881
HCAL-09-08,,4920883
HCAL-09-08,,4920900
HCAL-09-08,,4920903
HCAL-09-08,,4920905
HCAL-09-08,,4920910
HCAL-09-08,,4920913
HCAL-09-08,,4920914
HCAL-09-08,,4926624
HCAL-09-08,,4926625
HCAL-09-08,,4928021
HCAL-09-08,,4928025
HCAL-09-08,,4928027
HCAL-09-08,,4928030
HCAL-09-08,,4928032
HCAL-09-08,,4930912
HCAL-09-08,,4930916
HCAL-09-08,,4930921
HCAL-09-08,,4930952
HCAL-09-08,,4930959
HCAL-09-08,,4930966
HCAL-09-09,,4920915
HCAL-09-09,,4920916
HCAL-09-09,,4920917
HCAL-09-09,,4926626
HCAL-09-09,,4928033
HCAL-09-09,,4928034
HCAL-09-09,,4930972
HCAL-09-09,,4930978
HCAL-09-09,,4930982
HCAL-09-10,,4920918
HCAL-09-10,,4920920
HCAL-09-10,,4920922
HCAL-09-10,,4920928
HCAL-09-10,,4920929
HCAL-09-10,,4920930
HCAL-09-10,,4920931
HCAL-09-10,,4926627
HCAL-09-10,,4928035
HCAL-09-10,,4928036
HCAL-09-10,,4928037
HCAL-09-10,,4930987
HCAL-09-10,,4930992
HCAL-09-10,,4930995
HCAL-09-10,,4931000
HCAL-09-11,,4920932
HCAL-09-11,,4920933
HCAL-09-11,,4920934
HCAL-09-11,,4931007
HCAL-09-11,,4931013
HCAL-09-11,,4931026
HCAL-09-12,,4920936
HCAL-09-12,,4920938
HCAL-09-12,,4920941
HCAL-09-12,,4920942
HCAL-09-12,,4931031
HCAL-09-12,,4931035
HCAL-09-12,,4931043
HCAL-09-13,,4920943
HCAL-09-13,,4920944
HCAL-09-13,,4920945
HCAL-09-13,,4920946
HCAL-09-13,,4920947
HCAL-09-13,,4920948
HCAL-09-13,,4931048
HCAL-09-13,,4931053
HCAL-09-13,,4931058
HCAL-10-01,,4926639
HCAL-10-01,,4928091
HCAL-10-01,,4928096
HCAL-10-01,,4931109
HCAL-10-01,,4931112
HCAL-10-02,,4921140
HCAL-10-02,,4921141
HCAL-10-02,,4921144
HCAL-10-02,,4921146
HCAL-10-02,,4921148
HCAL-10-02,,4921151
HCAL-10-02,,4921154
HCAL-10-02,,4921156
HCAL-10-02,,4921158
HCAL-10-02,,4921161
HCAL-10-02,,4921163
HCAL-10-02,,4921166
HCAL-10-02,,4926657
HCAL-10-02,,4926662
HCAL-10-02,,4928122
HCAL-10-02,,4928124
HCAL-10-02,,4928125
HCAL-10-02,,4928128
HCAL-10-02,,4928130
HCAL-10-02,,4931120
HCAL-10-02,,4931125
HCAL-10-02,,4931136
HCAL-10-02,,4931142
HCAL-10-02,,4931148
HCAL-10-03,,4921168
HCAL-10-03,,4921170
HCAL-10-03,,4921174
HCAL-10-03,,4928133
HCAL-10-03,,4928136
HCAL-10-03,,4931151
HCAL-10-04,,4921176
HCAL-10-04,,4921178
HCAL-10-04,,4921181
HCAL-10-04,,4921188
HCAL-10-04,,4921190
HCAL-10-04,,4921193
HCAL-10-04,,4921195
HCAL-10-04,,4921198
HCAL-10-04,,4921206
HCAL-10-04,,4926680
HCAL-10-04,,4926683
HCAL-10-04,,4928170
HCAL-10-04,,4928171
HCAL-10-04,,4928172
HCAL-10-04,,4928174
HCAL-10-04,,4931160
HCAL-10-04,,4931163
HCAL-10-04,,4931171
HCAL-10-05,,4921210
HCAL-10-05,,4921213
HCAL-10-05,,4921217
HCAL-10-05,,4921221
HCAL-10-05,,4921224
HCAL-10-05,,4926690
HCAL-10-05,,4926692
HCAL-10-05,,4928176
HCAL-10-05,,4928177
HCAL-10-05,,4931176
HCAL-10-05,,4931182
HCAL-10-05,,4931186
HCAL-10-06,,4921227
HCAL-10-06,,4921238
HCAL-10-06,,4921239
HCAL-10-06,,4921241
HCAL-10-06,,4921243
HCAL-10-06,,4921246
HCAL-10-06,,4921255
HCAL-10-06,,4921250
HCAL-10-06,,4921259
HCAL-10-06,,4926704
HCAL-10-06,,4926711
HCAL-10-06,,4928179
HCAL-10-06,,4928182
HCAL-10-06,,4928185
HCAL-10-06,,4928197
HCAL-10-06,,4928198
HCAL-10-06,,4931192
HCAL-10-06,,4931195
HCAL-10-06,,4931199
HCAL-10-06,,4931203
HCAL-10-06,,4931207
HCAL-10-06,,4931211
HCAL-10-07,,4921262
HCAL-10-07,,4921264
HCAL-10-07,,4921267
HCAL-10-07,,4921270
HCAL-10-07,,4926719
HCAL-10-07,,4928201
HCAL-10-07,,4928203
HCAL-10-07,,4931217
HCAL-10-07,,4931220
HCAL-10-07,,4931223
HCAL-10-08,,4921273
HCAL-10-08,,4921280
HCAL-10-08,,4921277
HCAL-10-08,,4931228
HCAL-10-08,,4931231
HCAL-10-08,,4931233
HCAL-10-09,,4921283
HCAL-10-09,,4921285
HCAL-10-09,,4921288
HCAL-10-09,,4921293
HCAL-10-09,,4931240
HCAL-10-09,,4931243
HCAL-10-09,,4931246
HCAL-10-10,,4921296
HCAL-10-10,,4921298
HCAL-10-10,,4921301
HCAL-10-10,,4921304
HCAL-10-10,,4926728
HCAL-10-10,,4928242
HCAL-10-10,,4928246
HCAL-10-10,,4931291
HCAL-10-10,,4931391
HCAL-10-10,,4931311
HCAL-10-11,,4921307
HCAL-10-11,,4921310
HCAL-10-11,,4921314
HCAL-10-11,,4921315
HCAL-10-11,,4926740
HCAL-10-11,,4928262
HCAL-10-11,,4928265
HCAL-10-11,,4928267
HCAL-10-11,,4926748
HCAL-10-11,,4928268
HCAL-10-11,,4928269
HCAL-10-11,,4931318
HCAL-10-11,,4931394
HCAL-10-11,,4931396
HCAL-10-12,,4921317
HCAL-10-12,,4921320
HCAL-10-12,,4921322
HCAL-10-12,,4921324
HCAL-10-12,,4921331
HCAL-10-12,,4926754
HCAL-10-12,,4928270
HCAL-10-12,,4928272
HCAL-10-12,,4931400
HCAL-10-12,,4931406
HCAL-10-12,,4931413
HCAL-10-13,,4921327
HCAL-10-13,,4921339
HCAL-10-13,,4921344
HCAL-10-13,,4921351
HCAL-10-13,,4921353
HCAL-10-13,,4926764
HCAL-10-13,,4926767
HCAL-10-13,,4926770
HCAL-10-13,,4928281
HCAL-10-13,,4928284
HCAL-10-13,,4928285
HCAL-10-13,,4928286
HCAL-10-13,,4931428
HCAL-10-13,,4931431
HCAL-10-13,,4931434
HCAL-10-14,,4921356
HCAL-10-14,,4921359
HCAL-10-14,,4921369
HCAL-10-14,,4921370
HCAL-10-14,,4921371
HCAL-10-14,,4926778
HCAL-10-14,,4928287
HCAL-10-14,,4928288
HCAL-10-14,,4931437
HCAL-10-14,,4931440
HCAL-10-14,,4931441
HCAL-10-15,,4921374
HCAL-10-15,,4921377
HCAL-10-15,,4921382
HCAL-10-15,,4921391
HCAL-10-15,,4921396
HCAL-10-15,,4921399
HCAL-10-15,,4926790
HCAL-10-15,,4926798
HCAL-10-15,,4928291
HCAL-10-15,,4928295
HCAL-10-15,,4931442
HCAL-10-15,,4931443
HCAL-10-15,,4931444
EXEP-01-01,,
